UWI,Source,Test Type,Test Number,Number,Depth Top,Depth Base,Lat Len Horiz Displacement (ft),Lat Len Gross Perf Intvl,Prod Method
42013342210001,PI,IP,001,1,10240,10250,,10,PERF
42013342210001,PI,IP,001,2,10256,10264,,8,PERF
42013342210001,PI,IP,001,3,10270,10290,,20,PERF
42013342210001,PI,PT,002,1,10338,10374,,36,PERF
42013342210001,PI,PT,002,2,10559,10590,,31,PERF
42013342710000,PI,IP,001,1,8390,8396,4006,6,PERF
42013342710000,PI,IP,001,2,8547,8553,4006,6,PERF
42013342710000,PI,IP,001,3,8697,8703,4006,6,PERF
42013342710000,PI,IP,001,4,8850,8856,4006,6,PERF
42013342710000,PI,IP,001,5,9047,9053,4006,6,PERF
42013342710000,PI,IP,001,6,9200,9206,4006,6,PERF
42013342710000,PI,IP,001,7,9347,9353,4006,6,PERF
42013342710000,PI,IP,001,8,9497,9503,4006,6,PERF
42013342710000,PI,IP,001,9,9533,9647,4006,114,PERF
42013342710000,PI,IP,001,10,9797,9803,4006,6,PERF
42013342710000,PI,IP,001,11,9947,9953,4006,6,PERF
42013342710000,PI,IP,001,12,10097,10103,4006,6,PERF
42013342710000,PI,IP,001,13,10256,10282,4006,26,PERF
42013342710000,PI,IP,001,14,10397,10403,4006,6,PERF
42013342710000,PI,IP,001,15,10547,10553,4006,6,PERF
42013342710000,PI,IP,001,16,10686,10692,4006,6,PERF
42013342710000,PI,IP,001,17,10847,10853,4006,6,PERF
42013342710000,PI,IP,001,18,10997,11003,4006,6,PERF
42013342710000,PI,IP,001,19,11147,11153,4006,6,PERF
42013342710000,PI,IP,001,20,11297,11303,4006,6,PERF
42013342710000,PI,IP,001,21,11446,11452,4006,6,PERF
42013342710000,PI,IP,001,22,11524,11527,4006,3,PERF
42013342730000,PI,IP,001,1,10080,10086,5199,6,PERF
42013342730000,PI,IP,001,2,10225,10231,5199,6,PERF
42013342730000,PI,IP,001,3,10375,10381,5199,6,PERF
42013342730000,PI,IP,001,4,10528,10534,5199,6,PERF
42013342730000,PI,IP,001,5,10675,10681,5199,6,PERF
42013342730000,PI,IP,001,6,10820,10826,5199,6,PERF
42013342730000,PI,IP,001,7,10975,10981,5199,6,PERF
42013342730000,PI,IP,001,8,11125,11131,5199,6,PERF
42013342730000,PI,IP,001,9,11325,11331,5199,6,PERF
42013342730000,PI,IP,001,10,11475,11481,5199,6,PERF
42013342730000,PI,IP,001,11,11676,11682,5199,6,PERF
42013342730000,PI,IP,001,12,11825,11831,5199,6,PERF
42013342730000,PI,IP,001,13,11965,11971,5199,6,PERF
42013342730000,PI,IP,001,14,12125,12131,5199,6,PERF
42013342730000,PI,IP,001,15,12270,12276,5199,6,PERF
42013342730000,PI,IP,001,16,12404,12410,5199,6,PERF
42013342730000,PI,IP,001,17,12560,12566,5199,6,PERF
42013342730000,PI,IP,001,18,12725,12731,5199,6,PERF
42013342730000,PI,IP,001,19,12890,12896,5199,6,PERF
42013342730000,PI,IP,001,20,13025,13031,5199,6,PERF
42013342730000,PI,IP,001,21,13170,13176,5199,6,PERF
42013342730000,PI,IP,001,22,13325,13331,5199,6,PERF
42013342730000,PI,IP,001,23,13782,13786,5199,4,PERF
42013342730000,PI,IP,001,24,13925,13931,5199,6,PERF
42013342730000,PI,IP,001,25,14075,14081,5199,6,PERF
42013342730000,PI,IP,001,26,14125,14131,5199,6,PERF
42013342780100,PI,IP,001,1,9976,13546,3960,3570,PERF
42013342790000,PI,IP,001,1,9626,9629,4977,3,PERF
42013342790000,PI,IP,001,2,9756,9759,4977,3,PERF
42013342790000,PI,IP,001,3,9886,9892,4977,6,PERF
42013342790000,PI,IP,001,4,10010,10013,4977,3,PERF
42013342790000,PI,IP,001,5,10146,10152,4977,6,PERF
42013342790000,PI,IP,001,6,10276,10279,4977,3,PERF
42013342790000,PI,IP,001,7,10406,10412,4977,6,PERF
42013342790000,PI,IP,001,8,10540,10543,4977,3,PERF
42013342790000,PI,IP,001,9,10664,10670,4977,6,PERF
42013342790000,PI,IP,001,10,10796,10799,4977,3,PERF
42013342790000,PI,IP,001,11,10926,10932,4977,6,PERF
42013342790000,PI,IP,001,12,11060,11063,4977,3,PERF
42013342790000,PI,IP,001,13,11180,11186,4977,6,PERF
42013342790000,PI,IP,001,14,11316,11319,4977,3,PERF
42013342790000,PI,IP,001,15,11446,11452,4977,6,PERF
42013342790000,PI,IP,001,16,11599,11602,4977,3,PERF
42013342790000,PI,IP,001,17,11756,11762,4977,6,PERF
42013342790000,PI,IP,001,18,11900,11903,4977,3,PERF
42013342790000,PI,IP,001,19,12046,12052,4977,6,PERF
42013342790000,PI,IP,001,20,12196,12199,4977,3,PERF
42013342790000,PI,IP,001,21,12346,12352,4977,6,PERF
42013342790000,PI,IP,001,22,12500,12503,4977,3,PERF
42013342790000,PI,IP,001,23,12646,12652,4977,6,PERF
42013342790000,PI,IP,001,24,13252,13255,4977,3,PERF
42013342790000,PI,IP,001,25,13430,13436,4977,6,PERF
42013342790000,PI,IP,001,26,13590,13596,4977,6,PERF
42013342790000,PI,IP,001,27,13884,13890,4977,6,PERF
42013342790000,PI,IP,001,28,14044,14050,4977,6,PERF
42013342820000,PI,IP,001,1,9691,9697,4869,6,PERF
42013342820000,PI,IP,001,2,9846,9852,4869,6,PERF
42013342820000,PI,IP,001,3,10001,10007,4869,6,PERF
42013342820000,PI,IP,001,4,10157,10163,4869,6,PERF
42013342820000,PI,IP,001,5,10296,10302,4869,6,PERF
42013342820000,PI,IP,001,6,10464,10470,4869,6,PERF
42013342820000,PI,IP,001,7,10621,10627,4869,6,PERF
42013342820000,PI,IP,001,8,10776,10782,4869,6,PERF
42013342820000,PI,IP,001,9,10931,10937,4869,6,PERF
42013342820000,PI,IP,001,10,11087,11093,4869,6,PERF
42013342820000,PI,IP,001,11,11234,11240,4869,6,PERF
42013342820000,PI,IP,001,12,11394,11400,4869,6,PERF
42013342820000,PI,IP,001,13,11551,11557,4869,6,PERF
42013342820000,PI,IP,001,14,11706,11712,4869,6,PERF
42013342820000,PI,IP,001,15,11861,11867,4869,6,PERF
42013342820000,PI,IP,001,16,12016,12022,4869,6,PERF
42013342820000,PI,IP,001,17,12174,12180,4869,6,PERF
42013342820000,PI,IP,001,18,12318,12324,4869,6,PERF
42013342820000,PI,IP,001,19,12480,12486,4869,6,PERF
42013342820000,PI,IP,001,20,12636,12642,4869,6,PERF
42013342820000,PI,IP,001,21,12791,12797,4869,6,PERF
42013342820000,PI,IP,001,22,12946,12952,4869,6,PERF
42013342820000,PI,IP,001,23,13101,13107,4869,6,PERF
42013342820000,PI,IP,001,24,13351,13357,4869,6,PERF
42013342820000,PI,IP,001,25,13401,13407,4869,6,PERF
42013342820000,PI,IP,001,26,13553,13559,4869,6,PERF
42013342820000,PI,IP,001,27,13693,13699,4869,6,PERF
42013342820000,PI,IP,001,28,13854,13860,4869,6,PERF
42013342820000,PI,IP,001,29,14009,14015,4869,6,PERF
42013342840000,PI,IP,001,1,9550,9553,4906,3,PERF
42013342840000,PI,IP,001,2,9700,9703,4906,3,PERF
42013342840000,PI,IP,001,3,9837,9843,4906,6,PERF
42013342840000,PI,IP,001,4,10010,10013,4906,3,PERF
42013342840000,PI,IP,001,5,10150,10153,4906,3,PERF
42013342840000,PI,IP,001,6,10310,10313,4906,3,PERF
42013342840000,PI,IP,001,7,10450,10453,4906,3,PERF
42013342840000,PI,IP,001,8,10590,10593,4906,3,PERF
42013342840000,PI,IP,001,9,10720,10723,4906,3,PERF
42013342840000,PI,IP,001,10,10900,10903,4906,3,PERF
42013342840000,PI,IP,001,11,11030,11033,4906,3,PERF
42013342840000,PI,IP,001,12,11170,11173,4906,3,PERF
42013342840000,PI,IP,001,13,11294,11297,4906,3,PERF
42013342840000,PI,IP,001,14,11300,11303,4906,3,PERF
42013342840000,PI,IP,001,15,11560,11563,4906,3,PERF
42013342840000,PI,IP,001,16,11700,11703,4906,3,PERF
42013342840000,PI,IP,001,17,11870,11873,4906,3,PERF
42013342840000,PI,IP,001,18,12003,12006,4906,3,PERF
42013342840000,PI,IP,001,19,12174,12177,4906,3,PERF
42013342840000,PI,IP,001,20,12180,12183,4906,3,PERF
42013342840000,PI,IP,001,21,13390,13393,4906,3,PERF
42013342840000,PI,IP,001,22,13700,13703,4906,3,PERF
42013342840000,PI,IP,001,23,13850,13853,4906,3,PERF
42013342840000,PI,IP,001,24,13992,13998,4906,6,PERF
42013342840000,PI,IP,001,25,14056,14062,4906,6,PERF
42013342850000,PI,IP,001,1,9770,9773,4754,3,PERF
42013342850000,PI,IP,001,2,9866,9869,4754,3,PERF
42013342850000,PI,IP,001,3,9962,9968,4754,6,PERF
42013342850000,PI,IP,001,4,10074,10077,4754,3,PERF
42013342850000,PI,IP,001,5,10170,10173,4754,3,PERF
42013342850000,PI,IP,001,6,10260,10266,4754,6,PERF
42013342850000,PI,IP,001,7,10368,10371,4754,3,PERF
42013342850000,PI,IP,001,8,10461,10464,4754,3,PERF
42013342850000,PI,IP,001,9,10576,10582,4754,6,PERF
42013342850000,PI,IP,001,10,10670,10673,4754,3,PERF
42013342850000,PI,IP,001,11,10770,10773,4754,3,PERF
42013342850000,PI,IP,001,12,10868,10874,4754,6,PERF
42013342850000,PI,IP,001,13,10962,10965,4754,3,PERF
42013342850000,PI,IP,001,14,11078,11081,4754,3,PERF
42013342850000,PI,IP,001,15,11170,11176,4754,6,PERF
42013342850000,PI,IP,001,16,11270,11273,4754,3,PERF
42013342850000,PI,IP,001,17,11370,11373,4754,3,PERF
42013342850000,PI,IP,001,18,11466,11472,4754,6,PERF
42013342850000,PI,IP,001,19,11562,11565,4754,3,PERF
42013342850000,PI,IP,001,20,11677,11680,4754,3,PERF
42013342850000,PI,IP,001,21,11770,11776,4754,6,PERF
42013342850000,PI,IP,001,22,11870,11873,4754,3,PERF
42013342850000,PI,IP,001,23,11970,11973,4754,3,PERF
42013342850000,PI,IP,001,24,12064,12070,4754,6,PERF
42013342850000,PI,IP,001,25,12180,12183,4754,3,PERF
42013342850000,PI,IP,001,26,12270,12273,4754,3,PERF
42013342850000,PI,IP,001,27,12370,12376,4754,6,PERF
42013342850000,PI,IP,001,28,12470,12473,4754,3,PERF
42013342850000,PI,IP,001,29,12566,12569,4754,3,PERF
42013342850000,PI,IP,001,30,12656,12662,4754,6,PERF
42013342850000,PI,IP,001,31,12775,12778,4754,3,PERF
42013342850000,PI,IP,001,32,12870,12873,4754,3,PERF
42013342850000,PI,IP,001,33,12970,12976,4754,6,PERF
42013342850000,PI,IP,001,34,13070,13073,4754,3,PERF
42013342850000,PI,IP,001,35,13163,13166,4754,3,PERF
42013342850000,PI,IP,001,36,13276,13282,4754,6,PERF
42013342850000,PI,IP,001,37,13370,13373,4754,3,PERF
42013342850000,PI,IP,001,38,13470,13473,4754,3,PERF
42013342850000,PI,IP,001,39,13570,13576,4754,6,PERF
42013342850000,PI,IP,001,40,13825,13831,4754,6,PERF
42013342850000,PI,IP,001,41,13867,13873,4754,6,PERF
42013342890000,PI,IP,001,1,9670,9673,4764,3,PERF
42013342890000,PI,IP,001,2,9880,9887,4764,7,PERF
42013342890000,PI,IP,001,3,9980,9983,4764,3,PERF
42013342890000,PI,IP,001,4,10090,10096,4764,6,PERF
42013342890000,PI,IP,001,5,10183,10186,4764,3,PERF
42013342890000,PI,IP,001,6,10290,10296,4764,6,PERF
42013342890000,PI,IP,001,7,10400,10403,4764,3,PERF
42013342890000,PI,IP,001,8,10500,10503,4764,3,PERF
42013342890000,PI,IP,001,9,10606,10660,4764,54,PERF
42013342890000,PI,IP,001,10,10704,10707,4764,3,PERF
42013342890000,PI,IP,001,11,10810,10813,4764,3,PERF
42013342890000,PI,IP,001,12,10902,10908,4764,6,PERF
42013342890000,PI,IP,001,13,11020,11023,4764,3,PERF
42013342890000,PI,IP,001,14,11110,11113,4764,3,PERF
42013342890000,PI,IP,001,15,11220,11226,4764,6,PERF
42013342890000,PI,IP,001,16,11330,11333,4764,3,PERF
42013342890000,PI,IP,001,17,11430,11436,4764,6,PERF
42013342890000,PI,IP,001,18,11530,11536,4764,6,PERF
42013342890000,PI,IP,001,19,11633,11636,4764,3,PERF
42013342890000,PI,IP,001,20,11740,11743,4764,3,PERF
42013342890000,PI,IP,001,21,11846,11852,4764,6,PERF
42013342890000,PI,IP,001,22,11950,11953,4764,3,PERF
42013342890000,PI,IP,001,23,12050,12053,4764,3,PERF
42013342890000,PI,IP,001,24,12150,12156,4764,6,PERF
42013342890000,PI,IP,001,25,12260,12263,4764,3,PERF
42013342890000,PI,IP,001,26,12356,12359,4764,3,PERF
42013342890000,PI,IP,001,27,12466,12472,4764,6,PERF
42013342890000,PI,IP,001,28,12570,12573,4764,3,PERF
42013342890000,PI,IP,001,29,12670,12673,4764,3,PERF
42013342890000,PI,IP,001,30,12754,12760,4764,6,PERF
42013342890000,PI,IP,001,31,12880,12883,4764,3,PERF
42013342890000,PI,IP,001,32,12980,12983,4764,3,PERF
42013342890000,PI,IP,001,33,13080,13086,4764,6,PERF
42013342890000,PI,IP,001,34,13190,13193,4764,3,PERF
42013342890000,PI,IP,001,35,13290,13293,4764,3,PERF
42013342890000,PI,IP,001,36,13390,13396,4764,6,PERF
42013342890000,PI,IP,001,37,13503,13509,4764,6,PERF
42013342890000,PI,IP,001,38,13582,13588,4764,6,PERF
42013342900000,PI,IP,001,1,9699,9702,5010,3,PERF
42013342900000,PI,IP,001,2,9790,9796,5010,6,PERF
42013342900000,PI,IP,001,3,9880,9886,5010,6,PERF
42013342900000,PI,IP,001,4,9977,9980,5010,3,PERF
42013342900000,PI,IP,001,5,10070,10073,5010,3,PERF
42013342900000,PI,IP,001,6,10157,10163,5010,6,PERF
42013342900000,PI,IP,001,7,10274,10277,5010,3,PERF
42013342900000,PI,IP,001,8,10363,10366,5010,3,PERF
42013342900000,PI,IP,001,9,10455,10461,5010,6,PERF
42013342900000,PI,IP,001,10,10545,10548,5010,3,PERF
42013342900000,PI,IP,001,11,10638,10641,5010,3,PERF
42013342900000,PI,IP,001,12,10731,10737,5010,6,PERF
42013342900000,PI,IP,001,13,10824,10827,5010,3,PERF
42013342900000,PI,IP,001,14,10917,10920,5010,3,PERF
42013342900000,PI,IP,001,15,11010,11016,5010,6,PERF
42013342900000,PI,IP,001,16,11103,11106,5010,3,PERF
42013342900000,PI,IP,001,17,11196,11199,5010,3,PERF
42013342900000,PI,IP,001,18,11289,11295,5010,6,PERF
42013342900000,PI,IP,001,19,11382,11385,5010,3,PERF
42013342900000,PI,IP,001,20,11475,11481,5010,6,PERF
42013342900000,PI,IP,001,21,11661,11664,5010,3,PERF
42013342900000,PI,IP,001,22,11775,11778,5010,3,PERF
42013342900000,PI,IP,001,23,11889,11895,5010,6,PERF
42013342900000,PI,IP,001,24,12010,12013,5010,3,PERF
42013342900000,PI,IP,001,25,12117,12120,5010,3,PERF
42013342900000,PI,IP,001,26,12240,12246,5010,6,PERF
42013342900000,PI,IP,001,27,12345,12348,5010,3,PERF
42013342900000,PI,IP,001,28,12469,12472,5010,3,PERF
42013342900000,PI,IP,001,29,12573,12579,5010,6,PERF
42013342900000,PI,IP,001,30,12677,12680,5010,3,PERF
42013342900000,PI,IP,001,31,12801,12804,5010,3,PERF
42013342900000,PI,IP,001,32,12905,12911,5010,6,PERF
42013342900000,PI,IP,001,33,13029,13032,5010,3,PERF
42013342900000,PI,IP,001,34,13133,13136,5010,3,PERF
42013342900000,PI,IP,001,35,13257,13263,5010,6,PERF
42013342900000,PI,IP,001,36,13361,13364,5010,3,PERF
42013342900000,PI,IP,001,37,13485,13488,5010,3,PERF
42013342900000,PI,IP,001,38,13589,13595,5010,6,PERF
42013342900000,PI,IP,001,39,13839,13845,5010,6,PERF
42013342900000,PI,IP,001,40,13899,13905,5010,6,PERF
42013342910100,PI,IP,001,1,10950,10950,6972,0,PERF
42013342910100,PI,IP,001,2,11000,11000,6972,0,PERF
42013342910100,PI,IP,001,3,11050,11050,6972,0,PERF
42013342910100,PI,IP,001,4,11100,11100,6972,0,PERF
42013342910100,PI,IP,001,5,11150,11150,6972,0,PERF
42013342910100,PI,IP,001,6,11200,11200,6972,0,PERF
42013342910100,PI,IP,001,7,11250,11250,6972,0,PERF
42013342910100,PI,IP,001,8,11300,11300,6972,0,PERF
42013342910100,PI,IP,001,9,11350,11350,6972,0,PERF
42013342910100,PI,IP,001,10,11400,11400,6972,0,PERF
42013342910100,PI,IP,001,11,11450,11450,6972,0,PERF
42013342910100,PI,IP,001,12,11500,11500,6972,0,PERF
42013342910100,PI,IP,001,13,11550,11550,6972,0,PERF
42013342910100,PI,IP,001,14,11600,11600,6972,0,PERF
42013342910100,PI,IP,001,15,11650,11650,6972,0,PERF
42013342910100,PI,IP,001,16,11700,11700,6972,0,PERF
42013342910100,PI,IP,001,17,11750,11750,6972,0,PERF
42013342910100,PI,IP,001,18,11800,11800,6972,0,PERF
42013342910100,PI,IP,001,19,11850,11850,6972,0,PERF
42013342910100,PI,IP,001,20,11900,11900,6972,0,PERF
42013342910100,PI,IP,001,21,11950,11950,6972,0,PERF
42013342910100,PI,IP,001,22,12000,12000,6972,0,PERF
42013342910100,PI,IP,001,23,12050,12050,6972,0,PERF
42013342910100,PI,IP,001,24,12100,12100,6972,0,PERF
42013342910100,PI,IP,001,25,12150,12150,6972,0,PERF
42013342910100,PI,IP,001,26,12200,12200,6972,0,PERF
42013342910100,PI,IP,001,27,12250,12250,6972,0,PERF
42013342910100,PI,IP,001,28,12300,12300,6972,0,PERF
42013342910100,PI,IP,001,29,12350,12350,6972,0,PERF
42013342910100,PI,IP,001,30,12400,12400,6972,0,PERF
42013342910100,PI,IP,001,31,12450,12450,6972,0,PERF
42013342910100,PI,IP,001,32,12500,12500,6972,0,PERF
42013342910100,PI,IP,001,33,12550,12550,6972,0,PERF
42013342910100,PI,IP,001,34,12600,12600,6972,0,PERF
42013342910100,PI,IP,001,35,12650,12650,6972,0,PERF
42013342910100,PI,IP,001,36,12700,12700,6972,0,PERF
42013342910100,PI,IP,001,37,12750,12750,6972,0,PERF
42013342910100,PI,IP,001,38,12800,12800,6972,0,PERF
42013342910100,PI,IP,001,39,12850,12850,6972,0,PERF
42013342910100,PI,IP,001,40,12900,12900,6972,0,PERF
42013342910100,PI,IP,001,41,12950,12950,6972,0,PERF
42013342910100,PI,IP,001,42,13000,13000,6972,0,PERF
42013342910100,PI,IP,001,43,13050,13050,6972,0,PERF
42013342910100,PI,IP,001,44,13100,13100,6972,0,PERF
42013342910100,PI,IP,001,45,13150,13150,6972,0,PERF
42013342910100,PI,IP,001,46,13200,13200,6972,0,PERF
42013342910100,PI,IP,001,47,13250,13250,6972,0,PERF
42013342910100,PI,IP,001,48,13300,13300,6972,0,PERF
42013342910100,PI,IP,001,49,13350,13350,6972,0,PERF
42013342910100,PI,IP,001,50,13400,13400,6972,0,PERF
42013342910100,PI,IP,001,51,13450,13450,6972,0,PERF
42013342910100,PI,IP,001,52,13500,13500,6972,0,PERF
42013342910100,PI,IP,001,53,13550,13550,6972,0,PERF
42013342910100,PI,IP,001,54,13600,13600,6972,0,PERF
42013342910100,PI,IP,001,55,13650,13650,6972,0,PERF
42013342910100,PI,IP,001,56,13700,13700,6972,0,PERF
42013342910100,PI,IP,001,57,13750,13750,6972,0,PERF
42013342910100,PI,IP,001,58,13800,13800,6972,0,PERF
42013342910100,PI,IP,001,59,13850,13850,6972,0,PERF
42013342910100,PI,IP,001,60,13900,13900,6972,0,PERF
42013342910100,PI,IP,001,61,13950,13950,6972,0,PERF
42013342910100,PI,IP,001,62,14000,14000,6972,0,PERF
42013342910100,PI,IP,001,63,14050,14050,6972,0,PERF
42013342910100,PI,IP,001,64,14100,14100,6972,0,PERF
42013342910100,PI,IP,001,65,14150,14150,6972,0,PERF
42013342910100,PI,IP,001,66,14200,14200,6972,0,PERF
42013342910100,PI,IP,001,67,14250,14250,6972,0,PERF
42013342910100,PI,IP,001,68,14300,14300,6972,0,PERF
42013342910100,PI,IP,001,69,14350,14350,6972,0,PERF
42013342910100,PI,IP,001,70,14400,14400,6972,0,PERF
42013342910100,PI,IP,001,71,14450,14450,6972,0,PERF
42013342910100,PI,IP,001,72,14500,14500,6972,0,PERF
42013342910100,PI,IP,001,73,14550,14550,6972,0,PERF
42013342910100,PI,IP,001,74,14600,14600,6972,0,PERF
42013342910100,PI,IP,001,75,14650,14650,6972,0,PERF
42013342910100,PI,IP,001,76,14700,14700,6972,0,PERF
42013342910100,PI,IP,001,77,14750,14750,6972,0,PERF
42013342910100,PI,IP,001,78,14800,14800,6972,0,PERF
42013342910100,PI,IP,001,79,14850,14850,6972,0,PERF
42013342910100,PI,IP,001,80,14900,14900,6972,0,PERF
42013342910100,PI,IP,001,81,14950,14950,6972,0,PERF
42013342910100,PI,IP,001,82,15000,15000,6972,0,PERF
42013342910100,PI,IP,001,83,15050,15050,6972,0,PERF
42013342910100,PI,IP,001,84,15100,15100,6972,0,PERF
42013342910100,PI,IP,001,85,15150,15150,6972,0,PERF
42013342910100,PI,IP,001,86,15200,15200,6972,0,PERF
42013342910100,PI,IP,001,87,15250,15250,6972,0,PERF
42013342910100,PI,IP,001,88,15300,15300,6972,0,PERF
42013342910100,PI,IP,001,89,15350,15350,6972,0,PERF
42013342910100,PI,IP,001,90,15400,15400,6972,0,PERF
42013342910100,PI,IP,001,91,15450,15450,6972,0,PERF
42013342910100,PI,IP,001,92,15500,15500,6972,0,PERF
42013342910100,PI,IP,001,93,15550,15550,6972,0,PERF
42013342910100,PI,IP,001,94,15600,15600,6972,0,PERF
42013342910100,PI,IP,001,95,15650,15650,6972,0,PERF
42013342910100,PI,IP,001,96,15700,15700,6972,0,PERF
42013342910100,PI,IP,001,97,15750,15750,6972,0,PERF
42013342910100,PI,IP,001,98,15800,15800,6972,0,PERF
42013342910100,PI,IP,001,99,15850,15850,6972,0,PERF
42013342910100,PI,IP,001,100,15900,15900,6972,0,PERF
42013342910100,PI,IP,001,101,15950,15950,6972,0,PERF
42013342910100,PI,IP,001,102,16000,16000,6972,0,PERF
42013342910100,PI,IP,001,103,16050,16050,6972,0,PERF
42013342910100,PI,IP,001,104,16100,16100,6972,0,PERF
42013342910100,PI,IP,001,105,16150,16150,6972,0,PERF
42013342910100,PI,IP,001,106,16200,16200,6972,0,PERF
42013342910100,PI,IP,001,107,16250,16250,6972,0,PERF
42013342910100,PI,IP,001,108,16300,16300,6972,0,PERF
42013342910100,PI,IP,001,109,16400,16400,6972,0,PERF
42013342910100,PI,IP,001,110,16450,16450,6972,0,PERF
42013342910100,PI,IP,001,111,16500,16500,6972,0,PERF
42013342910100,PI,IP,001,112,16550,16550,6972,0,PERF
42013342910100,PI,IP,001,113,16600,16600,6972,0,PERF
42013342910100,PI,IP,001,114,16650,16650,6972,0,PERF
42013343040000,PI,IP,001,1,8180,8183,4219,3,PERF
42013343040000,PI,IP,001,2,8285,8288,4219,3,PERF
42013343040000,PI,IP,001,3,8385,8391,4219,6,PERF
42013343040000,PI,IP,001,4,8490,8493,4219,3,PERF
42013343040000,PI,IP,001,5,8590,8593,4219,3,PERF
42013343040000,PI,IP,001,6,8685,8691,4219,6,PERF
42013343040000,PI,IP,001,7,8795,8798,4219,3,PERF
42013343040000,PI,IP,001,8,8895,8898,4219,3,PERF
42013343040000,PI,IP,001,9,8995,9001,4219,6,PERF
42013343040000,PI,IP,001,10,9100,9103,4219,3,PERF
42013343040000,PI,IP,001,11,9212,9215,4219,3,PERF
42013343040000,PI,IP,001,12,9306,9312,4219,6,PERF
42013343040000,PI,IP,001,13,9405,9408,4219,3,PERF
42013343040000,PI,IP,001,14,9505,9508,4219,3,PERF
42013343040000,PI,IP,001,15,9605,9611,4219,6,PERF
42013343040000,PI,IP,001,16,9713,9716,4219,3,PERF
42013343040000,PI,IP,001,17,9810,9813,4219,3,PERF
42013343040000,PI,IP,001,18,9910,9916,4219,6,PERF
42013343040000,PI,IP,001,19,10020,10023,4219,3,PERF
42013343040000,PI,IP,001,20,10117,10120,4219,3,PERF
42013343040000,PI,IP,001,21,10220,10226,4219,6,PERF
42013343040000,PI,IP,001,22,10330,10333,4219,3,PERF
42013343040000,PI,IP,001,23,10430,10433,4219,3,PERF
42013343040000,PI,IP,001,24,10524,10530,4219,6,PERF
42013343040000,PI,IP,001,25,10640,10643,4219,3,PERF
42013343040000,PI,IP,001,26,10740,10743,4219,3,PERF
42013343040000,PI,IP,001,27,10840,10846,4219,6,PERF
42013343040000,PI,IP,001,28,10950,10953,4219,3,PERF
42013343040000,PI,IP,001,29,11050,11053,4219,3,PERF
42013343040000,PI,IP,001,30,11150,11156,4219,6,PERF
42013343040000,PI,IP,001,31,11260,11263,4219,3,PERF
42013343040000,PI,IP,001,32,11360,11363,4219,3,PERF
42013343040000,PI,IP,001,33,11460,11466,4219,6,PERF
42013343040000,PI,IP,001,34,11561,11564,4219,3,PERF
42013343040000,PI,IP,001,35,11661,11664,4219,3,PERF
42013343040000,PI,IP,001,36,11761,11767,4219,6,PERF
42013343060000,PI,IP,001,1,10610,15634,5267,5024,PERF
42013343070000,PI,IP,001,1,10619,15374,5089,4755,PERF
42013343110000,PI,IP,001,1,8603,8820,5060,217,PERF
42013343110000,PI,IP,001,2,8893,9090,5060,197,PERF
42013343110000,PI,IP,001,3,9182,9399,5060,217,PERF
42013343110000,PI,IP,001,4,9472,9689,5060,217,PERF
42013343110000,PI,IP,001,5,9761,9978,5060,217,PERF
42013343110000,PI,IP,001,6,10084,10286,5060,202,PERF
42013343110000,PI,IP,001,7,10359,10558,5060,199,PERF
42013343110000,PI,IP,001,8,10630,10847,5060,217,PERF
42013343110000,PI,IP,001,9,10940,11110,5060,170,PERF
42013343110000,PI,IP,001,10,11202,11426,5060,224,PERF
42013343110000,PI,IP,001,11,11499,11716,5060,217,PERF
42013343110000,PI,IP,001,12,11788,12005,5060,217,PERF
42013343110000,PI,IP,001,13,12078,12295,5060,217,PERF
42013343110000,PI,IP,001,14,12443,12660,5060,217,PERF
42013343110000,PI,IP,001,15,12745,12890,5060,145,PERF
42013343140100,PI,IP,001,1,8690,8951,5599,261,PERF
42013343140100,PI,IP,001,2,9010,9271,5599,261,PERF
42013343140100,PI,IP,001,3,9331,9576,5599,245,PERF
42013343140100,PI,IP,001,4,9636,9881,5599,245,PERF
42013343140100,PI,IP,001,5,9950,10251,5599,301,PERF
42013343140100,PI,IP,001,6,10320,10561,5599,241,PERF
42013343140100,PI,IP,001,7,10632,10881,5599,249,PERF
42013343140100,PI,IP,001,8,10942,11311,5599,369,PERF
42013343140100,PI,IP,001,9,11382,11731,5599,349,PERF
42013343140100,PI,IP,001,10,11792,12021,5599,229,PERF
42013343140100,PI,IP,001,11,12078,12311,5599,233,PERF
42013343140100,PI,IP,001,12,12370,12611,5599,241,PERF
42013343140100,PI,IP,001,13,12672,12933,5599,261,PERF
42013343140100,PI,IP,001,14,13002,13263,5599,261,PERF
42013343140100,PI,IP,001,15,13332,13592,5599,260,PERF
42013343140100,PI,IP,001,16,13662,13847,5599,185,PERF
42013343150000,PI,IP,002,1,8571,10033,4609,1462,PERF
42013343150000,PI,IP,002,2,10133,12237,4609,2104,PERF
42013343150000,PI,IP,002,3,12429,12429,4609,0,PERF
42013343150000,PI,PT,001,1,8571,8796,4609,225,PERF
42013343150000,PI,PT,001,2,8871,9096,4609,225,PERF
42013343150000,PI,PT,001,3,9171,9396,4609,225,PERF
42013343150000,PI,PT,001,4,9471,9696,4609,225,PERF
42013343150000,PI,PT,001,5,9771,9996,4609,225,PERF
42013343160000,PI,IP,001,1,10198,14421,5509,4223,PERF
42013343180000,PI,IP,001,1,11032,15302,4870,4270,PERF
42013343190000,PI,IP,001,1,7380,8949,2217,1569,PERF
42013343210000,PI,IP,001,1,11070,15902,5583,4832,PERF
42013343220000,PI,IP,001,1,10760,15452,5401,4692,PERF
42013343230000,PI,IP,001,1,10750,14322,4405,3572,PERF
42013343260000,PI,IP,001,1,11579,17414,8034,5835,PERF
42013343290000,PI,IP,001,1,7650,13000,5792,5350,PERF
42013343320000,PI,IP,001,1,8718,13290,4979,4572,PERF
42013343330000,PI,IP,001,1,10054,16356,6745,6302,PERF
42013343340100,PI,IP,001,1,7798,8045,5451,247,PERF
42013343340100,PI,IP,001,2,8121,8368,5451,247,PERF
42013343340100,PI,IP,001,3,8444,8692,5451,248,PERF
42013343340100,PI,IP,001,4,8768,9011,5451,243,PERF
42013343340100,PI,IP,001,5,9089,9338,5451,249,PERF
42013343340100,PI,IP,001,6,9414,9658,5451,244,PERF
42013343340100,PI,IP,001,7,9737,9984,5451,247,PERF
42013343340100,PI,IP,001,8,10060,10308,5451,248,PERF
42013343340100,PI,IP,001,9,10384,10631,5451,247,PERF
42013343340100,PI,IP,001,10,10707,10951,5451,244,PERF
42013343340100,PI,IP,001,11,11030,11274,5451,244,PERF
42013343340100,PI,IP,001,12,11353,11600,5451,247,PERF
42013343340100,PI,IP,001,13,11676,11924,5451,248,PERF
42013343340100,PI,IP,001,14,12000,12244,5451,244,PERF
42013343340100,PI,IP,001,15,12323,12570,5451,247,PERF
42013343350000,PI,IP,001,1,10005,14390,5293,4385,PERF
42013343380000,PI,IP,003,1,10870,15406,4576,4536,PERF
42013343380000,PI,PT,001,1,10870,11071,4576,201,PERF
42013343380000,PI,PT,001,2,11125,11356,4576,231,PERF
42013343380000,PI,PT,001,3,11635,11836,4576,201,PERF
42013343380000,PI,PT,001,4,11890,12091,4576,201,PERF
42013343380000,PI,PT,001,5,12145,12346,4576,201,PERF
42013343380000,PI,PT,001,6,12400,12601,4576,201,PERF
42013343380000,PI,PT,001,7,12655,12856,4576,201,PERF
42013343380000,PI,PT,001,8,12910,13111,4576,201,PERF
42013343380000,PI,PT,001,9,13165,13366,4576,201,PERF
42013343380000,PI,PT,001,10,13420,13621,4576,201,PERF
42013343380000,PI,PT,001,11,13675,13876,4576,201,PERF
42013343380000,PI,PT,001,12,13930,14131,4576,201,PERF
42013343380000,PI,PT,001,13,14185,14386,4576,201,PERF
42013343380000,PI,PT,001,14,14440,14641,4576,201,PERF
42013343380000,PI,PT,001,15,14708,14789,4576,81,PERF
42013343380000,PI,PT,001,16,14950,15151,4576,201,PERF
42013343380000,PI,PT,001,17,15205,15406,4576,201,PERF
42013343380000,PI,PT,002,18,10870,15406,4576,4536,PERF
42013343390000,PI,IP,004,1,10860,15141,4678,4281,PERF
42013343390000,PI,PT,001,1,10860,11061,4678,201,PERF
42013343390000,PI,PT,001,2,11115,11316,4678,201,PERF
42013343390000,PI,PT,001,3,11370,11571,4678,201,PERF
42013343390000,PI,PT,001,4,11625,11826,4678,201,PERF
42013343390000,PI,PT,001,5,11880,12081,4678,201,PERF
42013343390000,PI,PT,001,6,12135,12336,4678,201,PERF
42013343390000,PI,PT,001,7,12390,12591,4678,201,PERF
42013343390000,PI,PT,001,8,12645,12846,4678,201,PERF
42013343390000,PI,PT,001,9,12900,13101,4678,201,PERF
42013343390000,PI,PT,001,10,13155,13356,4678,201,PERF
42013343390000,PI,PT,001,11,13410,13611,4678,201,PERF
42013343390000,PI,PT,001,12,13665,13865,4678,200,PERF
42013343390000,PI,PT,001,13,13920,14121,4678,201,PERF
42013343390000,PI,PT,001,14,14175,14376,4678,201,PERF
42013343390000,PI,PT,001,15,14430,14630,4678,200,PERF
42013343390000,PI,PT,001,16,14940,15141,4678,201,PERF
42013343390000,PI,PT,002,17,10860,15141,4678,4281,PERF
42013343390000,PI,PT,003,18,10860,15141,4678,4281,PERF
42013343400000,PI,IP,001,1,11121,14861,4863,3740,PERF
42013343410000,PI,IP,004,1,10710,14929,4557,4219,PERF
42013343410000,PI,PT,001,1,10710,14929,4557,4219,PERF
42013343410000,PI,PT,002,2,10710,14929,4557,4219,PERF
42013343410000,PI,PT,003,3,10710,14929,4557,4219,PERF
42013343420000,PI,IP,004,1,10832,15354,4715,4522,PERF
42013343420000,PI,PT,001,1,10832,15354,4715,4522,PERF
42013343420000,PI,PT,002,2,10832,15354,4715,4522,PERF
42013343420000,PI,PT,003,3,10832,15354,4715,4522,PERF
42013343430000,PI,IP,005,1,11080,15614,4800,4534,PERF
42013343430000,PI,PT,001,1,11080,11334,4800,254,PERF
42013343430000,PI,PT,001,2,11385,11639,4800,254,PERF
42013343430000,PI,PT,001,3,11940,11991,4800,51,PERF
42013343430000,PI,PT,001,4,11995,12249,4800,254,PERF
42013343430000,PI,PT,001,5,12300,12554,4800,254,PERF
42013343430000,PI,PT,001,6,12605,12859,4800,254,PERF
42013343430000,PI,PT,001,7,12910,13164,4800,254,PERF
42013343430000,PI,PT,001,8,13215,13469,4800,254,PERF
42013343430000,PI,PT,001,9,13520,13774,4800,254,PERF
42013343430000,PI,PT,001,10,13825,14079,4800,254,PERF
42013343430000,PI,PT,001,11,14130,14384,4800,254,PERF
42013343430000,PI,PT,001,12,14435,14689,4800,254,PERF
42013343430000,PI,PT,001,13,14740,14994,4800,254,PERF
42013343430000,PI,PT,001,14,15045,15295,4800,250,PERF
42013343430000,PI,PT,001,15,15410,15614,4800,204,PERF
42013343430000,PI,PT,002,16,11080,15614,4800,4534,PERF
42013343430000,PI,PT,003,17,11080,15614,4800,4534,PERF
42013343430000,PI,PT,004,18,11080,15614,4800,4534,PERF
42013343440000,PI,IP,004,1,11600,15424,4839,3824,PERF
42013343440000,PI,PT,001,1,11600,11854,4839,254,PERF
42013343440000,PI,PT,001,2,11905,12159,4839,254,PERF
42013343440000,PI,PT,001,3,12210,12464,4839,254,PERF
42013343440000,PI,PT,001,4,12515,12769,4839,254,PERF
42013343440000,PI,PT,001,5,12820,13074,4839,254,PERF
42013343440000,PI,PT,001,6,13125,13379,4839,254,PERF
42013343440000,PI,PT,001,7,13430,13684,4839,254,PERF
42013343440000,PI,PT,001,8,13735,13985,4839,250,PERF
42013343440000,PI,PT,001,9,14040,14294,4839,254,PERF
42013343440000,PI,PT,001,10,14345,14599,4839,254,PERF
42013343440000,PI,PT,001,11,14650,14904,4839,254,PERF
42013343440000,PI,PT,001,12,14955,15209,4839,254,PERF
42013343440000,PI,PT,001,13,15260,15424,4839,164,PERF
42013343440000,PI,PT,002,14,11600,15424,4839,3824,PERF
42013343440000,PI,PT,003,15,11600,15424,4839,3824,PERF
42013343450000,PI,IP,001,1,7674,11520,5001,3846,PERF
42013343470000,PI,IP,001,1,11124,16306,5878,5182,PERF
42013343490000,PI,IP,001,1,10244,14664,4975,4420,PERF
42013343510000,PI,IP,001,1,11000,11150,6466,150,PERF
42013343510000,PI,IP,001,2,11200,11350,6466,150,PERF
42013343510000,PI,IP,001,3,11400,11550,6466,150,PERF
42013343510000,PI,IP,001,4,11600,11750,6466,150,PERF
42013343510000,PI,IP,001,5,11800,11950,6466,150,PERF
42013343510000,PI,IP,001,6,12000,12150,6466,150,PERF
42013343510000,PI,IP,001,7,12200,12350,6466,150,PERF
42013343510000,PI,IP,001,8,12400,12550,6466,150,PERF
42013343510000,PI,IP,001,9,12600,12750,6466,150,PERF
42013343510000,PI,IP,001,10,12800,12950,6466,150,PERF
42013343510000,PI,IP,001,11,13000,13150,6466,150,PERF
42013343510000,PI,IP,001,12,13200,13350,6466,150,PERF
42013343510000,PI,IP,001,13,13400,13550,6466,150,PERF
42013343510000,PI,IP,001,14,13600,13750,6466,150,PERF
42013343510000,PI,IP,001,15,13800,13950,6466,150,PERF
42013343510000,PI,IP,001,16,14000,14150,6466,150,PERF
42013343510000,PI,IP,001,17,14200,14350,6466,150,PERF
42013343510000,PI,IP,001,18,14400,14550,6466,150,PERF
42013343510000,PI,IP,001,19,14600,14750,6466,150,PERF
42013343510000,PI,IP,001,20,14800,14950,6466,150,PERF
42013343510000,PI,IP,001,21,15000,15150,6466,150,PERF
42013343510000,PI,IP,001,22,15200,15350,6466,150,PERF
42013343510000,PI,IP,001,23,15400,15550,6466,150,PERF
42013343510000,PI,IP,001,24,15600,15750,6466,150,PERF
42013343510000,PI,IP,001,25,15800,15950,6466,150,PERF
42013343510000,PI,IP,001,26,16000,16150,6466,150,PERF
42013343510000,PI,IP,001,27,16200,16350,6466,150,PERF
42013343510000,PI,IP,001,28,16400,16550,6466,150,PERF
42013343510000,PI,IP,001,29,16600,16750,6466,150,PERF
42013343520000,PI,IP,001,1,10169,14269,4613,4100,PERF
42013343530000,PI,IP,004,1,11369,16951,5930,5582,PERF
42013343530000,PI,PT,001,1,11369,11553,5930,184,PERF
42013343530000,PI,PT,001,2,11609,11913,5930,304,PERF
42013343530000,PI,PT,001,3,11969,12273,5930,304,PERF
42013343530000,PI,PT,001,4,12329,12633,5930,304,PERF
42013343530000,PI,PT,001,5,12689,12993,5930,304,PERF
42013343530000,PI,PT,001,6,13049,13353,5930,304,PERF
42013343530000,PI,PT,001,7,13409,13713,5930,304,PERF
42013343530000,PI,PT,001,8,13769,14073,5930,304,PERF
42013343530000,PI,PT,001,9,14129,14433,5930,304,PERF
42013343530000,PI,PT,001,10,14489,14793,5930,304,PERF
42013343530000,PI,PT,001,11,14849,15153,5930,304,PERF
42013343530000,PI,PT,001,12,15209,15509,5930,300,PERF
42013343530000,PI,PT,001,13,15569,15873,5930,304,PERF
42013343530000,PI,PT,001,14,15929,16233,5930,304,PERF
42013343530000,PI,PT,001,15,16289,16589,5930,300,PERF
42013343530000,PI,PT,001,16,16649,16951,5930,302,PERF
42013343530000,PI,PT,002,17,11369,16951,5930,5582,PERF
42013343530000,PI,PT,003,18,11369,16951,5930,5582,PERF
42013343540000,PI,IP,001,1,11152,17014,6601,5862,PERF
42013343550000,PI,IP,004,1,11351,16662,5844,5311,PERF
42013343550000,PI,PT,001,1,11351,11603,5844,252,PERF
42013343550000,PI,PT,001,2,11656,11908,5844,252,PERF
42013343550000,PI,PT,001,3,11961,12213,5844,252,PERF
42013343550000,PI,PT,001,4,12266,12516,5844,250,PERF
42013343550000,PI,PT,001,5,12571,12823,5844,252,PERF
42013343550000,PI,PT,001,6,12876,13128,5844,252,PERF
42013343550000,PI,PT,001,7,13181,13433,5844,252,PERF
42013343550000,PI,PT,001,8,13486,13738,5844,252,PERF
42013343550000,PI,PT,001,9,13791,14041,5844,250,PERF
42013343550000,PI,PT,001,10,14096,14348,5844,252,PERF
42013343550000,PI,PT,001,11,14401,14653,5844,252,PERF
42013343550000,PI,PT,001,12,14706,14965,5844,259,PERF
42013343550000,PI,PT,001,13,15011,15263,5844,252,PERF
42013343550000,PI,PT,001,14,15316,15568,5844,252,PERF
42013343550000,PI,PT,001,15,15621,15873,5844,252,PERF
42013343550000,PI,PT,001,16,15926,16178,5844,252,PERF
42013343550000,PI,PT,001,17,16231,16483,5844,252,PERF
42013343550000,PI,PT,001,18,16460,16662,5844,202,PERF
42013343550000,PI,PT,002,19,11351,16662,5844,5311,PERF
42013343550000,PI,PT,003,20,11351,16662,5844,5311,PERF
42013343590000,PI,IP,001,1,10570,15391,6025,4821,PERF
42013343600000,PI,IP,002,1,11004,15842,5217,4838,PERF
42013343600000,PI,PT,001,1,11004,11254,5217,250,PERF
42013343600000,PI,PT,001,2,11309,11559,5217,250,PERF
42013343600000,PI,PT,001,3,11614,11864,5217,250,PERF
42013343600000,PI,PT,001,4,12224,12474,5217,250,PERF
42013343600000,PI,PT,001,5,12529,12779,5217,250,PERF
42013343600000,PI,PT,001,6,12834,13084,5217,250,PERF
42013343600000,PI,PT,001,7,13139,13389,5217,250,PERF
42013343600000,PI,PT,001,8,13444,13694,5217,250,PERF
42013343600000,PI,PT,001,9,13749,13999,5217,250,PERF
42013343600000,PI,PT,001,10,14054,14304,5217,250,PERF
42013343600000,PI,PT,001,11,14359,14611,5217,252,PERF
42013343600000,PI,PT,001,12,14664,14916,5217,252,PERF
42013343600000,PI,PT,001,13,14969,15221,5217,252,PERF
42013343600000,PI,PT,001,14,15274,15526,5217,252,PERF
42013343600000,PI,PT,001,15,15590,15842,5217,252,PERF
42013343600000,PI,PT,001,16,15590,15790,5217,200,REPERF
42013343610000,PI,IP,002,1,11219,16921,6402,5702,PERF
42013343620000,PI,IP,001,1,9922,16883,7241,6961,PERF
42013343630000,PI,IP,001,1,10916,15084,5580,4168,PERF
42013343640000,PI,IP,004,1,10729,15252,4645,4523,PERF
42013343640000,PI,PT,001,1,10729,10983,4645,254,PERF
42013343640000,PI,PT,001,2,11034,11288,4645,254,PERF
42013343640000,PI,PT,001,3,11339,11593,4645,254,PERF
42013343640000,PI,PT,001,4,11644,11898,4645,254,PERF
42013343640000,PI,PT,001,5,12863,13118,4645,255,PERF
42013343640000,PI,PT,001,6,13169,13425,4645,256,PERF
42013343640000,PI,PT,001,7,13474,13728,4645,254,PERF
42013343640000,PI,PT,001,8,13779,14033,4645,254,PERF
42013343640000,PI,PT,001,9,14084,14338,4645,254,PERF
42013343640000,PI,PT,001,10,14389,14643,4645,254,PERF
42013343640000,PI,PT,001,11,14694,14948,4645,254,PERF
42013343640000,PI,PT,001,12,15000,15252,4645,252,PERF
42013343640000,PI,PT,002,13,10729,15252,4645,4523,PERF
42013343640000,PI,PT,003,14,10729,15252,4645,4523,PERF
42013343650000,PI,IP,001,1,10199,14731,5126,4532,PERF
42013343660000,PI,IP,001,1,10943,15446,,4503,PERF
42013343670000,PI,IP,001,1,10700,14874,4732,4174,PERF
42013343680000,PI,IP,001,1,10607,16449,6533,5842,PERF
42013343690000,PI,IP,002,1,12151,16366,5567,4215,PERF
42013343690000,PI,PT,001,1,12151,16366,5567,4215,PERF
42013343700000,PI,IP,001,1,10076,14801,5316,4725,PERF
42013343710000,PI,IP,003,1,11103,16655,6088,5552,PERF
42013343710000,PI,PT,001,1,11103,11304,6088,201,PERF
42013343710000,PI,PT,001,2,11358,11559,6088,201,PERF
42013343710000,PI,PT,001,3,11613,11814,6088,201,PERF
42013343710000,PI,PT,001,4,11868,12069,6088,201,PERF
42013343710000,PI,PT,001,5,12123,12324,6088,201,PERF
42013343710000,PI,PT,001,6,12378,12579,6088,201,PERF
42013343710000,PI,PT,001,7,12633,12834,6088,201,PERF
42013343710000,PI,PT,001,8,12888,13089,6088,201,PERF
42013343710000,PI,PT,001,9,13143,13344,6088,201,PERF
42013343710000,PI,PT,001,10,13398,13599,6088,201,PERF
42013343710000,PI,PT,001,11,13653,13854,6088,201,PERF
42013343710000,PI,PT,001,12,13908,14109,6088,201,PERF
42013343710000,PI,PT,001,13,14163,14364,6088,201,PERF
42013343710000,PI,PT,001,14,14418,14619,6088,201,PERF
42013343710000,PI,PT,001,15,14673,14874,6088,201,PERF
42013343710000,PI,PT,001,16,14928,15129,6088,201,PERF
42013343710000,PI,PT,001,17,15183,15384,6088,201,PERF
42013343710000,PI,PT,001,18,15438,15639,6088,201,PERF
42013343710000,PI,PT,001,19,15693,15894,6088,201,PERF
42013343710000,PI,PT,001,20,15948,16149,6088,201,PERF
42013343710000,PI,PT,001,21,16203,16404,6088,201,PERF
42013343710000,PI,PT,001,22,16455,16655,6088,200,PERF
42013343710000,PI,PT,002,23,11103,16655,6088,5552,PERF
42013343720000,PI,IP,003,1,11213,15612,5053,4399,PERF
42013343720000,PI,PT,001,1,11213,11465,5053,252,PERF
42013343720000,PI,PT,001,2,11513,11765,5053,252,PERF
42013343720000,PI,PT,001,3,11813,12065,5053,252,PERF
42013343720000,PI,PT,001,4,12113,12365,5053,252,PERF
42013343720000,PI,PT,001,5,12413,12665,5053,252,PERF
42013343720000,PI,PT,001,6,12713,12965,5053,252,PERF
42013343720000,PI,PT,001,7,13013,13265,5053,252,PERF
42013343720000,PI,PT,001,8,13313,13565,5053,252,PERF
42013343720000,PI,PT,001,9,13613,13865,5053,252,PERF
42013343720000,PI,PT,001,10,13913,14165,5053,252,PERF
42013343720000,PI,PT,001,11,14213,14465,5053,252,PERF
42013343720000,PI,PT,001,12,14513,14765,5053,252,PERF
42013343720000,PI,PT,001,13,14813,15065,5053,252,PERF
42013343720000,PI,PT,001,14,15113,15365,5053,252,PERF
42013343720000,PI,PT,001,15,15410,15612,5053,202,PERF
42013343720000,PI,PT,002,16,11213,15612,5053,4399,PERF
42013343730000,PI,IP,003,1,11172,16172,5721,5000,PERF
42013343730000,PI,PT,001,1,11172,11424,5721,252,PERF
42013343730000,PI,PT,001,2,11472,11724,5721,252,PERF
42013343730000,PI,PT,001,3,11772,12024,5721,252,PERF
42013343730000,PI,PT,001,4,12072,12324,5721,252,PERF
42013343730000,PI,PT,001,5,12372,12624,5721,252,PERF
42013343730000,PI,PT,001,6,12672,12924,5721,252,PERF
42013343730000,PI,PT,001,7,12972,13224,5721,252,PERF
42013343730000,PI,PT,001,8,13272,13524,5721,252,PERF
42013343730000,PI,PT,001,9,13572,13824,5721,252,PERF
42013343730000,PI,PT,001,10,13872,14124,5721,252,PERF
42013343730000,PI,PT,001,11,14172,14424,5721,252,PERF
42013343730000,PI,PT,001,12,14472,14724,5721,252,PERF
42013343730000,PI,PT,001,13,14772,15024,5721,252,PERF
42013343730000,PI,PT,001,14,15072,15324,5721,252,PERF
42013343730000,PI,PT,001,15,15372,15624,5721,252,PERF
42013343730000,PI,PT,001,16,15672,15924,5721,252,PERF
42013343730000,PI,PT,001,17,15970,16172,5721,202,PERF
42013343730000,PI,PT,002,18,11172,16172,5721,5000,PERF
42013343750000,PI,IP,001,1,10510,14803,4540,4293,PERF
42013343760000,PI,IP,001,1,10175,14735,5214,4560,PERF
42013343770000,PI,IP,001,1,8353,8375,5790,22,PERF
42013343770000,PI,IP,001,2,8634,8656,5790,22,PERF
42013343770000,PI,IP,001,3,8926,8949,5790,23,PERF
42013343770000,PI,IP,001,4,9228,9251,5790,23,PERF
42013343770000,PI,IP,001,5,9486,9508,5790,22,PERF
42013343770000,PI,IP,001,6,9786,9809,5790,23,PERF
42013343770000,PI,IP,001,7,10089,10111,5790,22,PERF
42013343770000,PI,IP,001,8,10392,10415,5790,23,PERF
42013343770000,PI,IP,001,9,10698,10721,5790,23,PERF
42013343770000,PI,IP,001,10,10996,11019,5790,23,PERF
42013343770000,PI,IP,001,11,11279,11302,5790,23,PERF
42013343770000,PI,IP,001,12,11583,11606,5790,23,PERF
42013343770000,PI,IP,001,13,11887,11910,5790,23,PERF
42013343770000,PI,IP,001,14,12145,12167,5790,22,PERF
42013343770000,PI,IP,001,15,12450,12473,5790,23,PERF
42013343780000,PI,IP,001,1,10545,14389,4175,3844,PERF
42013343810000,PI,IP,001,1,11090,15184,3903,4094,PERF
42013343820000,PI,IP,001,1,8565,8914,8023,349,PERF
42013343820000,PI,IP,001,2,8969,9318,8023,349,PERF
42013343820000,PI,IP,001,3,9373,9722,8023,349,PERF
42013343820000,PI,IP,001,4,9777,10126,8023,349,PERF
42013343820000,PI,IP,001,5,10181,10530,8023,349,PERF
42013343820000,PI,IP,001,6,10585,10934,8023,349,PERF
42013343820000,PI,IP,001,7,10989,11338,8023,349,PERF
42013343820000,PI,IP,001,8,11393,11742,8023,349,PERF
42013343820000,PI,IP,001,9,11797,12146,8023,349,PERF
42013343820000,PI,IP,001,10,12201,12550,8023,349,PERF
42013343820000,PI,IP,001,11,12605,12954,8023,349,PERF
42013343820000,PI,IP,001,12,13009,13358,8023,349,PERF
42013343820000,PI,IP,001,13,13413,13762,8023,349,PERF
42013343820000,PI,IP,001,14,13817,14166,8023,349,PERF
42013343820000,PI,IP,001,15,14221,14570,8023,349,PERF
42013343820000,PI,IP,001,16,14625,14974,8023,349,PERF
42013343820000,PI,IP,001,17,15029,15378,8023,349,PERF
42013343820000,PI,IP,001,18,15433,15666,8023,233,PERF
42013343830000,PI,IP,001,1,10030,14849,5735,4819,PERF
42013343840000,PI,IP,003,1,11103,16655,6097,5552,PERF
42013343840000,PI,PT,001,1,11103,11304,6097,201,PERF
42013343840000,PI,PT,001,2,11358,11559,6097,201,PERF
42013343840000,PI,PT,001,3,11613,11814,6097,201,PERF
42013343840000,PI,PT,001,4,11868,12069,6097,201,PERF
42013343840000,PI,PT,001,5,12123,12324,6097,201,PERF
42013343840000,PI,PT,001,6,12378,12579,6097,201,PERF
42013343840000,PI,PT,001,7,12633,12834,6097,201,PERF
42013343840000,PI,PT,001,8,12888,13089,6097,201,PERF
42013343840000,PI,PT,001,9,13143,13344,6097,201,PERF
42013343840000,PI,PT,001,10,13398,13599,6097,201,PERF
42013343840000,PI,PT,001,11,13653,13854,6097,201,PERF
42013343840000,PI,PT,001,12,13908,14109,6097,201,PERF
42013343840000,PI,PT,001,13,14163,14364,6097,201,PERF
42013343840000,PI,PT,001,14,14418,14619,6097,201,PERF
42013343840000,PI,PT,001,15,14673,14874,6097,201,PERF
42013343840000,PI,PT,001,16,14928,15129,6097,201,PERF
42013343840000,PI,PT,001,17,15183,15384,6097,201,PERF
42013343840000,PI,PT,001,18,15438,15639,6097,201,PERF
42013343840000,PI,PT,001,19,15693,15894,6097,201,PERF
42013343840000,PI,PT,001,20,15948,16149,6097,201,PERF
42013343840000,PI,PT,001,21,16203,16404,6097,201,PERF
42013343840000,PI,PT,001,22,16455,16655,6097,200,PERF
42013343840000,PI,PT,002,23,11103,16655,6097,5552,PERF
42013343850000,PI,IP,002,1,11138,16522,6077,5384,PERF
42013343850000,PI,PT,001,1,11138,11390,6077,252,PERF
42013343850000,PI,PT,001,2,11443,11695,6077,252,PERF
42013343850000,PI,PT,001,3,11748,12000,6077,252,PERF
42013343850000,PI,PT,001,4,12053,12305,6077,252,PERF
42013343850000,PI,PT,001,5,12358,12610,6077,252,PERF
42013343850000,PI,PT,001,6,12663,12915,6077,252,PERF
42013343850000,PI,PT,001,7,12968,13220,6077,252,PERF
42013343850000,PI,PT,001,8,13273,13525,6077,252,PERF
42013343850000,PI,PT,001,9,13578,13830,6077,252,PERF
42013343850000,PI,PT,001,10,13883,14153,6077,270,PERF
42013343850000,PI,PT,001,11,14188,14440,6077,252,PERF
42013343850000,PI,PT,001,12,14493,14745,6077,252,PERF
42013343850000,PI,PT,001,13,14798,15050,6077,252,PERF
42013343850000,PI,PT,001,14,15103,15355,6077,252,PERF
42013343850000,PI,PT,001,15,15408,15660,6077,252,PERF
42013343850000,PI,PT,001,16,15829,16081,6077,252,PERF
42013343850000,PI,PT,001,17,16320,16522,6077,202,PERF
42013343860000,PI,IP,003,1,11232,16618,6013,5386,PERF
42013343860000,PI,PT,001,1,11232,11484,6013,252,PERF
42013343860000,PI,PT,001,2,11537,11789,6013,252,PERF
42013343860000,PI,PT,001,3,11842,12094,6013,252,PERF
42013343860000,PI,PT,001,4,12147,12399,6013,252,PERF
42013343860000,PI,PT,001,5,12452,12704,6013,252,PERF
42013343860000,PI,PT,001,6,12757,13009,6013,252,PERF
42013343860000,PI,PT,001,7,13062,13314,6013,252,PERF
42013343860000,PI,PT,001,8,13367,13619,6013,252,PERF
42013343860000,PI,PT,001,9,13672,13924,6013,252,PERF
42013343860000,PI,PT,001,10,14282,14534,6013,252,PERF
42013343860000,PI,PT,001,11,14587,14839,6013,252,PERF
42013343860000,PI,PT,001,12,14881,15133,6013,252,PERF
42013343860000,PI,PT,001,13,15188,15440,6013,252,PERF
42013343860000,PI,PT,001,14,15495,15747,6013,252,PERF
42013343860000,PI,PT,001,15,15802,16054,6013,252,PERF
42013343860000,PI,PT,001,16,16109,16361,6013,252,PERF
42013343860000,PI,PT,001,17,16416,16618,6013,202,PERF
42013343860000,PI,PT,002,18,11232,16618,6013,5386,PERF
42013343870000,PI,IP,001,1,10657,15215,5682,4558,PERF
42013343920000,PI,IP,001,1,10975,11225,6853,250,PERF
42013343920000,PI,IP,001,2,11275,11525,6853,250,PERF
42013343920000,PI,IP,001,3,11725,11925,6853,200,PERF
42013343920000,PI,IP,001,4,11975,12225,6853,250,PERF
42013343920000,PI,IP,001,5,12275,12525,6853,250,PERF
42013343920000,PI,IP,001,6,12575,12825,6853,250,PERF
42013343920000,PI,IP,001,7,12875,13125,6853,250,PERF
42013343920000,PI,IP,001,8,13175,13425,6853,250,PERF
42013343920000,PI,IP,001,9,13475,13725,6853,250,PERF
42013343920000,PI,IP,001,10,13775,14025,6853,250,PERF
42013343920000,PI,IP,001,11,14075,14325,6853,250,PERF
42013343920000,PI,IP,001,12,14375,14625,6853,250,PERF
42013343920000,PI,IP,001,13,14675,14925,6853,250,PERF
42013343920000,PI,IP,001,14,14975,15225,6853,250,PERF
42013343920000,PI,IP,001,15,15275,15525,6853,250,PERF
42013343920000,PI,IP,001,16,15575,15825,6853,250,PERF
42013343920000,PI,IP,001,17,15875,16125,6853,250,PERF
42013343920000,PI,IP,001,18,16175,16425,6853,250,PERF
42013343920000,PI,IP,001,19,16475,16725,6853,250,PERF
42013343920000,PI,IP,001,20,16775,17025,6853,250,PERF
42013343940000,PI,IP,001,1,8635,8802,4542,167,PERF
42013343940000,PI,IP,001,2,8879,9042,4542,163,PERF
42013343940000,PI,IP,001,3,9115,9272,4542,157,PERF
42013343940000,PI,IP,001,4,9355,9522,4542,167,PERF
42013343940000,PI,IP,001,5,9605,9772,4542,167,PERF
42013343940000,PI,IP,001,6,9835,10042,4542,207,PERF
42013343940000,PI,IP,001,7,10075,10242,4542,167,PERF
42013343940000,PI,IP,001,8,10315,10542,4542,227,PERF
42013343940000,PI,IP,001,9,10615,10842,4542,227,PERF
42013343940000,PI,IP,001,10,10914,11095,4542,181,PERF
42013343940000,PI,IP,001,11,11160,11342,4542,182,PERF
42013343940000,PI,IP,001,12,11410,11592,4542,182,PERF
42013343940000,PI,IP,001,13,11780,11840,4542,60,PERF
42013343940000,PI,IP,001,14,11910,12090,4542,180,PERF
42013343960000,PI,IP,002,1,10787,14972,4739,4185,PERF
42013343960000,PI,PT,001,1,10787,14972,4739,4185,PERF
42013343980000,PI,IP,002,1,10868,14999,4726,4131,PERF
42013343980000,PI,PT,001,1,10868,11120,4726,252,PERF
42013343980000,PI,PT,001,2,11168,11420,4726,252,PERF
42013343980000,PI,PT,001,3,11468,11720,4726,252,PERF
42013343980000,PI,PT,001,4,11768,12020,4726,252,PERF
42013343980000,PI,PT,001,5,12068,12320,4726,252,PERF
42013343980000,PI,PT,001,6,12368,12620,4726,252,PERF
42013343980000,PI,PT,001,7,12668,12920,4726,252,PERF
42013343980000,PI,PT,001,8,12968,13220,4726,252,PERF
42013343980000,PI,PT,001,9,13268,13520,4726,252,PERF
42013343980000,PI,PT,001,10,13568,13820,4726,252,PERF
42013343980000,PI,PT,001,11,13868,14120,4726,252,PERF
42013343980000,PI,PT,001,12,14168,14420,4726,252,PERF
42013343980000,PI,PT,001,13,14468,14720,4726,252,PERF
42013343980000,PI,PT,001,14,14797,14999,4726,202,PERF
42013343990000,PI,IP,001,1,10820,18409,,7589,PERF
42013344000000,PI,IP,001,1,11026,15110,,4084,PERF
42013344010000,PI,IP,004,1,11086,15262,4652,4176,PERF
42013344010000,PI,PT,001,1,11086,11338,4652,252,PERF
42013344010000,PI,PT,001,2,11391,11643,4652,252,PERF
42013344010000,PI,PT,001,3,11696,11948,4652,252,PERF
42013344010000,PI,PT,001,4,12001,12153,4652,152,PERF
42013344010000,PI,PT,001,5,12306,12558,4652,252,PERF
42013344010000,PI,PT,001,6,12611,12863,4652,252,PERF
42013344010000,PI,PT,001,7,12916,13168,4652,252,PERF
42013344010000,PI,PT,001,8,13221,13473,4652,252,PERF
42013344010000,PI,PT,001,9,13526,13778,4652,252,PERF
42013344010000,PI,PT,001,10,13831,14083,4652,252,PERF
42013344010000,PI,PT,001,11,14136,14388,4652,252,PERF
42013344010000,PI,PT,001,12,14441,14693,4652,252,PERF
42013344010000,PI,PT,001,13,14746,14998,4652,252,PERF
42013344010000,PI,PT,001,14,15060,15262,4652,202,PERF
42013344010000,PI,PT,002,15,11086,15262,4652,4176,PERF
42013344010000,PI,PT,003,16,11086,15262,4652,4176,PERF
42013344030000,PI,IP,001,1,10650,18067,8155,7417,PERF
42013344040000,PI,IP,001,1,10585,16227,6274,5642,PERF
42013344070000,PI,IP,001,1,10950,16134,6387,5184,PERF
42013344090000,PI,IP,001,1,14380,14582,4151,202,PERF
42013344100000,PI,IP,001,1,10523,15729,5834,5206,PERF
42013344110000,PI,IP,001,1,10523,15729,5933,5206,PERF
42013344120000,PI,IP,001,1,11105,11607,4906,502,PERF
42013344120000,PI,IP,001,2,11655,11907,4906,252,PERF
42013344120000,PI,IP,001,3,11955,12207,4906,252,PERF
42013344120000,PI,IP,001,4,12255,12507,4906,252,PERF
42013344120000,PI,IP,001,5,12555,12807,4906,252,PERF
42013344120000,PI,IP,001,6,12855,13107,4906,252,PERF
42013344120000,PI,IP,001,7,13155,13407,4906,252,PERF
42013344120000,PI,IP,001,8,13455,13707,4906,252,PERF
42013344120000,PI,IP,001,9,13755,14007,4906,252,PERF
42013344120000,PI,IP,001,10,14055,14307,4906,252,PERF
42013344120000,PI,IP,001,11,14355,14607,4906,252,PERF
42013344120000,PI,IP,001,12,14655,14907,4906,252,PERF
42013344120000,PI,IP,001,13,15255,15457,4906,202,PERF
42013344130000,PI,IP,001,1,10450,14746,5113,4296,PERF
42013344160000,PI,IP,001,1,11081,11333,5188,252,PERF
42013344160000,PI,IP,001,2,11381,11633,5188,252,PERF
42013344160000,PI,IP,001,3,11681,11933,5188,252,PERF
42013344160000,PI,IP,001,4,11981,12233,5188,252,PERF
42013344160000,PI,IP,001,5,12281,12533,5188,252,PERF
42013344160000,PI,IP,001,6,12581,12833,5188,252,PERF
42013344160000,PI,IP,001,7,12881,13133,5188,252,PERF
42013344160000,PI,IP,001,8,13181,13433,5188,252,PERF
42013344160000,PI,IP,001,9,13481,13733,5188,252,PERF
42013344160000,PI,IP,001,10,13781,14033,5188,252,PERF
42013344160000,PI,IP,001,11,14081,14333,5188,252,PERF
42013344160000,PI,IP,001,12,14380,14632,5188,252,PERF
42013344160000,PI,IP,001,13,15470,15722,5188,252,PERF
42013344180000,PI,IP,002,1,11297,14857,4313,3560,PERF
42013344180000,PI,PT,001,1,11297,11549,4313,252,PERF
42013344180000,PI,PT,001,2,11602,11854,4313,252,PERF
42013344180000,PI,PT,001,3,11907,12159,4313,252,PERF
42013344180000,PI,PT,001,4,12212,12464,4313,252,PERF
42013344180000,PI,PT,001,5,12517,12769,4313,252,PERF
42013344180000,PI,PT,001,6,13127,13379,4313,252,PERF
42013344180000,PI,PT,001,7,13432,13684,4313,252,PERF
42013344180000,PI,PT,001,8,13737,13989,4313,252,PERF
42013344180000,PI,PT,001,9,14042,14294,4313,252,PERF
42013344180000,PI,PT,001,10,14347,14599,4313,252,PERF
42013344180000,PI,PT,001,11,14655,14857,4313,202,PERF
42013344200000,PI,IP,001,1,11200,11452,4492,252,PERF
42013344200000,PI,IP,001,2,11505,11757,4492,252,PERF
42013344200000,PI,IP,001,3,11810,12062,4492,252,PERF
42013344200000,PI,IP,001,4,12115,12367,4492,252,PERF
42013344200000,PI,IP,001,5,12420,12672,4492,252,PERF
42013344200000,PI,IP,001,6,12725,12977,4492,252,PERF
42013344200000,PI,IP,001,7,13030,13282,4492,252,PERF
42013344200000,PI,IP,001,8,13335,13587,4492,252,PERF
42013344200000,PI,IP,001,9,13640,13892,4492,252,PERF
42013344200000,PI,IP,001,10,13945,14197,4492,252,PERF
42013344200000,PI,IP,001,11,14250,14502,4492,252,PERF
42013344200000,PI,IP,001,12,14555,14757,4492,202,PERF
42013344210000,PI,IP,002,1,11815,15122,4325,3307,PERF
42013344210000,PI,PT,001,1,11815,12067,4325,252,PERF
42013344210000,PI,PT,001,2,12120,12372,4325,252,PERF
42013344210000,PI,PT,001,3,12425,12677,4325,252,PERF
42013344210000,PI,PT,001,4,12730,12982,4325,252,PERF
42013344210000,PI,PT,001,5,13035,13287,4325,252,PERF
42013344210000,PI,PT,001,6,13340,13592,4325,252,PERF
42013344210000,PI,PT,001,7,13645,13897,4325,252,PERF
42013344210000,PI,PT,001,8,13950,14202,4325,252,PERF
42013344210000,PI,PT,001,9,14255,14507,4325,252,PERF
42013344210000,PI,PT,001,10,14560,14812,4325,252,PERF
42013344210000,PI,PT,001,11,14870,15122,4325,252,PERF
42013344220000,PI,IP,001,1,7958,8200,4447,242,PERF
42013344220000,PI,IP,001,2,8258,8500,4447,242,PERF
42013344220000,PI,IP,001,3,8558,8800,4447,242,PERF
42013344220000,PI,IP,001,4,8858,9100,4447,242,PERF
42013344220000,PI,IP,001,5,9158,9400,4447,242,PERF
42013344220000,PI,IP,001,6,9458,9700,4447,242,PERF
42013344220000,PI,IP,001,7,9758,10000,4447,242,PERF
42013344220000,PI,IP,001,8,10058,10300,4447,242,PERF
42013344220000,PI,IP,001,9,10358,10600,4447,242,PERF
42013344220000,PI,IP,001,10,10658,10900,4447,242,PERF
42013344220000,PI,IP,001,11,10958,11200,4447,242,PERF
42013344220000,PI,IP,001,12,11258,11500,4447,242,PERF
42013344220000,PI,IP,001,13,11558,11800,4447,242,PERF
42013344220000,PI,IP,001,14,11858,12040,4447,182,PERF
42013344230000,PI,IP,001,1,11170,16552,5946,5382,PERF
42013344240000,PI,IP,001,1,9876,15406,5841,5530,PERF
42013344250000,PI,IP,001,1,11145,11378,4766,233,PERF
42013344250000,PI,IP,001,2,11445,11668,4766,223,PERF
42013344250000,PI,IP,001,3,11740,11968,4766,228,PERF
42013344250000,PI,IP,001,4,12030,12263,4766,233,PERF
42013344250000,PI,IP,001,5,12330,12558,4766,228,PERF
42013344250000,PI,IP,001,6,12625,12858,4766,233,PERF
42013344250000,PI,IP,001,7,12920,13148,4766,228,PERF
42013344250000,PI,IP,001,8,13212,13443,4766,231,PERF
42013344250000,PI,IP,001,9,13514,13738,4766,224,PERF
42013344250000,PI,IP,001,10,13805,14033,4766,228,PERF
42013344250000,PI,IP,001,11,14100,14328,4766,228,PERF
42013344250000,PI,IP,001,12,14395,14623,4766,228,PERF
42013344250000,PI,IP,001,13,14690,14890,4766,200,PERF
42013344260000,PI,IP,001,1,8698,15048,7498,6350,PERF
42013344270000,PI,IP,001,1,8526,15369,7873,6843,PERF
42013344280000,PI,IP,001,1,7917,8149,4735,232,PERF
42013344280000,PI,IP,001,2,8227,8455,4735,228,PERF
42013344280000,PI,IP,001,3,8537,8769,4735,232,PERF
42013344280000,PI,IP,001,4,8847,9079,4735,232,PERF
42013344280000,PI,IP,001,5,9161,9389,4735,228,PERF
42013344280000,PI,IP,001,6,9473,9699,4735,226,PERF
42013344280000,PI,IP,001,7,9775,10009,4735,234,PERF
42013344280000,PI,IP,001,8,10087,10319,4735,232,PERF
42013344280000,PI,IP,001,9,10397,10629,4735,232,PERF
42013344280000,PI,IP,001,10,10707,10935,4735,228,PERF
42013344280000,PI,IP,001,11,11017,11249,4735,232,PERF
42013344280000,PI,IP,001,12,11327,11559,4735,232,PERF
42013344280000,PI,IP,001,13,11642,11882,4735,240,PERF
42013344310000,PI,IP,001,1,8623,16269,8776,7646,PERF
42013344320000,PI,IP,001,1,8414,16456,8893,8042,PERF
42013344330000,PI,IP,001,1,10615,15123,4864,4508,PERF
42013344350000,PI,IP,001,1,10134,15270,5831,5136,PERF
42013344400000,PI,IP,001,1,11100,17412,6801,6312,PERF
42013344410000,PI,IP,001,1,10877,11095,4203,218,PERF
42013344410000,PI,IP,001,2,11111,11350,4203,239,PERF
42013344410000,PI,IP,001,3,11408,11605,4203,197,PERF
42013344410000,PI,IP,001,4,11663,11795,4203,132,PERF
42013344410000,PI,IP,001,5,11918,12113,4203,195,PERF
42013344410000,PI,IP,001,6,12428,12623,4203,195,PERF
42013344410000,PI,IP,001,7,12683,12880,4203,197,PERF
42013344410000,PI,IP,001,8,12938,13135,4203,197,PERF
42013344410000,PI,IP,001,9,13193,13388,4203,195,PERF
42013344410000,PI,IP,001,10,13448,13645,4203,197,PERF
42013344410000,PI,IP,001,11,13703,13900,4203,197,PERF
42013344410000,PI,IP,001,12,13958,14155,4203,197,PERF
42013344410000,PI,IP,001,13,14213,14410,4203,197,PERF
42013344410000,PI,IP,001,14,14597,14666,4203,69,PERF
42013344410000,PI,IP,001,15,14723,14920,4203,197,PERF
42013344450000,PI,IP,001,1,9890,10233,5674,343,PERF
42013344450000,PI,IP,001,2,10287,10630,5674,343,PERF
42013344450000,PI,IP,001,3,10684,11027,5674,343,PERF
42013344450000,PI,IP,001,4,11081,11424,5674,343,PERF
42013344450000,PI,IP,001,5,11478,11821,5674,343,PERF
42013344450000,PI,IP,001,6,11875,12218,5674,343,PERF
42013344450000,PI,IP,001,7,12272,12615,5674,343,PERF
42013344450000,PI,IP,001,8,12669,13012,5674,343,PERF
42013344450000,PI,IP,001,9,13066,13409,5674,343,PERF
42013344450000,PI,IP,001,10,13463,13806,5674,343,PERF
42013344450000,PI,IP,001,11,13860,14203,5674,343,PERF
42013344450000,PI,IP,001,12,14257,14600,5674,343,PERF
42013344450000,PI,IP,001,13,14654,14997,5674,343,PERF
42013344450000,PI,IP,001,14,15051,15337,5674,286,PERF
42013344470000,PI,IP,001,1,9110,15536,6837,6426,PERF
42013344480000,PI,IP,001,1,9285,15008,6238,5723,PERF
42013344520000,PI,IP,001,1,10223,15003,5479,4780,PERF
42013344530000,PI,IP,001,1,7994,12964,5998,4970,PERF
42013344540000,PI,IP,001,1,8068,12230,5013,4162,PERF
42013344550000,PI,IP,001,1,8297,13024,5641,4727,PERF
42013344560000,PI,IP,001,1,8410,16335,8529,7925,PERF
42013344570000,PI,IP,001,1,8753,15173,7928,6420,PERF
42013344580000,PI,IP,001,1,11130,11392,4080,262,PERF
42013344580000,PI,IP,001,2,11470,11757,4080,287,PERF
42013344580000,PI,IP,001,3,11835,12122,4080,287,PERF
42013344580000,PI,IP,001,4,12200,12487,4080,287,PERF
42013344580000,PI,IP,001,5,12565,12852,4080,287,PERF
42013344580000,PI,IP,001,6,12930,13217,4080,287,PERF
42013344580000,PI,IP,001,7,13295,13578,4080,283,PERF
42013344580000,PI,IP,001,8,13660,13947,4080,287,PERF
42013344580000,PI,IP,001,9,14025,14312,4080,287,PERF
42013344580000,PI,IP,001,10,14373,14645,4080,272,PERF
42013344610000,PI,IP,001,1,11105,11305,4805,200,PERF
42013344610000,PI,IP,001,2,11358,11575,4805,217,PERF
42013344610000,PI,IP,001,3,11629,11845,4805,216,PERF
42013344610000,PI,IP,001,4,11933,12115,4805,182,PERF
42013344610000,PI,IP,001,5,12170,12385,4805,215,PERF
42013344610000,PI,IP,001,6,12443,12665,4805,222,PERF
42013344610000,PI,IP,001,7,12713,12925,4805,212,PERF
42013344610000,PI,IP,001,8,12983,13195,4805,212,PERF
42013344610000,PI,IP,001,9,13253,13465,4805,212,PERF
42013344610000,PI,IP,001,10,13523,13735,4805,212,PERF
42013344610000,PI,IP,001,11,13793,14005,4805,212,PERF
42013344610000,PI,IP,001,12,14063,14275,4805,212,PERF
42013344610000,PI,IP,001,13,14333,14545,4805,212,PERF
42013344610000,PI,IP,001,14,14595,14815,4805,220,PERF
42013344610000,PI,IP,001,15,14873,15085,4805,212,PERF
42013344610000,PI,IP,001,16,15143,15383,4805,240,PERF
42013344620000,PI,IP,001,1,11125,11350,4232,225,PERF
42013344620000,PI,IP,001,2,11428,11655,4232,227,PERF
42013344620000,PI,IP,001,3,11733,11960,4232,227,PERF
42013344620000,PI,IP,001,4,12038,12265,4232,227,PERF
42013344620000,PI,IP,001,5,12343,12570,4232,227,PERF
42013344620000,PI,IP,001,6,12648,12875,4232,227,PERF
42013344620000,PI,IP,001,7,12948,13178,4232,230,PERF
42013344620000,PI,IP,001,8,13258,13485,4232,227,PERF
42013344620000,PI,IP,001,9,13563,13782,4232,219,PERF
42013344620000,PI,IP,001,10,13868,14095,4232,227,PERF
42013344620000,PI,IP,001,11,14173,14400,4232,227,PERF
42013344620000,PI,IP,001,12,14478,14705,4232,227,PERF
42013344620000,PI,IP,001,13,14783,14945,4232,162,PERF
42013344630000,PI,IP,001,1,10772,15829,6320,5057,PERF
42013344640000,PI,IP,001,1,10322,16735,6799,6413,PERF
42013344650000,PI,IP,001,1,10558,15222,5399,4664,PERF
42013344660000,PI,IP,001,1,10568,15252,5346,4684,PERF
42013344680000,PI,IP,001,1,9355,9724,7692,369,PERF
42013344680000,PI,IP,001,2,9755,10144,7692,389,PERF
42013344680000,PI,IP,001,3,10195,10564,7692,369,PERF
42013344680000,PI,IP,001,4,10615,10984,7692,369,PERF
42013344680000,PI,IP,001,5,11035,11404,7692,369,PERF
42013344680000,PI,IP,001,6,11455,11824,7692,369,PERF
42013344680000,PI,IP,001,7,11875,12244,7692,369,PERF
42013344680000,PI,IP,001,8,12295,12664,7692,369,PERF
42013344680000,PI,IP,001,9,12715,13084,7692,369,PERF
42013344680000,PI,IP,001,10,13135,13504,7692,369,PERF
42013344680000,PI,IP,001,11,13555,13924,7692,369,PERF
42013344680000,PI,IP,001,12,13975,14344,7692,369,PERF
42013344680000,PI,IP,001,13,14395,14764,7692,369,PERF
42013344680000,PI,IP,001,14,14815,15184,7692,369,PERF
42013344680000,PI,IP,001,15,15235,15604,7692,369,PERF
42013344680000,PI,IP,001,16,15655,16024,7692,369,PERF
42013344680000,PI,IP,001,17,16075,16444,7692,369,PERF
42013344690000,PI,IP,001,1,9165,9534,6990,369,PERF
42013344690000,PI,IP,001,2,9578,9947,6990,369,PERF
42013344690000,PI,IP,001,3,9991,10360,6990,369,PERF
42013344690000,PI,IP,001,4,10404,10773,6990,369,PERF
42013344690000,PI,IP,001,5,10817,11186,6990,369,PERF
42013344690000,PI,IP,001,6,11230,11599,6990,369,PERF
42013344690000,PI,IP,001,7,11643,12012,6990,369,PERF
42013344690000,PI,IP,001,8,12056,12425,6990,369,PERF
42013344690000,PI,IP,001,9,12469,12838,6990,369,PERF
42013344690000,PI,IP,001,10,12882,13251,6990,369,PERF
42013344690000,PI,IP,001,11,13295,13664,6990,369,PERF
42013344690000,PI,IP,001,12,13708,14077,6990,369,PERF
42013344690000,PI,IP,001,13,14121,14490,6990,369,PERF
42013344690000,PI,IP,001,14,14534,14903,6990,369,PERF
42013344690000,PI,IP,001,15,14947,15316,6990,369,PERF
42013344690000,PI,IP,001,16,15360,15729,6990,369,PERF
42013344710000,PI,IP,001,1,9310,9683,7632,373,PERF
42013344710000,PI,IP,001,2,9734,10103,7632,369,PERF
42013344710000,PI,IP,001,3,10154,10523,7632,369,PERF
42013344710000,PI,IP,001,4,10574,10943,7632,369,PERF
42013344710000,PI,IP,001,5,10994,11363,7632,369,PERF
42013344710000,PI,IP,001,6,11414,11783,7632,369,PERF
42013344710000,PI,IP,001,7,11834,12203,7632,369,PERF
42013344710000,PI,IP,001,8,12254,12623,7632,369,PERF
42013344710000,PI,IP,001,9,12674,13043,7632,369,PERF
42013344710000,PI,IP,001,10,13094,13463,7632,369,PERF
42013344710000,PI,IP,001,11,13514,13883,7632,369,PERF
42013344710000,PI,IP,001,12,13934,14303,7632,369,PERF
42013344710000,PI,IP,001,13,14354,14723,7632,369,PERF
42013344710000,PI,IP,001,14,14774,15143,7632,369,PERF
42013344710000,PI,IP,001,15,15194,15563,7632,369,PERF
42013344710000,PI,IP,001,16,15614,15983,7632,369,PERF
42013344720000,PI,IP,001,1,11290,11562,6037,272,PERF
42013344720000,PI,IP,001,2,11646,11912,6037,266,PERF
42013344720000,PI,IP,001,3,11990,12262,6037,272,PERF
42013344720000,PI,IP,001,4,12340,12612,6037,272,PERF
42013344720000,PI,IP,001,5,12690,12962,6037,272,PERF
42013344720000,PI,IP,001,6,13040,13312,6037,272,PERF
42013344720000,PI,IP,001,7,13390,13662,6037,272,PERF
42013344720000,PI,IP,001,8,13740,14012,6037,272,PERF
42013344720000,PI,IP,001,9,14090,14362,6037,272,PERF
42013344720000,PI,IP,001,10,14436,14712,6037,276,PERF
42013344720000,PI,IP,001,11,14790,15062,6037,272,PERF
42013344720000,PI,IP,001,12,15140,15412,6037,272,PERF
42013344720000,PI,IP,001,13,15481,15762,6037,281,PERF
42013344720000,PI,IP,001,14,15840,16112,6037,272,PERF
42013344720000,PI,IP,001,15,16190,16462,6037,272,PERF
42013344720000,PI,IP,001,16,16540,16812,6037,272,PERF
42013344720000,PI,IP,001,17,16890,17132,6037,242,PERF
42013344730000,PI,IP,001,1,9920,10257,6864,337,PERF
42013344730000,PI,IP,001,2,10301,10638,6864,337,PERF
42013344730000,PI,IP,001,3,10682,11019,6864,337,PERF
42013344730000,PI,IP,001,4,11063,11400,6864,337,PERF
42013344730000,PI,IP,001,5,11444,11781,6864,337,PERF
42013344730000,PI,IP,001,6,11825,12162,6864,337,PERF
42013344730000,PI,IP,001,7,12206,12543,6864,337,PERF
42013344730000,PI,IP,001,8,12587,12924,6864,337,PERF
42013344730000,PI,IP,001,9,12968,13305,6864,337,PERF
42013344730000,PI,IP,001,10,13349,13686,6864,337,PERF
42013344730000,PI,IP,001,11,13730,14067,6864,337,PERF
42013344730000,PI,IP,001,12,14111,14448,6864,337,PERF
42013344730000,PI,IP,001,13,14492,14829,6864,337,PERF
42013344730000,PI,IP,001,14,14873,15210,6864,337,PERF
42013344730000,PI,IP,001,15,15254,15591,6864,337,PERF
42013344730000,PI,IP,001,16,15635,15972,6864,337,PERF
42013344740000,PI,IP,001,1,9738,10075,6877,337,PERF
42013344740000,PI,IP,001,2,10114,10451,6877,337,PERF
42013344740000,PI,IP,001,3,10490,10827,6877,337,PERF
42013344740000,PI,IP,001,4,10866,11203,6877,337,PERF
42013344740000,PI,IP,001,5,11242,11579,6877,337,PERF
42013344740000,PI,IP,001,6,11618,11955,6877,337,PERF
42013344740000,PI,IP,001,7,11994,12331,6877,337,PERF
42013344740000,PI,IP,001,8,12370,12707,6877,337,PERF
42013344740000,PI,IP,001,9,12746,13083,6877,337,PERF
42013344740000,PI,IP,001,10,13122,13459,6877,337,PERF
42013344740000,PI,IP,001,11,13498,13835,6877,337,PERF
42013344740000,PI,IP,001,12,13874,14211,6877,337,PERF
42013344740000,PI,IP,001,13,14250,14587,6877,337,PERF
42013344740000,PI,IP,001,14,14626,14963,6877,337,PERF
42013344740000,PI,IP,001,15,15002,15339,6877,337,PERF
42013344740000,PI,IP,001,16,15378,15715,6877,337,PERF
42013344740000,PI,IP,001,17,15754,16091,6877,337,PERF
42013344760000,PI,IP,001,1,11380,11658,6101,278,PERF
42013344760000,PI,IP,001,2,11738,12008,6101,270,PERF
42013344760000,PI,IP,001,3,12090,12360,6101,270,PERF
42013344760000,PI,IP,001,4,12440,12712,6101,272,PERF
42013344760000,PI,IP,001,5,12792,13064,6101,272,PERF
42013344760000,PI,IP,001,6,13144,13416,6101,272,PERF
42013344760000,PI,IP,001,7,13496,13768,6101,272,PERF
42013344760000,PI,IP,001,8,13854,14120,6101,266,PERF
42013344760000,PI,IP,001,9,14200,14472,6101,272,PERF
42013344760000,PI,IP,001,10,14552,14824,6101,272,PERF
42013344760000,PI,IP,001,11,14904,15176,6101,272,PERF
42013344760000,PI,IP,001,12,15256,15528,6101,272,PERF
42013344760000,PI,IP,001,13,15608,15880,6101,272,PERF
42013344760000,PI,IP,001,14,15960,16232,6101,272,PERF
42013344760000,PI,IP,001,15,16312,16584,6101,272,PERF
42013344760000,PI,IP,001,16,16664,16936,6101,272,PERF
42013344770000,PI,IP,001,1,11264,11537,6091,273,PERF
42013344770000,PI,IP,001,2,11628,11890,6091,262,PERF
42013344770000,PI,IP,001,3,11978,12248,6091,270,PERF
42013344770000,PI,IP,001,4,12334,12605,6091,271,PERF
42013344770000,PI,IP,001,5,12691,12961,6091,270,PERF
42013344770000,PI,IP,001,6,13047,13318,6091,271,PERF
42013344770000,PI,IP,001,7,13404,13674,6091,270,PERF
42013344770000,PI,IP,001,8,13760,14031,6091,271,PERF
42013344770000,PI,IP,001,9,14118,14385,6091,267,PERF
42013344770000,PI,IP,001,10,14473,14744,6091,271,PERF
42013344770000,PI,IP,001,11,14830,15100,6091,270,PERF
42013344770000,PI,IP,001,12,15186,15457,6091,271,PERF
42013344770000,PI,IP,001,13,15543,15815,6091,272,PERF
42013344770000,PI,IP,001,14,15896,16172,6091,276,PERF
42013344770000,PI,IP,001,15,16256,16526,6091,270,PERF
42013344770000,PI,IP,001,16,16612,16794,6091,182,PERF
42013344780000,PI,IP,001,1,11235,11488,6028,253,PERF
42013344780000,PI,IP,001,2,11566,11820,6028,254,PERF
42013344780000,PI,IP,001,3,11900,12152,6028,252,PERF
42013344780000,PI,IP,001,4,12230,12482,6028,252,PERF
42013344780000,PI,IP,001,5,12560,12814,6028,254,PERF
42013344780000,PI,IP,001,6,12892,13150,6028,258,PERF
42013344780000,PI,IP,001,7,13224,13478,6028,254,PERF
42013344780000,PI,IP,001,8,13556,13810,6028,254,PERF
42013344780000,PI,IP,001,9,13888,14142,6028,254,PERF
42013344780000,PI,IP,001,10,14222,14474,6028,252,PERF
42013344780000,PI,IP,001,11,14552,14806,6028,254,PERF
42013344780000,PI,IP,001,12,14880,15138,6028,258,PERF
42013344780000,PI,IP,001,13,15216,15470,6028,254,PERF
42013344780000,PI,IP,001,14,15548,15802,6028,254,PERF
42013344780000,PI,IP,001,15,15880,16134,6028,254,PERF
42013344780000,PI,IP,001,16,16212,16466,6028,254,PERF
42013344780000,PI,IP,001,17,16542,16816,6028,274,PERF
42013344790000,PI,IP,001,1,10327,16683,6747,6356,PERF
42013344800000,PI,IP,001,1,11199,11446,6036,247,PERF
42013344800000,PI,IP,001,2,11524,11772,6036,248,PERF
42013344800000,PI,IP,001,3,11856,12098,6036,242,PERF
42013344800000,PI,IP,001,4,12176,12422,6036,246,PERF
42013344800000,PI,IP,001,5,12500,12748,6036,248,PERF
42013344800000,PI,IP,001,6,12826,13074,6036,248,PERF
42013344800000,PI,IP,001,7,13152,13400,6036,248,PERF
42013344800000,PI,IP,001,8,13478,13726,6036,248,PERF
42013344800000,PI,IP,001,9,13804,14052,6036,248,PERF
42013344800000,PI,IP,001,10,14130,14378,6036,248,PERF
42013344800000,PI,IP,001,11,14456,14704,6036,248,PERF
42013344800000,PI,IP,001,12,14782,15030,6036,248,PERF
42013344800000,PI,IP,001,13,15108,15356,6036,248,PERF
42013344800000,PI,IP,001,14,15434,15682,6036,248,PERF
42013344800000,PI,IP,001,15,15760,16008,6036,248,PERF
42013344800000,PI,IP,001,16,16086,16334,6036,248,PERF
42013344800000,PI,IP,001,17,16412,16684,6036,272,PERF
42013344810000,PI,IP,001,1,11255,17955,7455,6700,PERF
42013344820000,PI,IP,001,1,11419,17991,7402,6572,PERF
42013344830000,PI,IP,001,1,11378,11647,7322,269,PERF
42013344830000,PI,IP,001,2,11725,11994,7322,269,PERF
42013344830000,PI,IP,001,3,12072,12341,7322,269,PERF
42013344830000,PI,IP,001,4,12419,12682,7322,263,PERF
42013344830000,PI,IP,001,5,12760,13023,7322,263,PERF
42013344830000,PI,IP,001,6,13101,13364,7322,263,PERF
42013344830000,PI,IP,001,7,13442,13705,7322,263,PERF
42013344830000,PI,IP,001,8,13783,14044,7322,261,PERF
42013344830000,PI,IP,001,9,14124,14387,7322,263,PERF
42013344830000,PI,IP,001,10,14645,14738,7322,93,PERF
42013344830000,PI,IP,001,11,14806,15069,7322,263,PERF
42013344830000,PI,IP,001,12,15147,15410,7322,263,PERF
42013344830000,PI,IP,001,13,15492,15754,7322,262,PERF
42013344830000,PI,IP,001,14,15829,16092,7322,263,PERF
42013344830000,PI,IP,001,15,16170,16433,7322,263,PERF
42013344830000,PI,IP,001,16,16511,16774,7322,263,PERF
42013344830000,PI,IP,001,17,16852,17115,7322,263,PERF
42013344830000,PI,IP,001,18,17195,17454,7322,259,PERF
42013344830000,PI,IP,001,19,17534,17797,7322,263,PERF
42013344830000,PI,IP,001,20,17875,18147,7322,272,PERF
42013344840200,PI,IP,001,1,11500,17467,7392,5967,PERF
42013344850000,PI,IP,001,1,13553,13765,5979,212,PERF
42013344850000,PI,IP,001,2,13833,14045,5979,212,PERF
42013344850000,PI,IP,001,3,14113,14323,5979,210,PERF
42013344850000,PI,IP,001,4,14393,14605,5979,212,PERF
42013344850000,PI,IP,001,5,14673,14881,5979,208,PERF
42013344850000,PI,IP,001,6,14953,15165,5979,212,PERF
42013344850000,PI,IP,001,7,15233,15445,5979,212,PERF
42013344850000,PI,IP,001,8,15513,15725,5979,212,PERF
42013344850000,PI,IP,001,9,15787,16005,5979,218,PERF
42013344850000,PI,IP,001,10,16073,16285,5979,212,PERF
42013344850000,PI,IP,001,11,16353,16595,5979,242,PERF
42013344860000,PI,IP,001,1,9601,15787,6873,6186,PERF
42013344870000,PI,IP,001,1,11155,16608,6314,5453,PERF
42013344880000,PI,IP,001,1,11397,16209,5954,4812,PERF
42013344890000,PI,IP,001,1,9547,13050,5568,3503,PERF
42021316090000,PI,IP,001,1,6540,6550,,10,PERF
42025336250000,PI,IP,001,1,13621,13754,4097,133,PERF
42025336250000,PI,IP,001,2,13840,14018,4097,178,PERF
42025336250000,PI,IP,001,3,14083,14272,4097,189,PERF
42025336250000,PI,IP,001,4,14347,14536,4097,189,PERF
42025336250000,PI,IP,001,5,14604,14815,4097,211,PERF
42025336250000,PI,IP,001,6,14875,15065,4097,190,PERF
42025336250000,PI,IP,001,7,15144,15331,4097,187,PERF
42025336250000,PI,IP,001,8,15403,15602,4097,199,PERF
42025336250000,PI,IP,001,9,15667,15870,4097,203,PERF
42025336250000,PI,IP,001,10,15931,16123,4097,192,PERF
42025336250000,PI,IP,001,11,16195,16394,4097,199,PERF
42025336250000,PI,IP,001,12,16459,16700,4097,241,PERF
42025337170000,PI,IP,001,1,13153,17210,4036,4057,PERF
42025337210100,PI,IP,001,1,13174,13444,5477,270,PERF
42025337210100,PI,IP,001,2,13509,13779,5477,270,PERF
42025337210100,PI,IP,001,3,13844,14114,5477,270,PERF
42025337210100,PI,IP,001,4,14179,14449,5477,270,PERF
42025337210100,PI,IP,001,5,14514,14784,5477,270,PERF
42025337210100,PI,IP,001,6,14849,15119,5477,270,PERF
42025337210100,PI,IP,001,7,15184,15454,5477,270,PERF
42025337210100,PI,IP,001,8,15519,15789,5477,270,PERF
42025337210100,PI,IP,001,9,15854,16124,5477,270,PERF
42025337210100,PI,IP,001,10,16189,16459,5477,270,PERF
42025337210100,PI,IP,001,11,16524,16794,5477,270,PERF
42025337210100,PI,IP,001,12,16859,17129,5477,270,PERF
42025337210100,PI,IP,001,13,17194,17464,5477,270,PERF
42025337210100,PI,IP,001,14,17529,17799,5477,270,PERF
42025337210100,PI,IP,001,15,17864,18134,5477,270,PERF
42025337240000,PI,IP,001,1,12760,19053,6472,6293,PERF
42025337260000,PI,IP,001,1,13030,17789,5548,4759,PERF
42025337410000,PI,IP,001,1,13396,17120,4221,3724,PERF
42025337470000,PI,IP,001,1,13203,17780,5539,4577,PERF
42025337750000,PI,IP,001,1,13409,18761,6051,5352,PERF
42025337910000,PI,IP,001,1,13130,18677,5811,5547,PERF
42025337940000,PI,IP,001,1,13200,17996,6770,4796,PERF
42025337950000,PI,IP,001,1,13388,17214,4242,3826,PERF
42025337970000,PI,IP,001,1,13019,17766,5327,4747,PERF
17033200970000,PI,IP,001,1,17550,17554,,4,PERF
42041308310001,PI,IP,001,1,7610,7650,,40,PERF
42041308310001,PI,PT,001,1,7141,7212,,71,PERF
42041310460001,PI,IP,001,1,7399,7544,,145,PERF
42041311700000,PI,IP,001,1,7780,7786,,6,PERF
42041311700000,PI,IP,001,2,7790,7816,,26,PERF
42041311700000,PI,IP,001,3,7820,7826,,6,PERF
42041311700000,PI,IP,001,4,7834,7850,,16,PERF
42041311700000,PI,IP,001,5,7853,7878,,25,PERF
42041311700000,PI,IP,001,6,7884,7896,,12,PERF
42041311700000,PI,IP,001,7,7903,7930,,27,PERF
42041312500000,PI,IP,001,1,7704,7710,,6,PERF
42041312500000,PI,IP,001,2,7714,7744,,30,PERF
42041312500000,PI,IP,001,3,7782,7810,,28,PERF
42041312500000,PI,IP,001,4,7814,7826,,12,PERF
42041312500000,PI,IP,001,5,7832,7856,,24,PERF
42041320120000,PI,IP,001,1,9945,12085,3906,2140,PERF
42041320140100,PI,IP,001,1,14908,15227,3301,319,PERF
42041320160000,PI,IP,001,1,11932,15103,4083,3171,PERF
42041320800000,PI,IP,001,1,8702,13476,6153,4774,PERF
42041320840000,PI,IP,001,1,8140,13518,6024,5378,PERF
42041320920000,PI,IP,001,1,8263,8356,5450,93,PERF
42041320920000,PI,IP,001,2,8401,8552,5450,151,PERF
42041320920000,PI,IP,001,3,8602,8753,5450,151,PERF
42041320920000,PI,IP,001,4,8803,8954,5450,151,PERF
42041320920000,PI,IP,001,5,9004,9155,5450,151,PERF
42041320920000,PI,IP,001,6,9205,9356,5450,151,PERF
42041320920000,PI,IP,001,7,9406,9557,5450,151,PERF
42041320920000,PI,IP,001,8,9607,9758,5450,151,PERF
42041320920000,PI,IP,001,9,9808,9959,5450,151,PERF
42041320920000,PI,IP,001,10,10009,10160,5450,151,PERF
42041320920000,PI,IP,001,11,10210,10361,5450,151,PERF
42041320920000,PI,IP,001,12,10411,10562,5450,151,PERF
42041320920000,PI,IP,001,13,10612,10763,5450,151,PERF
42041320920000,PI,IP,001,14,10813,10964,5450,151,PERF
42041320920000,PI,IP,001,15,11014,11165,5450,151,PERF
42041320920000,PI,IP,001,16,11215,11366,5450,151,PERF
42041320920000,PI,IP,001,17,11416,11567,5450,151,PERF
42041320920000,PI,IP,001,18,11617,11768,5450,151,PERF
42041320920000,PI,IP,001,19,11818,11969,5450,151,PERF
42041320920000,PI,IP,001,20,12019,12170,5450,151,PERF
42041320920000,PI,IP,001,21,12220,12371,5450,151,PERF
42041320920000,PI,IP,001,22,12421,12572,5450,151,PERF
42041320920000,PI,IP,001,23,12622,12773,5450,151,PERF
42041320920000,PI,IP,001,24,12823,12974,5450,151,PERF
42041320920000,PI,IP,001,25,13024,13175,5450,151,PERF
42041320940000,PI,IP,001,1,8098,8099,6695,1,PERF
42041320940000,PI,IP,001,2,8120,8121,6695,1,PERF
42041320940000,PI,IP,001,3,8142,8143,6695,1,PERF
42041320940000,PI,IP,001,4,8164,8165,6695,1,PERF
42041320940000,PI,IP,001,5,8186,8187,6695,1,PERF
42041320940000,PI,IP,001,6,8208,8209,6695,1,PERF
42041320940000,PI,IP,001,7,8259,8260,6695,1,PERF
42041320940000,PI,IP,001,8,8289,8290,6695,1,PERF
42041320940000,PI,IP,001,9,8319,8320,6695,1,PERF
42041320940000,PI,IP,001,10,8349,8350,6695,1,PERF
42041320940000,PI,IP,001,11,8379,8380,6695,1,PERF
42041320940000,PI,IP,001,12,8409,8410,6695,1,PERF
42041320940000,PI,IP,001,13,8460,8461,6695,1,PERF
42041320940000,PI,IP,001,14,8490,8491,6695,1,PERF
42041320940000,PI,IP,001,15,8520,8521,6695,1,PERF
42041320940000,PI,IP,001,16,8550,8551,6695,1,PERF
42041320940000,PI,IP,001,17,8580,8581,6695,1,PERF
42041320940000,PI,IP,001,18,8610,8611,6695,1,PERF
42041320940000,PI,IP,001,19,8658,8659,6695,1,PERF
42041320940000,PI,IP,001,20,8691,8692,6695,1,PERF
42041320940000,PI,IP,001,21,8721,8722,6695,1,PERF
42041320940000,PI,IP,001,22,8754,8755,6695,1,PERF
42041320940000,PI,IP,001,23,8781,8782,6695,1,PERF
42041320940000,PI,IP,001,24,8811,8812,6695,1,PERF
42041320940000,PI,IP,001,25,8862,8863,6695,1,PERF
42041320940000,PI,IP,001,26,8892,8893,6695,1,PERF
42041320940000,PI,IP,001,27,8921,8922,6695,1,PERF
42041320940000,PI,IP,001,28,8952,8953,6695,1,PERF
42041320940000,PI,IP,001,29,8982,8983,6695,1,PERF
42041320940000,PI,IP,001,30,9010,9011,6695,1,PERF
42041320940000,PI,IP,001,31,9063,9064,6695,1,PERF
42041320940000,PI,IP,001,32,9093,9094,6695,1,PERF
42041320940000,PI,IP,001,33,9123,9124,6695,1,PERF
42041320940000,PI,IP,001,34,9153,9154,6695,1,PERF
42041320940000,PI,IP,001,35,9183,9184,6695,1,PERF
42041320940000,PI,IP,001,36,9213,9214,6695,1,PERF
42041320940000,PI,IP,001,37,9264,9265,6695,1,PERF
42041320940000,PI,IP,001,38,9294,9295,6695,1,PERF
42041320940000,PI,IP,001,39,9324,9325,6695,1,PERF
42041320940000,PI,IP,001,40,9354,9355,6695,1,PERF
42041320940000,PI,IP,001,41,9384,9385,6695,1,PERF
42041320940000,PI,IP,001,42,9414,9415,6695,1,PERF
42041320940000,PI,IP,001,43,9465,9466,6695,1,PERF
42041320940000,PI,IP,001,44,9499,9500,6695,1,PERF
42041320940000,PI,IP,001,45,9525,9526,6695,1,PERF
42041320940000,PI,IP,001,46,9555,9556,6695,1,PERF
42041320940000,PI,IP,001,47,9589,9590,6695,1,PERF
42041320940000,PI,IP,001,48,9615,9616,6695,1,PERF
42041320940000,PI,IP,001,49,9669,9670,6695,1,PERF
42041320940000,PI,IP,001,50,9696,9697,6695,1,PERF
42041320940000,PI,IP,001,51,9726,9727,6695,1,PERF
42041320940000,PI,IP,001,52,9759,9760,6695,1,PERF
42041320940000,PI,IP,001,53,9786,9787,6695,1,PERF
42041320940000,PI,IP,001,54,9816,9817,6695,1,PERF
42041320940000,PI,IP,001,55,9867,9868,6695,1,PERF
42041320940000,PI,IP,001,56,9897,9898,6695,1,PERF
42041320940000,PI,IP,001,57,9927,9928,6695,1,PERF
42041320940000,PI,IP,001,58,9957,9958,6695,1,PERF
42041320940000,PI,IP,001,59,9987,9988,6695,1,PERF
42041320940000,PI,IP,001,60,10017,10018,6695,1,PERF
42041320940000,PI,IP,001,61,10068,10069,6695,1,PERF
42041320940000,PI,IP,001,62,10098,10099,6695,1,PERF
42041320940000,PI,IP,001,63,10128,10129,6695,1,PERF
42041320940000,PI,IP,001,64,10158,10159,6695,1,PERF
42041320940000,PI,IP,001,65,10188,10189,6695,1,PERF
42041320940000,PI,IP,001,66,10218,10219,6695,1,PERF
42041320940000,PI,IP,001,67,10269,10270,6695,1,PERF
42041320940000,PI,IP,001,68,10299,10300,6695,1,PERF
42041320940000,PI,IP,001,69,10329,10330,6695,1,PERF
42041320940000,PI,IP,001,70,10359,10360,6695,1,PERF
42041320940000,PI,IP,001,71,10389,10390,6695,1,PERF
42041320940000,PI,IP,001,72,10419,10420,6695,1,PERF
42041320940000,PI,IP,001,73,10470,10471,6695,1,PERF
42041320940000,PI,IP,001,74,10500,10501,6695,1,PERF
42041320940000,PI,IP,001,75,10530,10531,6695,1,PERF
42041320940000,PI,IP,001,76,10560,10561,6695,1,PERF
42041320940000,PI,IP,001,77,10590,10591,6695,1,PERF
42041320940000,PI,IP,001,78,10620,10621,6695,1,PERF
42041320940000,PI,IP,001,79,10671,10672,6695,1,PERF
42041320940000,PI,IP,001,80,10701,10702,6695,1,PERF
42041320940000,PI,IP,001,81,10731,10732,6695,1,PERF
42041320940000,PI,IP,001,82,10761,10762,6695,1,PERF
42041320940000,PI,IP,001,83,10791,10792,6695,1,PERF
42041320940000,PI,IP,001,84,10821,10822,6695,1,PERF
42041320940000,PI,IP,001,85,10872,10873,6695,1,PERF
42041320940000,PI,IP,001,86,10902,10903,6695,1,PERF
42041320940000,PI,IP,001,87,10932,10933,6695,1,PERF
42041320940000,PI,IP,001,88,10962,10963,6695,1,PERF
42041320940000,PI,IP,001,89,10992,10993,6695,1,PERF
42041320940000,PI,IP,001,90,11022,11023,6695,1,PERF
42041320940000,PI,IP,001,91,11070,11071,6695,1,PERF
42041320940000,PI,IP,001,92,11103,11104,6695,1,PERF
42041320940000,PI,IP,001,93,11133,11134,6695,1,PERF
42041320940000,PI,IP,001,94,11163,11164,6695,1,PERF
42041320940000,PI,IP,001,95,11193,11194,6695,1,PERF
42041320940000,PI,IP,001,96,11223,11224,6695,1,PERF
42041320940000,PI,IP,001,97,11274,11275,6695,1,PERF
42041320940000,PI,IP,001,98,11304,11305,6695,1,PERF
42041320940000,PI,IP,001,99,11334,11335,6695,1,PERF
42041320940000,PI,IP,001,100,11364,11365,6695,1,PERF
42041320940000,PI,IP,001,101,11394,11395,6695,1,PERF
42041320940000,PI,IP,001,102,11420,11421,6695,1,PERF
42041320940000,PI,IP,001,103,11475,11476,6695,1,PERF
42041320940000,PI,IP,001,104,11505,11506,6695,1,PERF
42041320940000,PI,IP,001,105,11535,11536,6695,1,PERF
42041320940000,PI,IP,001,106,11565,11566,6695,1,PERF
42041320940000,PI,IP,001,107,11595,11596,6695,1,PERF
42041320940000,PI,IP,001,108,11625,11626,6695,1,PERF
42041320940000,PI,IP,001,109,11676,11677,6695,1,PERF
42041320940000,PI,IP,001,110,11706,11707,6695,1,PERF
42041320940000,PI,IP,001,111,11736,11737,6695,1,PERF
42041320940000,PI,IP,001,112,11766,11767,6695,1,PERF
42041320940000,PI,IP,001,113,11796,11797,6695,1,PERF
42041320940000,PI,IP,001,114,11829,11830,6695,1,PERF
42041320940000,PI,IP,001,115,11877,11878,6695,1,PERF
42041320940000,PI,IP,001,116,11904,11905,6695,1,PERF
42041320940000,PI,IP,001,117,11937,11938,6695,1,PERF
42041320940000,PI,IP,001,118,11967,11968,6695,1,PERF
42041320940000,PI,IP,001,119,12000,12001,6695,1,PERF
42041320940000,PI,IP,001,120,12027,12028,6695,1,PERF
42041320940000,PI,IP,001,121,12078,12079,6695,1,PERF
42041320940000,PI,IP,001,122,12108,12109,6695,1,PERF
42041320940000,PI,IP,001,123,12138,12139,6695,1,PERF
42041320940000,PI,IP,001,124,12166,12167,6695,1,PERF
42041320940000,PI,IP,001,125,12198,12199,6695,1,PERF
42041320940000,PI,IP,001,126,12228,12229,6695,1,PERF
42041320940000,PI,IP,001,127,12279,12280,6695,1,PERF
42041320940000,PI,IP,001,128,12309,12310,6695,1,PERF
42041320940000,PI,IP,001,129,12339,12340,6695,1,PERF
42041320940000,PI,IP,001,130,12369,12370,6695,1,PERF
42041320940000,PI,IP,001,131,12399,12400,6695,1,PERF
42041320940000,PI,IP,001,132,12429,12430,6695,1,PERF
42041320940000,PI,IP,001,133,12483,12484,6695,1,PERF
42041320940000,PI,IP,001,134,12510,12511,6695,1,PERF
42041320940000,PI,IP,001,135,12540,12541,6695,1,PERF
42041320940000,PI,IP,001,136,12573,12574,6695,1,PERF
42041320940000,PI,IP,001,137,12600,12601,6695,1,PERF
42041320940000,PI,IP,001,138,12630,12631,6695,1,PERF
42041320940000,PI,IP,001,139,12681,12682,6695,1,PERF
42041320940000,PI,IP,001,140,12711,12712,6695,1,PERF
42041320940000,PI,IP,001,141,12741,12742,6695,1,PERF
42041320940000,PI,IP,001,142,12771,12772,6695,1,PERF
42041320940000,PI,IP,001,143,12801,12802,6695,1,PERF
42041320940000,PI,IP,001,144,12828,12829,6695,1,PERF
42041320940000,PI,IP,001,145,12882,12883,6695,1,PERF
42041320940000,PI,IP,001,146,12912,12913,6695,1,PERF
42041320940000,PI,IP,001,147,12942,12943,6695,1,PERF
42041320940000,PI,IP,001,148,12972,12973,6695,1,PERF
42041320940000,PI,IP,001,149,13002,13003,6695,1,PERF
42041320940000,PI,IP,001,150,13032,13033,6695,1,PERF
42041320940000,PI,IP,001,151,13083,13084,6695,1,PERF
42041320940000,PI,IP,001,152,13113,13114,6695,1,PERF
42041320940000,PI,IP,001,153,13143,13144,6695,1,PERF
42041320940000,PI,IP,001,154,13173,13174,6695,1,PERF
42041320940000,PI,IP,001,155,13203,13204,6695,1,PERF
42041320940000,PI,IP,001,156,13233,13234,6695,1,PERF
42041320940000,PI,IP,001,157,13284,13285,6695,1,PERF
42041320940000,PI,IP,001,158,13314,13315,6695,1,PERF
42041320940000,PI,IP,001,159,13344,13345,6695,1,PERF
42041320940000,PI,IP,001,160,13374,13375,6695,1,PERF
42041320940000,PI,IP,001,161,13404,13405,6695,1,PERF
42041320940000,PI,IP,001,162,13434,13435,6695,1,PERF
42041320940000,PI,IP,001,163,13488,13489,6695,1,PERF
42041320940000,PI,IP,001,164,13515,13516,6695,1,PERF
42041320940000,PI,IP,001,165,13545,13546,6695,1,PERF
42041320940000,PI,IP,001,166,13577,13578,6695,1,PERF
42041320940000,PI,IP,001,167,13605,13606,6695,1,PERF
42041320940000,PI,IP,001,168,13635,13636,6695,1,PERF
42041320940000,PI,IP,001,169,13686,13687,6695,1,PERF
42041320940000,PI,IP,001,170,13716,13717,6695,1,PERF
42041320940000,PI,IP,001,171,13746,13747,6695,1,PERF
42041320940000,PI,IP,001,172,13776,13777,6695,1,PERF
42041320940000,PI,IP,001,173,13806,13807,6695,1,PERF
42041320940000,PI,IP,001,174,13834,13835,6695,1,PERF
42041320940000,PI,IP,001,175,13887,13888,6695,1,PERF
42041320940000,PI,IP,001,176,13917,13918,6695,1,PERF
42041320940000,PI,IP,001,177,13947,13948,6695,1,PERF
42041320940000,PI,IP,001,178,13977,13978,6695,1,PERF
42041320940000,PI,IP,001,179,14007,14008,6695,1,PERF
42041320940000,PI,IP,001,180,14037,14038,6695,1,PERF
42041320940000,PI,IP,001,181,14088,14089,6695,1,PERF
42041320940000,PI,IP,001,182,14118,14119,6695,1,PERF
42041320940000,PI,IP,001,183,14148,14149,6695,1,PERF
42041320940000,PI,IP,001,184,14178,14179,6695,1,PERF
42041320940000,PI,IP,001,185,14208,14209,6695,1,PERF
42041320940000,PI,IP,001,186,14238,14239,6695,1,PERF
42041320940000,PI,IP,001,187,14289,14290,6695,1,PERF
42041320940000,PI,IP,001,188,14319,14320,6695,1,PERF
42041320940000,PI,IP,001,189,14349,14350,6695,1,PERF
42041320940000,PI,IP,001,190,14379,14380,6695,1,PERF
42041320940000,PI,IP,001,191,14409,14410,6695,1,PERF
42041320940000,PI,IP,001,192,14439,14440,6695,1,PERF
42041320980000,PI,IP,001,1,7773,12431,5094,4658,PERF
42041320990000,PI,IP,001,1,8073,14887,7689,6814,PERF
42041321070000,PI,IP,001,1,8300,14244,6386,5944,PERF
42041321150000,PI,IP,001,1,7976,14080,6571,6104,PERF
42051307980000,PI,IP,001,1,8469,8603,,134,PERF
42051310090001,PI,IP,001,1,8710,8830,,120,PERF
42051314520001,PI,IP,001,1,7865,7954,,89,PERF
42051314850002,PI,IP,001,1,8840,8920,,80,PERF
42051314870001,PI,IP,002,1,10290,10410,,120,PERF
42051314870001,PI,PT,001,1,9986,10102,,116,OPENHOLE
42051315420001,PI,IP,001,1,8770,8870,,100,PERF
42051317330001,PI,IP,001,1,9940,10006,,66,PERF
42051317330001,PI,PT,002,1,9648,9756,,108,PERF
42051317330001,PI,PT,003,2,10083,10089,,6,PERF
42051317780002,PI,IP,001,1,7525,7686,,161,PERF
42051318100001,PI,IP,002,1,9005,9055,,50,PERF
42051318100001,PI,PT,001,1,8644,8776,,132,PERF
42051319750002,PI,IP,001,1,7800,8006,,206,PERF
42051321380001,PI,IP,001,1,8950,9044,,94,PERF
42051324150001,PI,IP,002,1,8860,8950,,90,PERF
42051324150001,PI,PT,001,1,8532,8654,,122,PERF
42051324200001,PI,IP,001,1,10320,10430,,110,PERF
42051330880100,PI,IP,001,1,9245,9255,,10,PERF
42051330880100,PI,IP,001,2,9495,9505,,10,PERF
42051330880100,PI,IP,001,3,9795,9805,,10,PERF
42051330880100,PI,IP,001,4,10050,10070,,20,PERF
42051330880100,PI,IP,001,5,10098,10101,,3,PERF
42051331310100,PI,IP,001,1,9780,13420,4910,3640,PERF
42051336380100,PI,IP,001,1,9765,12077,3483,2312,PERF
42051336400000,PI,IP,002,1,8485,9120,1437,635,PERF
42051336400000,PI,PT,001,1,8485,9120,1437,635,PERF
42051336420000,PI,IP,002,1,8215,9200,4036,985,PERF
42051336420000,PI,PT,001,1,8215,9200,4036,985,PERF
42051336430000,PI,IP,001,1,12489,13400,4449,911,PERF
42051336570000,PI,IP,001,1,7448,12214,4893,4766,OPENHOLE
42051336650000,PI,IP,001,1,6830,12291,5523,5461,OPENHOLE
42051336920000,PI,IP,001,1,5950,6091,,141,PERF
42051336920000,PI,IP,001,2,6560,6562,,2,PERF
42051336920000,PI,IP,001,3,6818,6865,,47,PERF
42051336980000,PI,IP,001,1,9048,9053,,5,PERF
42051336980000,PI,IP,001,2,9091,9096,,5,PERF
17085217740000,PI,PT,001,1,2302,2392,,90,OPENHOLE
17085220930000,PI,IP,001,1,3490,3504,,14,PERF
42123322020000,PI,IP,001,1,12970,16798,3508,3828,OPENHOLE
42123322310100,PI,IP,001,1,13470,17241,4531,3771,PERF
42123322520100,PI,IP,001,1,13554,16380,3979,2826,PERF
42123322550100,PI,IP,001,1,15500,16654,3612,1154,PERF
42123322610000,PI,IP,001,1,13950,18332,5215,4382,PERF
42123322810101,PI,IP,001,1,13919,13934,,15,PERF
42123322840000,PI,IP,001,1,13375,16375,3617,3000,PERF
42123322920000,PI,IP,001,1,13960,17479,3831,3519,PERF
42123322950000,PI,IP,001,1,14061,18050,4669,3989,PERF
42123322990000,PI,IP,001,1,14276,17941,4366,3665,PERF
42123323010000,PI,IP,001,1,13485,17020,4105,3535,PERF
42123323020000,PI,IP,001,1,14128,17650,4452,3522,PERF
42123323040000,PI,IP,001,1,12967,18440,,5473,PERF
42123323050000,PI,IP,001,1,13412,17879,5290,4467,PERF
42123323060000,PI,IP,001,1,12944,18351,,5407,PERF
42123323080100,PI,IP,001,1,13550,18506,5602,4956,PERF
42123323090000,PI,IP,001,1,13011,17959,5992,4948,PERF
42123323110000,PI,IP,001,1,13198,17286,4824,4088,PERF
42123323140000,PI,IP,001,1,12807,19075,,6268,PERF
42123323150000,PI,IP,001,1,14942,17510,4665,2568,PERF
42123323160000,PI,IP,001,1,13267,17748,5001,4481,PERF
42123323170000,PI,IP,002,1,13815,14060,4656,245,PERF
42123323170000,PI,IP,002,2,14120,14386,4656,266,PERF
42123323170000,PI,IP,002,3,14455,14723,4656,268,PERF
42123323170000,PI,IP,002,4,14792,15058,4656,266,PERF
42123323170000,PI,IP,002,5,15125,15395,4656,270,PERF
42123323170000,PI,IP,002,6,15562,15728,4656,166,PERF
42123323170000,PI,IP,002,7,15795,16065,4656,270,PERF
42123323170000,PI,IP,002,8,16130,16400,4656,270,PERF
42123323170000,PI,IP,002,9,16465,16735,4656,270,PERF
42123323170000,PI,PT,001,1,18146,18377,4656,231,PERF
42123323190000,PI,IP,001,1,12890,18641,5950,5751,PERF
42123323200000,PI,IP,001,1,13285,18725,6140,5440,PERF
42123323210000,PI,IP,001,1,14064,18362,4961,4298,PERF
42123323240100,PI,IP,001,1,13232,17712,5394,4480,PERF
42123323250000,PI,IP,001,1,13197,18522,6266,5325,PERF
42123323260000,PI,IP,001,1,12159,18809,6702,6650,PERF
42123323270000,PI,IP,001,1,13403,18351,5743,4948,PERF
42123323290000,PI,IP,001,1,13570,17212,4385,3642,PERF
42123323300000,PI,IP,001,1,13480,17106,4748,3626,PERF
42123323320000,PI,IP,001,1,13030,18699,6419,5669,PERF
42123323330000,PI,IP,001,1,13694,13971,,277,PERF
42123323330000,PI,IP,001,2,14049,14325,,276,PERF
42123323330000,PI,IP,001,3,14403,14680,,277,PERF
42123323330000,PI,IP,001,4,14758,15034,,276,PERF
42123323330000,PI,IP,001,5,15112,15389,,277,PERF
42123323330000,PI,IP,001,6,15467,15744,,277,PERF
42123323330000,PI,IP,001,7,16176,16453,,277,PERF
42123323330000,PI,IP,001,8,16531,16807,,276,PERF
42123323330000,PI,IP,001,9,16885,17157,,272,PERF
42123323330000,PI,IP,001,10,17240,17517,,277,PERF
42123323330000,PI,IP,001,11,17595,17871,,276,PERF
42123323330000,PI,IP,001,12,17952,18224,,272,PERF
42123323330000,PI,IP,001,13,18304,18580,,276,PERF
42123323330000,PI,IP,001,14,18658,18935,,277,PERF
42123323350000,PI,IP,001,1,13720,16739,3112,3019,PERF
42123323360000,PI,IP,001,1,12891,19175,6773,6284,PERF
42123323370000,PI,IP,001,1,13650,19210,5778,5560,PERF
42123323380000,PI,IP,001,1,13549,18497,5609,4948,PERF
42123323390100,PI,IP,001,1,13180,17324,5102,4144,PERF
42123323420000,PI,IP,001,1,14090,17800,4419,3710,PERF
42123323430000,PI,IP,001,1,13538,19280,6307,5742,PERF
42123323440000,PI,IP,001,1,13257,16687,4127,3430,PERF
42123323450000,PI,IP,001,1,14230,17592,4209,3362,PERF
42123323460000,PI,IP,001,1,13234,18182,5474,4948,PERF
42123323480000,PI,IP,001,1,13905,14170,5609,265,PERF
42123323480000,PI,IP,001,2,14250,14500,5609,250,PERF
42123323480000,PI,IP,001,3,14565,14830,5609,265,PERF
42123323480000,PI,IP,001,4,14895,15160,5609,265,PERF
42123323480000,PI,IP,001,5,15235,15490,5609,255,PERF
42123323480000,PI,IP,001,6,15555,15820,5609,265,PERF
42123323480000,PI,IP,001,7,15885,16150,5609,265,PERF
42123323480000,PI,IP,001,8,16215,16480,5609,265,PERF
42123323480000,PI,IP,001,9,16545,16810,5609,265,PERF
42123323480000,PI,IP,001,10,16875,17140,5609,265,PERF
42123323480000,PI,IP,001,11,17205,17470,5609,265,PERF
42123323480000,PI,IP,001,12,17535,17800,5609,265,PERF
42123323480000,PI,IP,001,13,17865,18130,5609,265,PERF
42123323480000,PI,IP,001,14,18196,18462,5609,266,PERF
42123323480000,PI,IP,001,15,18525,18780,5609,255,PERF
42123323490000,PI,IP,001,1,13850,17550,4124,3700,PERF
42123323500000,PI,IP,001,1,12464,18999,,6535,PERF
42123323510000,PI,IP,001,1,13399,17904,4937,4505,PERF
42123323520000,PI,IP,001,1,12976,18835,,5859,PERF
42123323530000,PI,IP,001,1,12543,16121,3766,3578,PERF
42123323550000,PI,IP,001,1,13003,17515,5137,4512,PERF
42123323560000,PI,IP,001,1,14013,18290,4848,4277,PERF
42123323570000,PI,IP,001,1,13186,17752,5286,4566,PERF
42123323580000,PI,IP,001,1,12838,18768,5957,5930,PERF
42123323590000,PI,IP,001,1,13794,18586,5220,4792,PERF
42123323600000,PI,IP,001,1,12762,18867,6890,6105,PERF
42123323610000,PI,IP,001,1,12485,17936,5993,5451,PERF
42123323620100,PI,IP,001,1,13799,17733,4933,3934,PERF
42123323640000,PI,IP,001,1,14741,17903,4385,3162,PERF
42123323650000,PI,IP,001,1,13240,18854,,5614,PERF
42123323660000,PI,IP,001,1,14230,19332,5711,5102,PERF
42123323670000,PI,IP,001,1,13023,19163,7372,6140,PERF
42123323680000,PI,IP,001,1,13902,18104,4820,4202,PERF
42123323700000,PI,IP,001,1,13321,18575,5513,5254,PERF
42123323720000,PI,IP,001,1,13648,19083,5646,5435,PERF
42123323730000,PI,IP,001,1,13093,17684,5474,4591,PERF
42123323740100,PI,IP,001,1,13078,17806,5705,4728,PERF
42123323750000,PI,IP,001,1,12828,17197,5298,4369,PERF
42123323760000,PI,IP,001,1,12844,18825,,5981,COMB
42123323770000,PI,IP,001,1,13760,18032,4530,4272,PERF
42123323780100,PI,IP,001,1,13871,19483,5812,5612,PERF
42123323800000,PI,IP,001,1,14097,18739,5255,4642,PERF
42123323810000,PI,IP,001,1,12104,16070,4195,3966,PERF
42123323820000,PI,IP,001,1,14443,19745,6121,5302,PERF
42123323840100,PI,IP,001,1,13788,18905,5700,5117,PERF
42123323850000,PI,IP,001,1,13770,18572,5351,4802,PERF
42123323860000,PI,IP,001,1,13677,18739,5566,5062,PERF
42123323870000,PI,IP,001,1,13327,13602,5898,275,PERF
42123323870000,PI,IP,001,2,13670,13942,5898,272,PERF
42123323870000,PI,IP,001,3,14040,14282,5898,242,PERF
42123323870000,PI,IP,001,4,14350,14622,5898,272,PERF
42123323870000,PI,IP,001,5,14690,14962,5898,272,PERF
42123323870000,PI,IP,001,6,15020,15302,5898,282,PERF
42123323870000,PI,IP,001,7,15370,15642,5898,272,PERF
42123323870000,PI,IP,001,8,15710,15982,5898,272,PERF
42123323870000,PI,IP,001,9,16050,16322,5898,272,PERF
42123323870000,PI,IP,001,10,16390,16662,5898,272,PERF
42123323870000,PI,IP,001,11,16730,17002,5898,272,PERF
42123323870000,PI,IP,001,12,17070,17342,5898,272,PERF
42123323870000,PI,IP,001,13,17410,17682,5898,272,PERF
42123323870000,PI,IP,001,14,17750,18022,5898,272,PERF
42123323870000,PI,IP,001,15,18090,18362,5898,272,PERF
42123323870000,PI,IP,001,16,18430,18702,5898,272,PERF
42123323880000,PI,IP,001,1,13232,17316,5017,4084,PERF
42123323890000,PI,IP,001,1,13584,17719,4456,4135,PERF
42123323900000,PI,IP,001,1,13641,19201,6296,5560,PERF
42123323910000,PI,IP,001,1,13957,18649,5363,4692,PERF
42123323920000,PI,IP,001,1,13836,18318,5140,4482,PERF
42123323930000,PI,IP,001,1,13484,17626,4158,4142,PERF
42123323940000,PI,IP,001,1,15110,19382,5877,4272,PERF
42123323950000,PI,IP,001,1,13959,19041,5693,5082,PERF
42123323960000,PI,IP,001,1,12332,16989,4887,4657,PERF
42123323970001,PI,IP,001,1,13658,19015,,5357,REPERF
42123323980000,PI,IP,001,1,12994,18057,6064,5063,PERF
42123323990000,PI,IP,001,1,12956,18246,6509,5290,PERF
42123324000000,PI,IP,001,1,13196,18960,6662,5764,PERF
42123324010000,PI,IP,001,1,14099,17381,3607,3282,PERF
42123324020000,PI,IP,001,1,12868,19040,7462,6172,PERF
42123324030000,PI,IP,001,1,14129,18836,5231,4707,PERF
42123324040000,PI,IP,001,1,13835,18277,5029,4442,PERF
42123324050000,PI,IP,001,1,12443,16881,4671,4438,PERF
42123324060000,PI,IP,001,1,12750,14969,2840,2219,PERF
42123324070000,PI,IP,001,1,13228,18379,5257,5151,PERF
42123324080000,PI,IP,001,1,15093,19222,5651,4129,PERF
42123324090000,PI,IP,001,1,14055,18900,5538,4845,PERF
42123324100000,PI,IP,001,1,13744,17951,4517,4207,PERF
42123324110000,PI,IP,001,1,13096,19994,7643,6898,PERF
42123324120000,PI,IP,001,1,13773,19233,6044,5460,PERF
42123324130000,PI,IP,002,1,13900,17775,4336,3875,PERF
42123324130000,PI,PT,001,1,13900,17775,4336,3875,PERF
42123324140000,PI,IP,001,1,13605,18646,5827,5041,PERF
42123324150000,PI,IP,001,1,13519,18092,4556,4573,PERF
42123324160000,PI,IP,001,1,14080,19402,5936,5322,PERF
42123324170000,PI,IP,001,1,13680,19775,6881,6095,PERF
42123324180000,PI,IP,001,1,14162,19062,5537,4900,PERF
42123324190000,PI,IP,001,1,14330,19652,6186,5322,PERF
42123324200000,PI,IP,001,1,13811,19987,7226,6176,PERF
42123324210000,PI,IP,001,1,13620,18872,6356,5252,PERF
42123324220000,PI,IP,001,1,13635,18697,5599,5062,PERF
42123324230000,PI,IP,001,1,14087,18350,5623,4263,PERF
42123324240000,PI,IP,001,1,13107,16457,3800,3350,PERF
42123324250000,PI,IP,001,1,13787,16220,4105,2433,PERF
42123324260000,PI,IP,001,1,13098,19111,6209,6013,PERF
42123324270000,PI,IP,001,1,12348,18611,6366,6263,PERF
42123324280000,PI,IP,001,1,13480,17783,4743,4303,PERF
42123324290000,PI,IP,001,1,13869,16819,3376,2950,PERF
42123324300000,PI,IP,001,1,12923,18549,6645,5626,PERF
42123324310000,PI,IP,001,1,13750,18232,5193,4482,PERF
42123324320000,PI,IP,001,1,13868,19531,,5663,PERF
42123324330000,PI,IP,001,1,13563,18289,,4726,PERF
42123324340000,PI,IP,001,1,12264,16127,3927,3863,PERF
42123324350000,PI,IP,001,1,13470,19143,6042,5673,PERF
42123324360000,PI,IP,001,1,13732,17789,4686,4057,PERF
42123324370000,PI,IP,001,1,13850,17912,4753,4062,PERF
42123324380000,PI,IP,001,1,13842,17829,4650,3987,PERF
42123324390000,PI,IP,001,1,13754,19212,7584,5458,PERF
42123324400000,PI,IP,001,1,12842,17542,5558,4700,PERF
42123324410000,PI,IP,001,1,12263,15693,3626,3430,PERF
42123324420000,PI,IP,001,1,13860,20022,6671,6162,PERF
42123324430000,PI,IP,001,1,13816,18283,4824,4467,PERF
42123324440000,PI,IP,001,1,13329,17673,4294,4344,PERF
42123324450000,PI,IP,001,1,14550,17632,4994,3082,PERF
42123324460000,PI,IP,001,1,13128,19341,6773,6213,PERF
42123324470000,PI,IP,001,1,13541,17451,4205,3910,PERF
42123324480000,PI,IP,001,1,13967,17150,,3183,PERF
42123324490000,PI,IP,001,1,13408,18442,5699,5034,PERF
42123324500000,PI,IP,001,1,13746,18674,5395,4928,PERF
42123324510000,PI,IP,001,1,13243,19053,5971,5810,PERF
42123324520000,PI,IP,001,1,14140,14393,4388,253,PERF
42123324520000,PI,IP,001,2,14471,14724,4388,253,PERF
42123324520000,PI,IP,001,3,14804,15055,4388,251,PERF
42123324520000,PI,IP,001,4,15133,15385,4388,252,PERF
42123324520000,PI,IP,001,5,15463,15716,4388,253,PERF
42123324520000,PI,IP,001,6,15794,16047,4388,253,PERF
42123324520000,PI,IP,001,7,16125,16378,4388,253,PERF
42123324520000,PI,IP,001,8,16465,16709,4388,244,PERF
42123324520000,PI,IP,001,9,16787,17038,4388,251,PERF
42123324520000,PI,IP,001,10,17118,17365,4388,247,PERF
42123324520000,PI,IP,001,11,17448,17701,4388,253,PERF
42123324520000,PI,IP,001,12,17779,18034,4388,255,PERF
42123324530000,PI,IP,001,1,12897,18485,6304,5588,PERF
42123324540000,PI,IP,001,1,13509,18629,5348,5120,PERF
42123324550000,PI,IP,001,1,13530,17943,5057,4413,PERF
42123324560000,PI,IP,001,1,13098,18422,,5324,PERF
42123324570100,PI,IP,001,1,12976,18395,6245,5419,PERF
42123324580100,PI,IP,001,1,13024,19071,7020,6047,PERF
42123324590000,PI,IP,001,1,13268,17772,5588,4504,PERF
42123324610000,PI,IP,001,1,13192,17666,6285,4474,PERF
42123324620000,PI,IP,001,1,13245,17539,,4294,PERF
42123324630000,PI,IP,001,1,13623,18849,5855,5226,PERF
42123324640000,PI,IP,001,1,13686,17474,4292,3788,PERF
42123324650000,PI,IP,001,1,13942,17733,4112,3791,PERF
42123324660000,PI,IP,001,1,12995,18551,5672,5556,PERF
42123324670000,PI,IP,001,1,13907,18370,4676,4463,PERF
42123324680000,PI,IP,001,1,13935,17575,4191,3640,PERF
42123324690000,PI,IP,001,1,12862,17829,5761,4967,PERF
42123324700000,PI,IP,001,1,13172,17690,5697,4518,PERF
42123324720000,PI,IP,001,1,12963,18551,5960,5588,PERF
42123324730100,PI,IP,001,1,13664,18953,5474,5289,PERF
42123324740000,PI,IP,001,1,13209,18153,5655,4944,PERF
42123324750000,PI,IP,001,1,13130,17801,5164,4671,PERF
42123324770000,PI,IP,001,1,13174,18430,5837,5256,PERF
42123324780000,PI,IP,001,1,13626,19088,5642,5462,PERF
42123324790000,PI,IP,001,1,13550,18802,5438,5252,PERF
42123324800000,PI,IP,001,1,13300,18374,5123,5074,PERF
42123324810000,PI,IP,001,1,13695,17692,4103,3997,PERF
42123324820000,PI,IP,001,1,14006,18607,,4601,PERF
42123324830000,PI,IP,001,1,13893,19335,5755,5442,PERF
42123324840000,PI,IP,001,1,13543,16655,3278,3112,PERF
42123324850000,PI,IP,001,1,13373,18521,,5148,PERF
42123324860000,PI,IP,001,1,13906,18200,5364,4294,PERF
42123324870000,PI,IP,001,1,13097,17536,,4439,PERF
42123324890000,PI,IP,001,1,13068,18297,6074,5229,PERF
42123324900000,PI,IP,001,1,13284,17864,,4580,PERF
42123324910000,PI,IP,001,1,13721,17978,5319,4257,PERF
42123324920000,PI,IP,001,1,13962,19325,5941,5363,PERF
42123324940000,PI,IP,001,1,13979,17585,4271,3606,PERF
42123324950000,PI,IP,002,1,12962,17905,5893,4943,PERF
42123324950000,PI,PT,001,1,12962,12964,5893,2,PERF
42123324950000,PI,PT,001,2,13074,13076,5893,2,PERF
42123324950000,PI,PT,001,3,13156,13158,5893,2,PERF
42123324950000,PI,PT,001,4,13240,13242,5893,2,PERF
42123324950000,PI,PT,001,5,13323,13325,5893,2,PERF
42123324950000,PI,PT,001,6,13407,13409,5893,2,PERF
42123324950000,PI,PT,001,7,13491,13493,5893,2,PERF
42123324950000,PI,PT,001,8,13570,13572,5893,2,PERF
42123324950000,PI,PT,001,9,13656,13658,5893,2,PERF
42123324950000,PI,PT,001,10,13742,13744,5893,2,PERF
42123324950000,PI,PT,001,11,13826,13828,5893,2,PERF
42123324950000,PI,PT,001,12,13909,13911,5893,2,PERF
42123324950000,PI,PT,001,13,13993,13995,5893,2,PERF
42123324950000,PI,PT,001,14,14077,14079,5893,2,PERF
42123324950000,PI,PT,001,15,14156,14158,5893,2,PERF
42123324950000,PI,PT,001,16,14244,14246,5893,2,PERF
42123324950000,PI,PT,001,17,14328,14330,5893,2,PERF
42123324950000,PI,PT,001,18,14411,14413,5893,2,PERF
42123324950000,PI,PT,001,19,14495,14497,5893,2,PERF
42123324950000,PI,PT,001,20,14579,14581,5893,2,PERF
42123324950000,PI,PT,001,21,14658,14660,5893,2,PERF
42123324950000,PI,PT,001,22,14746,14748,5893,2,PERF
42123324950000,PI,PT,001,23,14830,14832,5893,2,PERF
42123324950000,PI,PT,001,24,14913,14915,5893,2,PERF
42123324950000,PI,PT,001,25,14997,14999,5893,2,PERF
42123324950000,PI,PT,001,26,15081,15083,5893,2,PERF
42123324950000,PI,PT,001,27,15170,15172,5893,2,PERF
42123324950000,PI,PT,001,28,15246,15248,5893,2,PERF
42123324950000,PI,PT,001,29,15332,15334,5893,2,PERF
42123324950000,PI,PT,001,30,15416,15418,5893,2,PERF
42123324950000,PI,PT,001,31,15499,15501,5893,2,PERF
42123324950000,PI,PT,001,32,15583,15585,5893,2,PERF
42123324950000,PI,PT,001,33,15667,15669,5893,2,PERF
42123324950000,PI,PT,001,34,15750,15752,5893,2,PERF
42123324950000,PI,PT,001,35,15834,15836,5893,2,PERF
42123324950000,PI,PT,001,36,15918,15920,5893,2,PERF
42123324950000,PI,PT,001,37,16001,16003,5893,2,PERF
42123324950000,PI,PT,001,38,16085,16087,5893,2,PERF
42123324950000,PI,PT,001,39,16169,16171,5893,2,PERF
42123324950000,PI,PT,001,40,16250,16252,5893,2,PERF
42123324950000,PI,PT,001,41,16336,16338,5893,2,PERF
42123324950000,PI,PT,001,42,16420,16422,5893,2,PERF
42123324950000,PI,PT,001,43,16503,16505,5893,2,PERF
42123324950000,PI,PT,001,44,16587,16589,5893,2,PERF
42123324950000,PI,PT,001,45,16671,16673,5893,2,PERF
42123324950000,PI,PT,001,46,16750,16752,5893,2,PERF
42123324950000,PI,PT,001,47,16838,16840,5893,2,PERF
42123324950000,PI,PT,001,48,16922,16924,5893,2,PERF
42123324950000,PI,PT,001,49,17006,17008,5893,2,PERF
42123324950000,PI,PT,001,50,17089,17091,5893,2,PERF
42123324950000,PI,PT,001,51,17173,17175,5893,2,PERF
42123324950000,PI,PT,001,52,17250,17252,5893,2,PERF
42123324950000,PI,PT,001,53,17340,17342,5893,2,PERF
42123324950000,PI,PT,001,54,17424,17426,5893,2,PERF
42123324950000,PI,PT,001,55,17508,17510,5893,2,PERF
42123324950000,PI,PT,001,56,17591,17593,5893,2,PERF
42123324950000,PI,PT,001,57,17678,17680,5893,2,PERF
42123324950000,PI,PT,001,58,17753,17755,5893,2,PERF
42123324950000,PI,PT,001,59,17828,17830,5893,2,PERF
42123324950000,PI,PT,001,60,17903,17905,5893,2,PERF
42123324960000,PI,IP,001,1,13128,18124,5387,4996,PERF
42123324970000,PI,IP,001,1,13151,19111,6271,5960,PERF
42123324980100,PI,IP,001,1,13467,17761,4695,4294,PERF
42123325010000,PI,IP,001,1,14611,18264,4839,3653,PERF
42123325020000,PI,IP,001,1,13041,18163,5719,5122,PERF
42123325030000,PI,IP,001,1,12820,18183,,5363,PERF
42123325040000,PI,IP,001,1,12867,17045,5262,4178,PERF
42123325050000,PI,IP,001,1,13820,18561,,4741,PERF
42123325060000,PI,IP,001,1,13542,19062,5828,5520,PERF
42123325070000,PI,IP,001,1,12893,18106,,5213,PERF
42123325080000,PI,IP,001,1,13410,18760,5852,5350,PERF
42123325090000,PI,IP,001,1,13168,17683,,4515,PERF
42123325140000,PI,IP,001,1,13840,19302,5702,5462,PERF
42123325150000,PI,IP,001,1,13929,18347,5118,4418,PERF
42123325160000,PI,IP,001,1,13670,18301,4943,4631,PERF
42123325170000,PI,IP,001,1,13011,18207,6170,5196,PERF
42123325180000,PI,IP,001,1,13846,18571,5154,4725,PERF
42123325190100,PI,IP,001,1,13377,17570,4618,4193,PERF
42123325200000,PI,IP,001,1,13312,19536,,6224,PERF
42123325210000,PI,IP,001,1,13533,18203,4769,4670,PERF
42123325220000,PI,IP,001,1,13427,17781,4853,4354,PERF
42123325230000,PI,IP,001,1,12675,17584,,4909,PERF
42123325240000,PI,IP,001,1,12829,16753,4916,3924,PERF
42123325250000,PI,IP,001,1,13329,19616,6199,6287,PERF
42123325260000,PI,IP,001,1,12935,19795,7278,6860,PERF
42123325270000,PI,IP,001,1,12958,17400,,4442,PERF
42123325280000,PI,IP,001,1,13940,17649,4204,3709,PERF
42123325290000,PI,IP,001,1,12899,17350,5442,4451,PERF
42123325300000,PI,IP,001,1,13889,18477,5322,4588,PERF
42123325310000,PI,IP,001,1,13459,19067,7022,5608,PERF
42123325320000,PI,IP,001,1,13035,20350,7586,7315,PERF
42123325330000,PI,IP,001,1,13880,18783,5464,4903,PERF
42123325340000,PI,IP,001,1,13514,17721,,4207,PERF
42123325350000,PI,IP,001,1,12990,15954,3393,2964,PERF
42123325370000,PI,IP,001,1,15814,18027,,2213,PERF
42123325380000,PI,IP,001,1,13717,19761,6179,6044,PERF
42123325390000,PI,IP,001,1,13053,16668,3945,3615,PERF
42123325400000,PI,IP,001,1,13156,18374,6334,5218,PERF
42123325410000,PI,IP,001,1,13000,17215,4945,4215,PERF
42123325420000,PI,IP,001,1,13231,16559,5678,3328,PERF
42123325430000,PI,IP,001,1,13234,18408,5879,5174,PERF
42123325440000,PI,IP,001,1,13286,18458,5861,5172,PERF
42123325450000,PI,IP,001,1,13100,18551,5725,5451,PERF
42123325460000,PI,IP,001,1,14000,18480,5983,4480,PERF
42123325470000,PI,IP,001,1,13738,19080,5988,5342,PERF
42123325480000,PI,IP,001,1,13456,18158,,4702,PERF
42123325490100,PI,IP,001,1,13643,19002,5642,5359,PERF
42123325500000,PI,IP,001,1,13646,19009,,5363,PERF
42123325510000,PI,IP,001,1,13844,18349,5421,4505,PERF
42123325520000,PI,IP,001,1,14073,18192,,4119,PERF
42123325530000,PI,IP,001,1,13359,19486,,6127,PERF
42123325540000,PI,IP,001,1,13520,13642,5765,122,PERF
42123325540000,PI,IP,001,2,13700,13826,5765,126,PERF
42123325540000,PI,IP,001,3,13960,14202,5765,242,PERF
42123325540000,PI,IP,001,4,14260,14502,5765,242,PERF
42123325540000,PI,IP,001,5,14580,14822,5765,242,PERF
42123325540000,PI,IP,001,6,14902,15130,5765,228,PERF
42123325540000,PI,IP,001,7,15194,15362,5765,168,PERF
42123325540000,PI,IP,001,8,15420,15582,5765,162,PERF
42123325540000,PI,IP,001,9,15660,15982,5765,322,PERF
42123325540000,PI,IP,001,10,16240,16422,5765,182,PERF
42123325540000,PI,IP,001,11,16520,16842,5765,322,PERF
42123325540000,PI,IP,001,12,16926,17162,5765,236,PERF
42123325540000,PI,IP,001,13,17240,17402,5765,162,PERF
42123325540000,PI,IP,001,14,17460,17582,5765,122,PERF
42123325540000,PI,IP,001,15,17890,17992,5765,102,PERF
42123325540000,PI,IP,001,16,18060,18302,5765,242,PERF
42123325540000,PI,IP,001,17,18360,18622,5765,262,PERF
42123325550000,PI,IP,001,1,13555,17902,4952,4347,PERF
42123325560000,PI,IP,001,1,12715,18015,5997,5300,PERF
42123325570000,PI,IP,001,1,13173,18334,5498,5161,PERF
42123325580000,PI,IP,001,1,12560,17818,5992,5258,PERF
42123325590100,PI,IP,001,1,14085,19096,6049,5011,PERF
42123325600000,PI,IP,001,1,13800,19602,6080,5802,PERF
42123325610000,PI,IP,001,1,13031,18609,5520,5578,PERF
42123325620000,PI,IP,001,1,13160,18581,6784,5421,PERF
42123325640000,PI,IP,001,1,12823,17949,5634,5126,PERF
42123325650000,PI,IP,001,1,12949,18370,5356,5421,PERF
42123325660000,PI,IP,001,1,13670,18301,4779,4631,COMB
42123325670000,PI,IP,001,1,13301,18515,6233,5214,PERF
42123325680000,PI,IP,001,1,13780,19536,6383,5756,PERF
42123325690200,PI,IP,001,1,13288,17894,5349,4606,PERF
42123325700000,PI,IP,001,1,13974,18441,5052,4467,PERF
42123325710000,PI,IP,001,1,13590,18297,5020,4707,PERF
42123325720000,PI,IP,001,1,12822,17350,5844,4528,PERF
42123325750000,PI,IP,001,1,12809,18757,6500,5948,PERF
42123325760000,PI,IP,001,1,13790,19942,6463,6152,PERF
42123325770000,PI,IP,001,1,13602,19180,5747,5578,PERF
42123325780000,PI,IP,001,1,13417,18968,6041,5551,PERF
42123325790000,PI,IP,001,1,13050,18435,6725,5385,PERF
42123325800000,PI,IP,001,1,12870,16843,4511,3973,PERF
42123325820000,PI,IP,001,1,13400,18620,6446,5220,PERF
42123325840000,PI,IP,001,1,13137,18169,5902,5032,PERF
42123325850000,PI,IP,001,1,13185,18257,,5072,PERF
42123325860000,PI,IP,001,1,13471,16300,4069,2829,PERF
42123325870000,PI,IP,001,1,13418,16152,4017,2734,PERF
42123325880000,PI,IP,001,1,13708,16429,4086,2721,PERF
42123325890000,PI,IP,001,1,13588,16979,,3391,PERF
42123325900000,PI,IP,001,1,13920,17912,4447,3992,PERF
42123325910000,PI,IP,001,1,13705,19578,6336,5873,PERF
42123325920000,PI,IP,001,1,12923,17551,5520,4628,PERF
42123325930000,PI,IP,001,1,12902,17101,4476,4199,PERF
42123325940000,PI,IP,001,1,13222,17559,5743,4337,PERF
42123325950000,PI,IP,001,1,12840,17986,6025,5146,PERF
42123325960000,PI,IP,001,1,13865,18039,4750,4174,PERF
42123325970000,PI,IP,001,1,13728,18482,5519,4754,PERF
42123325980000,PI,IP,001,1,12893,17186,4469,4293,PERF
42123325990000,PI,IP,001,1,13185,17751,5342,4566,PERF
42123326000000,PI,IP,001,1,13404,18560,6244,5156,PERF
42123326020000,PI,IP,001,1,13090,17503,5604,4413,PERF
42123326030000,PI,IP,001,1,12924,12926,5807,2,PERF
42123326030000,PI,IP,001,2,13013,13015,5807,2,PERF
42123326030000,PI,IP,001,3,13095,13097,5807,2,PERF
42123326030000,PI,IP,001,4,13177,13179,5807,2,PERF
42123326030000,PI,IP,001,5,13258,13260,5807,2,PERF
42123326030000,PI,IP,001,6,13340,13342,5807,2,PERF
42123326030000,PI,IP,001,7,13424,13426,5807,2,PERF
42123326030000,PI,IP,001,8,13504,13506,5807,2,PERF
42123326030000,PI,IP,001,9,13586,13588,5807,2,PERF
42123326030000,PI,IP,001,10,13668,13670,5807,2,PERF
42123326030000,PI,IP,001,11,13750,13752,5807,2,PERF
42123326030000,PI,IP,001,12,13831,13833,5807,2,PERF
42123326030000,PI,IP,001,13,13913,13915,5807,2,PERF
42123326030000,PI,IP,001,14,13995,13997,5807,2,PERF
42123326030000,PI,IP,001,15,14077,14079,5807,2,PERF
42123326030000,PI,IP,001,16,14159,14161,5807,2,PERF
42123326030000,PI,IP,001,17,14241,14243,5807,2,PERF
42123326030000,PI,IP,001,18,14322,14324,5807,2,PERF
42123326030000,PI,IP,001,19,14404,14406,5807,2,PERF
42123326030000,PI,IP,001,20,14486,14488,5807,2,PERF
42123326030000,PI,IP,001,21,14568,14570,5807,2,PERF
42123326030000,PI,IP,001,22,14650,14652,5807,2,PERF
42123326030000,PI,IP,001,23,14732,14734,5807,2,PERF
42123326030000,PI,IP,001,24,14813,14815,5807,2,PERF
42123326030000,PI,IP,001,25,14895,14897,5807,2,PERF
42123326030000,PI,IP,001,26,14977,14979,5807,2,PERF
42123326030000,PI,IP,001,27,15059,15061,5807,2,PERF
42123326030000,PI,IP,001,28,15141,15143,5807,2,PERF
42123326030000,PI,IP,001,29,15223,15225,5807,2,PERF
42123326030000,PI,IP,001,30,15304,15306,5807,2,PERF
42123326030000,PI,IP,001,31,15386,15388,5807,2,PERF
42123326030000,PI,IP,001,32,15468,15470,5807,2,PERF
42123326030000,PI,IP,001,33,15550,15552,5807,2,PERF
42123326030000,PI,IP,001,34,15632,15634,5807,2,PERF
42123326030000,PI,IP,001,35,15714,15716,5807,2,PERF
42123326030000,PI,IP,001,36,15795,15797,5807,2,PERF
42123326030000,PI,IP,001,37,15877,15879,5807,2,PERF
42123326030000,PI,IP,001,38,15959,15961,5807,2,PERF
42123326030000,PI,IP,001,39,16041,16043,5807,2,PERF
42123326030000,PI,IP,001,40,16123,16125,5807,2,PERF
42123326030000,PI,IP,001,41,16205,16207,5807,2,PERF
42123326030000,PI,IP,001,42,16286,16288,5807,2,PERF
42123326030000,PI,IP,001,43,16368,16370,5807,2,PERF
42123326030000,PI,IP,001,44,16450,16452,5807,2,PERF
42123326030000,PI,IP,001,45,16532,16534,5807,2,PERF
42123326030000,PI,IP,001,46,16614,16616,5807,2,PERF
42123326030000,PI,IP,001,47,16696,16698,5807,2,PERF
42123326030000,PI,IP,001,48,16777,16779,5807,2,PERF
42123326030000,PI,IP,001,49,16859,16861,5807,2,PERF
42123326030000,PI,IP,001,50,16941,16943,5807,2,PERF
42123326030000,PI,IP,001,51,17023,17025,5807,2,PERF
42123326030000,PI,IP,001,52,17105,17107,5807,2,PERF
42123326030000,PI,IP,001,53,17187,17189,5807,2,PERF
42123326030000,PI,IP,001,54,17268,17270,5807,2,PERF
42123326030000,PI,IP,001,55,17350,17352,5807,2,PERF
42123326030000,PI,IP,001,56,17432,17434,5807,2,PERF
42123326030000,PI,IP,001,57,17514,17516,5807,2,PERF
42123326030000,PI,IP,001,58,17594,17596,5807,2,PERF
42123326030000,PI,IP,001,59,17674,17676,5807,2,PERF
42123326030000,PI,IP,001,60,17754,17756,5807,2,PERF
42123326040100,PI,IP,001,1,12969,12971,6074,2,PERF
42123326040100,PI,IP,001,2,13070,13072,6074,2,PERF
42123326040100,PI,IP,001,3,13155,13157,6074,2,PERF
42123326040100,PI,IP,001,4,13240,13242,6074,2,PERF
42123326040100,PI,IP,001,5,13325,13327,6074,2,PERF
42123326040100,PI,IP,001,6,13410,13412,6074,2,PERF
42123326040100,PI,IP,001,7,13496,13498,6074,2,PERF
42123326040100,PI,IP,001,8,13581,13583,6074,2,PERF
42123326040100,PI,IP,001,9,13666,13668,6074,2,PERF
42123326040100,PI,IP,001,10,13751,13753,6074,2,PERF
42123326040100,PI,IP,001,11,13836,13838,6074,2,PERF
42123326040100,PI,IP,001,12,13921,13923,6074,2,PERF
42123326040100,PI,IP,001,13,14006,14008,6074,2,PERF
42123326040100,PI,IP,001,14,14091,14093,6074,2,PERF
42123326040100,PI,IP,001,15,14176,14178,6074,2,PERF
42123326040100,PI,IP,001,16,14261,14263,6074,2,PERF
42123326040100,PI,IP,001,17,14346,14348,6074,2,PERF
42123326040100,PI,IP,001,18,14432,14434,6074,2,PERF
42123326040100,PI,IP,001,19,14517,14519,6074,2,PERF
42123326040100,PI,IP,001,20,14602,14604,6074,2,PERF
42123326040100,PI,IP,001,21,14687,14689,6074,2,PERF
42123326040100,PI,IP,001,22,14772,14774,6074,2,PERF
42123326040100,PI,IP,001,23,14857,14859,6074,2,PERF
42123326040100,PI,IP,001,24,14942,14944,6074,2,PERF
42123326040100,PI,IP,001,25,15027,15029,6074,2,PERF
42123326040100,PI,IP,001,26,15112,15114,6074,2,PERF
42123326040100,PI,IP,001,27,15197,15199,6074,2,PERF
42123326040100,PI,IP,001,28,15282,15284,6074,2,PERF
42123326040100,PI,IP,001,29,15368,15370,6074,2,PERF
42123326040100,PI,IP,001,30,15453,15455,6074,2,PERF
42123326040100,PI,IP,001,31,15538,15540,6074,2,PERF
42123326040100,PI,IP,001,32,15623,15625,6074,2,PERF
42123326040100,PI,IP,001,33,15708,15710,6074,2,PERF
42123326040100,PI,IP,001,34,15793,15795,6074,2,PERF
42123326040100,PI,IP,001,35,15878,15880,6074,2,PERF
42123326040100,PI,IP,001,36,15963,15965,6074,2,PERF
42123326040100,PI,IP,001,37,16048,16050,6074,2,PERF
42123326040100,PI,IP,001,38,16133,16135,6074,2,PERF
42123326040100,PI,IP,001,39,16218,16220,6074,2,PERF
42123326040100,PI,IP,001,40,16303,16305,6074,2,PERF
42123326040100,PI,IP,001,41,16389,16391,6074,2,PERF
42123326040100,PI,IP,001,42,16474,16476,6074,2,PERF
42123326040100,PI,IP,001,43,16559,16561,6074,2,PERF
42123326040100,PI,IP,001,44,16644,16646,6074,2,PERF
42123326040100,PI,IP,001,45,16729,16731,6074,2,PERF
42123326040100,PI,IP,001,46,16814,16816,6074,2,PERF
42123326040100,PI,IP,001,47,16899,16901,6074,2,PERF
42123326040100,PI,IP,001,48,16984,16986,6074,2,PERF
42123326040100,PI,IP,001,49,17069,17071,6074,2,PERF
42123326040100,PI,IP,001,50,17154,17156,6074,2,PERF
42123326040100,PI,IP,001,51,17239,17241,6074,2,PERF
42123326040100,PI,IP,001,52,17325,17327,6074,2,PERF
42123326040100,PI,IP,001,53,17410,17412,6074,2,PERF
42123326040100,PI,IP,001,54,17495,17497,6074,2,PERF
42123326040100,PI,IP,001,55,17580,17582,6074,2,PERF
42123326040100,PI,IP,001,56,17665,17667,6074,2,PERF
42123326040100,PI,IP,001,57,17750,17752,6074,2,PERF
42123326040100,PI,IP,001,58,17830,17832,6074,2,PERF
42123326040100,PI,IP,001,59,17910,17912,6074,2,PERF
42123326040100,PI,IP,001,60,17990,17992,6074,2,PERF
42123326050000,PI,IP,001,1,13221,13223,6005,2,PERF
42123326050000,PI,IP,001,2,13293,13295,6005,2,PERF
42123326050000,PI,IP,001,3,13370,13372,6005,2,PERF
42123326050000,PI,IP,001,4,13447,13449,6005,2,PERF
42123326050000,PI,IP,001,5,13523,13525,6005,2,PERF
42123326050000,PI,IP,001,6,13600,13602,6005,2,PERF
42123326050000,PI,IP,001,7,13677,13679,6005,2,PERF
42123326050000,PI,IP,001,8,13754,13756,6005,2,PERF
42123326050000,PI,IP,001,9,13831,13833,6005,2,PERF
42123326050000,PI,IP,001,10,13908,13910,6005,2,PERF
42123326050000,PI,IP,001,11,13985,13987,6005,2,PERF
42123326050000,PI,IP,001,12,14061,14063,6005,2,PERF
42123326050000,PI,IP,001,13,14138,14140,6005,2,PERF
42123326050000,PI,IP,001,14,14215,14217,6005,2,PERF
42123326050000,PI,IP,001,15,14292,14294,6005,2,PERF
42123326050000,PI,IP,001,16,14369,14371,6005,2,PERF
42123326050000,PI,IP,001,17,14446,14448,6005,2,PERF
42123326050000,PI,IP,001,18,14523,14525,6005,2,PERF
42123326050000,PI,IP,001,19,14599,14601,6005,2,PERF
42123326050000,PI,IP,001,20,14676,14678,6005,2,PERF
42123326050000,PI,IP,001,21,14753,14755,6005,2,PERF
42123326050000,PI,IP,001,22,14830,14832,6005,2,PERF
42123326050000,PI,IP,001,23,14907,14909,6005,2,PERF
42123326050000,PI,IP,001,24,14984,14986,6005,2,PERF
42123326050000,PI,IP,001,25,15061,15063,6005,2,PERF
42123326050000,PI,IP,001,26,15137,15139,6005,2,PERF
42123326050000,PI,IP,001,27,15214,15216,6005,2,PERF
42123326050000,PI,IP,001,28,15291,15293,6005,2,PERF
42123326050000,PI,IP,001,29,15368,15370,6005,2,PERF
42123326050000,PI,IP,001,30,15445,15447,6005,2,PERF
42123326050000,PI,IP,001,31,15522,15524,6005,2,PERF
42123326050000,PI,IP,001,32,15599,15601,6005,2,PERF
42123326050000,PI,IP,001,33,15675,15677,6005,2,PERF
42123326050000,PI,IP,001,34,15752,15754,6005,2,PERF
42123326050000,PI,IP,001,35,15829,15831,6005,2,PERF
42123326050000,PI,IP,001,36,15906,15908,6005,2,PERF
42123326050000,PI,IP,001,37,15983,15985,6005,2,PERF
42123326050000,PI,IP,001,38,16060,16062,6005,2,PERF
42123326050000,PI,IP,001,39,16137,16139,6005,2,PERF
42123326050000,PI,IP,001,40,16213,16215,6005,2,PERF
42123326050000,PI,IP,001,41,16290,16292,6005,2,PERF
42123326050000,PI,IP,001,42,16367,16369,6005,2,PERF
42123326050000,PI,IP,001,43,16444,16446,6005,2,PERF
42123326050000,PI,IP,001,44,16521,16523,6005,2,PERF
42123326050000,PI,IP,001,45,16598,16600,6005,2,PERF
42123326050000,PI,IP,001,46,16675,16677,6005,2,PERF
42123326050000,PI,IP,001,47,16751,16753,6005,2,PERF
42123326050000,PI,IP,001,48,16828,16830,6005,2,PERF
42123326050000,PI,IP,001,49,16905,16907,6005,2,PERF
42123326050000,PI,IP,001,50,16982,16984,6005,2,PERF
42123326050000,PI,IP,001,51,17059,17061,6005,2,PERF
42123326050000,PI,IP,001,52,17136,17138,6005,2,PERF
42123326050000,PI,IP,001,53,17213,17215,6005,2,PERF
42123326050000,PI,IP,001,54,17289,17291,6005,2,PERF
42123326050000,PI,IP,001,55,17366,17368,6005,2,PERF
42123326050000,PI,IP,001,56,17443,17445,6005,2,PERF
42123326050000,PI,IP,001,57,17520,17522,6005,2,PERF
42123326050000,PI,IP,001,58,17600,17602,6005,2,PERF
42123326050000,PI,IP,001,59,17680,17682,6005,2,PERF
42123326050000,PI,IP,001,60,17760,17762,6005,2,PERF
42123326060000,PI,IP,001,1,12972,12974,6947,2,PERF
42123326060000,PI,IP,001,2,13058,13060,6947,2,PERF
42123326060000,PI,IP,001,3,13144,13146,6947,2,PERF
42123326060000,PI,IP,001,4,13230,13232,6947,2,PERF
42123326060000,PI,IP,001,5,13322,13324,6947,2,PERF
42123326060000,PI,IP,001,6,13408,13410,6947,2,PERF
42123326060000,PI,IP,001,7,13494,13496,6947,2,PERF
42123326060000,PI,IP,001,8,13580,13582,6947,2,PERF
42123326060000,PI,IP,001,9,13672,13674,6947,2,PERF
42123326060000,PI,IP,001,10,13758,13760,6947,2,PERF
42123326060000,PI,IP,001,11,13844,13846,6947,2,PERF
42123326060000,PI,IP,001,12,13930,13932,6947,2,PERF
42123326060000,PI,IP,001,13,14022,14024,6947,2,PERF
42123326060000,PI,IP,001,14,14108,14110,6947,2,PERF
42123326060000,PI,IP,001,15,14194,14196,6947,2,PERF
42123326060000,PI,IP,001,16,14280,14282,6947,2,PERF
42123326060000,PI,IP,001,17,14372,14374,6947,2,PERF
42123326060000,PI,IP,001,18,14458,14460,6947,2,PERF
42123326060000,PI,IP,001,19,14544,14546,6947,2,PERF
42123326060000,PI,IP,001,20,14630,14632,6947,2,PERF
42123326060000,PI,IP,001,21,14722,14724,6947,2,PERF
42123326060000,PI,IP,001,22,14808,14810,6947,2,PERF
42123326060000,PI,IP,001,23,14894,14896,6947,2,PERF
42123326060000,PI,IP,001,24,14980,14982,6947,2,PERF
42123326060000,PI,IP,001,25,15072,15074,6947,2,PERF
42123326060000,PI,IP,001,26,15158,15160,6947,2,PERF
42123326060000,PI,IP,001,27,15244,15246,6947,2,PERF
42123326060000,PI,IP,001,28,15330,15332,6947,2,PERF
42123326060000,PI,IP,001,29,15422,15424,6947,2,PERF
42123326060000,PI,IP,001,30,15508,15510,6947,2,PERF
42123326060000,PI,IP,001,31,15594,15596,6947,2,PERF
42123326060000,PI,IP,001,32,15680,15682,6947,2,PERF
42123326060000,PI,IP,001,33,15772,15774,6947,2,PERF
42123326060000,PI,IP,001,34,15858,15860,6947,2,PERF
42123326060000,PI,IP,001,35,15944,15946,6947,2,PERF
42123326060000,PI,IP,001,36,16030,16032,6947,2,PERF
42123326060000,PI,IP,001,37,16122,16124,6947,2,PERF
42123326060000,PI,IP,001,38,16208,16210,6947,2,PERF
42123326060000,PI,IP,001,39,16294,16296,6947,2,PERF
42123326060000,PI,IP,001,40,16380,16382,6947,2,PERF
42123326060000,PI,IP,001,41,16472,16474,6947,2,PERF
42123326060000,PI,IP,001,42,16558,16560,6947,2,PERF
42123326060000,PI,IP,001,43,16644,16646,6947,2,PERF
42123326060000,PI,IP,001,44,16730,16732,6947,2,PERF
42123326060000,PI,IP,001,45,16822,16824,6947,2,PERF
42123326060000,PI,IP,001,46,16908,16910,6947,2,PERF
42123326060000,PI,IP,001,47,16994,16996,6947,2,PERF
42123326060000,PI,IP,001,48,17080,17082,6947,2,PERF
42123326060000,PI,IP,001,49,17172,17174,6947,2,PERF
42123326060000,PI,IP,001,50,17258,17260,6947,2,PERF
42123326060000,PI,IP,001,51,17344,17346,6947,2,PERF
42123326060000,PI,IP,001,52,17430,17432,6947,2,PERF
42123326060000,PI,IP,001,53,17522,17524,6947,2,PERF
42123326060000,PI,IP,001,54,17608,17610,6947,2,PERF
42123326060000,PI,IP,001,55,17694,17696,6947,2,PERF
42123326060000,PI,IP,001,56,17780,17782,6947,2,PERF
42123326060000,PI,IP,001,57,17872,17874,6947,2,PERF
42123326060000,PI,IP,001,58,17958,17960,6947,2,PERF
42123326060000,PI,IP,001,59,18044,18046,6947,2,PERF
42123326060000,PI,IP,001,60,18130,18132,6947,2,PERF
42123326060000,PI,IP,001,61,18222,18224,6947,2,PERF
42123326060000,PI,IP,001,62,18302,18304,6947,2,PERF
42123326060000,PI,IP,001,63,18382,18384,6947,2,PERF
42123326060000,PI,IP,001,64,18462,18464,6947,2,PERF
42123326070000,PI,IP,001,1,12992,12994,5929,2,PERF
42123326070000,PI,IP,001,2,13104,13106,5929,2,PERF
42123326070000,PI,IP,001,3,13191,13193,5929,2,PERF
42123326070000,PI,IP,001,4,13278,13280,5929,2,PERF
42123326070000,PI,IP,001,5,13366,13368,5929,2,PERF
42123326070000,PI,IP,001,6,13453,13455,5929,2,PERF
42123326070000,PI,IP,001,7,13541,13543,5929,2,PERF
42123326070000,PI,IP,001,8,13628,13630,5929,2,PERF
42123326070000,PI,IP,001,9,13716,13718,5929,2,PERF
42123326070000,PI,IP,001,10,13803,13805,5929,2,PERF
42123326070000,PI,IP,001,11,13890,13892,5929,2,PERF
42123326070000,PI,IP,001,12,13978,13980,5929,2,PERF
42123326070000,PI,IP,001,13,14065,14067,5929,2,PERF
42123326070000,PI,IP,001,14,14153,14155,5929,2,PERF
42123326070000,PI,IP,001,15,14240,14242,5929,2,PERF
42123326070000,PI,IP,001,16,14328,14330,5929,2,PERF
42123326070000,PI,IP,001,17,14415,14417,5929,2,PERF
42123326070000,PI,IP,001,18,14502,14504,5929,2,PERF
42123326070000,PI,IP,001,19,14590,14592,5929,2,PERF
42123326070000,PI,IP,001,20,14677,14679,5929,2,PERF
42123326070000,PI,IP,001,21,14765,14767,5929,2,PERF
42123326070000,PI,IP,001,22,14852,14854,5929,2,PERF
42123326070000,PI,IP,001,23,14939,14941,5929,2,PERF
42123326070000,PI,IP,001,24,15027,15029,5929,2,PERF
42123326070000,PI,IP,001,25,15114,15116,5929,2,PERF
42123326070000,PI,IP,001,26,15202,15204,5929,2,PERF
42123326070000,PI,IP,001,27,15289,15291,5929,2,PERF
42123326070000,PI,IP,001,28,15377,15379,5929,2,PERF
42123326070000,PI,IP,001,29,15464,15466,5929,2,PERF
42123326070000,PI,IP,001,30,15551,15553,5929,2,PERF
42123326070000,PI,IP,001,31,15639,15641,5929,2,PERF
42123326070000,PI,IP,001,32,15726,15728,5929,2,PERF
42123326070000,PI,IP,001,33,15814,15816,5929,2,PERF
42123326070000,PI,IP,001,34,15901,15903,5929,2,PERF
42123326070000,PI,IP,001,35,15989,15991,5929,2,PERF
42123326070000,PI,IP,001,36,16076,16078,5929,2,PERF
42123326070000,PI,IP,001,37,16163,16165,5929,2,PERF
42123326070000,PI,IP,001,38,16251,16253,5929,2,PERF
42123326070000,PI,IP,001,39,16338,16340,5929,2,PERF
42123326070000,PI,IP,001,40,16426,16428,5929,2,PERF
42123326070000,PI,IP,001,41,16513,16515,5929,2,PERF
42123326070000,PI,IP,001,42,16601,16603,5929,2,PERF
42123326070000,PI,IP,001,43,16688,16690,5929,2,PERF
42123326070000,PI,IP,001,44,16775,16777,5929,2,PERF
42123326070000,PI,IP,001,45,16863,16865,5929,2,PERF
42123326070000,PI,IP,001,46,16950,16952,5929,2,PERF
42123326070000,PI,IP,001,47,17038,17040,5929,2,PERF
42123326070000,PI,IP,001,48,17125,17127,5929,2,PERF
42123326070000,PI,IP,001,49,17213,17215,5929,2,PERF
42123326070000,PI,IP,001,50,17300,17302,5929,2,PERF
42123326070000,PI,IP,001,51,17387,17389,5929,2,PERF
42123326070000,PI,IP,001,52,17475,17477,5929,2,PERF
42123326070000,PI,IP,001,53,17562,17564,5929,2,PERF
42123326070000,PI,IP,001,54,17650,17652,5929,2,PERF
42123326070000,PI,IP,001,55,17737,17739,5929,2,PERF
42123326070000,PI,IP,001,56,17825,17827,5929,2,PERF
42123326070000,PI,IP,001,57,17912,17914,5929,2,PERF
42123326070000,PI,IP,001,58,17991,17993,5929,2,PERF
42123326070000,PI,IP,001,59,18071,18073,5929,2,PERF
42123326070000,PI,IP,001,60,18151,18153,5929,2,PERF
42123326080000,PI,IP,001,1,13059,13061,5850,2,PERF
42123326080000,PI,IP,001,2,13105,13107,5850,2,PERF
42123326080000,PI,IP,001,3,13187,13189,5850,2,PERF
42123326080000,PI,IP,001,4,13269,13271,5850,2,PERF
42123326080000,PI,IP,001,5,13351,13353,5850,2,PERF
42123326080000,PI,IP,001,6,13433,13435,5850,2,PERF
42123326080000,PI,IP,001,7,13515,13517,5850,2,PERF
42123326080000,PI,IP,001,8,13597,13599,5850,2,PERF
42123326080000,PI,IP,001,9,13679,13681,5850,2,PERF
42123326080000,PI,IP,001,10,13761,13763,5850,2,PERF
42123326080000,PI,IP,001,11,13843,13845,5850,2,PERF
42123326080000,PI,IP,001,12,13925,13927,5850,2,PERF
42123326080000,PI,IP,001,13,14007,14009,5850,2,PERF
42123326080000,PI,IP,001,14,14089,14091,5850,2,PERF
42123326080000,PI,IP,001,15,14171,14173,5850,2,PERF
42123326080000,PI,IP,001,16,14253,14255,5850,2,PERF
42123326080000,PI,IP,001,17,14334,14336,5850,2,PERF
42123326080000,PI,IP,001,18,14416,14418,5850,2,PERF
42123326080000,PI,IP,001,19,14498,14500,5850,2,PERF
42123326080000,PI,IP,001,20,14580,14582,5850,2,PERF
42123326080000,PI,IP,001,21,14662,14664,5850,2,PERF
42123326080000,PI,IP,001,22,14744,14746,5850,2,PERF
42123326080000,PI,IP,001,23,14826,14828,5850,2,PERF
42123326080000,PI,IP,001,24,14908,14910,5850,2,PERF
42123326080000,PI,IP,001,25,14990,14992,5850,2,PERF
42123326080000,PI,IP,001,26,15072,15074,5850,2,PERF
42123326080000,PI,IP,001,27,15154,15156,5850,2,PERF
42123326080000,PI,IP,001,28,15236,15238,5850,2,PERF
42123326080000,PI,IP,001,29,15318,15320,5850,2,PERF
42123326080000,PI,IP,001,30,15400,15402,5850,2,PERF
42123326080000,PI,IP,001,31,15482,15484,5850,2,PERF
42123326080000,PI,IP,001,32,15564,15566,5850,2,PERF
42123326080000,PI,IP,001,33,15645,15647,5850,2,PERF
42123326080000,PI,IP,001,34,15727,15729,5850,2,PERF
42123326080000,PI,IP,001,35,15809,15811,5850,2,PERF
42123326080000,PI,IP,001,36,15891,15893,5850,2,PERF
42123326080000,PI,IP,001,37,15973,15975,5850,2,PERF
42123326080000,PI,IP,001,38,16055,16057,5850,2,PERF
42123326080000,PI,IP,001,39,16137,16139,5850,2,PERF
42123326080000,PI,IP,001,40,16219,16221,5850,2,PERF
42123326080000,PI,IP,001,41,16301,16303,5850,2,PERF
42123326080000,PI,IP,001,42,16383,16385,5850,2,PERF
42123326080000,PI,IP,001,43,16465,16467,5850,2,PERF
42123326080000,PI,IP,001,44,16547,16549,5850,2,PERF
42123326080000,PI,IP,001,45,16629,16631,5850,2,PERF
42123326080000,PI,IP,001,46,16711,16713,5850,2,PERF
42123326080000,PI,IP,001,47,16793,16795,5850,2,PERF
42123326080000,PI,IP,001,48,16875,16877,5850,2,PERF
42123326080000,PI,IP,001,49,16956,16958,5850,2,PERF
42123326080000,PI,IP,001,50,17038,17040,5850,2,PERF
42123326080000,PI,IP,001,51,17120,17122,5850,2,PERF
42123326080000,PI,IP,001,52,17202,17204,5850,2,PERF
42123326080000,PI,IP,001,53,17284,17286,5850,2,PERF
42123326080000,PI,IP,001,54,17366,17368,5850,2,PERF
42123326080000,PI,IP,001,55,17448,17450,5850,2,PERF
42123326080000,PI,IP,001,56,17530,17532,5850,2,PERF
42123326080000,PI,IP,001,57,17612,17614,5850,2,PERF
42123326080000,PI,IP,001,58,17692,17694,5850,2,PERF
42123326080000,PI,IP,001,59,17772,17774,5850,2,PERF
42123326080000,PI,IP,001,60,17882,17884,5850,2,PERF
42123326090000,PI,IP,001,1,12933,12935,5800,2,PERF
42123326090000,PI,IP,001,2,13015,13017,5800,2,PERF
42123326090000,PI,IP,001,3,13089,13091,5800,2,PERF
42123326090000,PI,IP,001,4,13163,13165,5800,2,PERF
42123326090000,PI,IP,001,5,13237,13239,5800,2,PERF
42123326090000,PI,IP,001,6,13311,13313,5800,2,PERF
42123326090000,PI,IP,001,7,13385,13387,5800,2,PERF
42123326090000,PI,IP,001,8,13459,13461,5800,2,PERF
42123326090000,PI,IP,001,9,13533,13535,5800,2,PERF
42123326090000,PI,IP,001,10,13607,13609,5800,2,PERF
42123326090000,PI,IP,001,11,13681,13683,5800,2,PERF
42123326090000,PI,IP,001,12,13755,13757,5800,2,PERF
42123326090000,PI,IP,001,13,13829,13831,5800,2,PERF
42123326090000,PI,IP,001,14,13903,13905,5800,2,PERF
42123326090000,PI,IP,001,15,13977,13979,5800,2,PERF
42123326090000,PI,IP,001,16,14051,14053,5800,2,PERF
42123326090000,PI,IP,001,17,14125,14127,5800,2,PERF
42123326090000,PI,IP,001,18,14199,14201,5800,2,PERF
42123326090000,PI,IP,001,19,14273,14275,5800,2,PERF
42123326090000,PI,IP,001,20,14347,14349,5800,2,PERF
42123326090000,PI,IP,001,21,14421,14423,5800,2,PERF
42123326090000,PI,IP,001,22,14495,14497,5800,2,PERF
42123326090000,PI,IP,001,23,14569,14571,5800,2,PERF
42123326090000,PI,IP,001,24,14643,14645,5800,2,PERF
42123326090000,PI,IP,001,25,14717,14719,5800,2,PERF
42123326090000,PI,IP,001,26,14791,14793,5800,2,PERF
42123326090000,PI,IP,001,27,14865,14867,5800,2,PERF
42123326090000,PI,IP,001,28,14939,14941,5800,2,PERF
42123326090000,PI,IP,001,29,15014,15016,5800,2,PERF
42123326090000,PI,IP,001,30,15088,15090,5800,2,PERF
42123326090000,PI,IP,001,31,15162,15164,5800,2,PERF
42123326090000,PI,IP,001,32,15236,15238,5800,2,PERF
42123326090000,PI,IP,001,33,15310,15312,5800,2,PERF
42123326090000,PI,IP,001,34,15384,15386,5800,2,PERF
42123326090000,PI,IP,001,35,15458,15460,5800,2,PERF
42123326090000,PI,IP,001,36,15532,15534,5800,2,PERF
42123326090000,PI,IP,001,37,15606,15608,5800,2,PERF
42123326090000,PI,IP,001,38,15680,15682,5800,2,PERF
42123326090000,PI,IP,001,39,15754,15756,5800,2,PERF
42123326090000,PI,IP,001,40,15828,15830,5800,2,PERF
42123326090000,PI,IP,001,41,15902,15904,5800,2,PERF
42123326090000,PI,IP,001,42,15976,15978,5800,2,PERF
42123326090000,PI,IP,001,43,16050,16052,5800,2,PERF
42123326090000,PI,IP,001,44,16124,16126,5800,2,PERF
42123326090000,PI,IP,001,45,16198,16200,5800,2,PERF
42123326090000,PI,IP,001,46,16272,16274,5800,2,PERF
42123326090000,PI,IP,001,47,16346,16348,5800,2,PERF
42123326090000,PI,IP,001,48,16420,16422,5800,2,PERF
42123326090000,PI,IP,001,49,16494,16496,5800,2,PERF
42123326090000,PI,IP,001,50,16562,16564,5800,2,PERF
42123326090000,PI,IP,001,51,16638,16640,5800,2,PERF
42123326090000,PI,IP,001,52,16711,16713,5800,2,PERF
42123326100000,PI,IP,001,1,13075,18193,5882,5118,PERF
42123326110000,PI,IP,001,1,13391,18560,5689,5169,PERF
42123326120000,PI,IP,001,1,12992,18201,5701,5209,PERF
42123326130000,PI,IP,001,1,13498,18784,6523,5286,PERF
42123326140000,PI,IP,001,1,13623,17483,4025,3860,PERF
42123326150000,PI,IP,001,1,13986,17774,4484,3788,PERF
42123326160000,PI,IP,001,1,12603,17579,5463,4976,PERF
42123326170000,PI,IP,001,1,13683,18265,4809,4582,PERF
42123326180000,PI,IP,001,1,12958,16860,,3902,PERF
42123326190000,PI,IP,001,1,14094,18190,,4096,PERF
42123326200000,PI,IP,001,1,13723,18494,4958,4771,PERF
42123326210000,PI,IP,001,1,13999,18477,,4478,PERF
42123326220000,PI,IP,001,1,13589,18931,5381,5342,PERF
42123326230000,PI,IP,001,1,13042,18398,5760,5356,PERF
42123326240000,PI,IP,001,1,12450,18547,6987,6097,PERF
42123326250000,PI,IP,001,1,12389,16546,5416,4157,PERF
42123326260100,PI,IP,001,1,12700,16365,3832,3665,PERF
42123326270000,PI,IP,001,1,13027,18385,5583,5358,PERF
42123326290000,PI,IP,001,1,13950,19512,5740,5562,PERF
42123326300000,PI,IP,001,1,12800,17538,6289,4738,PERF
42123326310000,PI,IP,001,1,13316,18668,5789,5352,PERF
42123326320000,PI,IP,001,1,12725,16996,4709,4271,PERF
42123326330000,PI,IP,001,1,13599,16883,3490,3284,PERF
42123326350100,PI,IP,001,1,13542,18977,6062,5435,PERF
42123326360000,PI,IP,001,1,13146,19055,6211,5909,PERF
42123326370000,PI,IP,001,1,13577,18710,5576,5133,PERF
42123326380000,PI,IP,001,1,13601,19563,7077,5962,PERF
42123326390000,PI,IP,001,1,13527,16556,3632,3029,PERF
42123326400000,PI,IP,001,1,15188,17220,,2032,PERF
42123326410000,PI,IP,001,1,13825,19787,,5962,PERF
42123326420000,PI,IP,001,1,13337,17262,,3925,PERF
42123326440000,PI,IP,001,1,13753,19844,6444,6091,PERF
42123326450000,PI,IP,001,1,12929,17973,,5044,PERF
42123326460000,PI,IP,001,1,13364,17934,,4570,PERF
42123326470000,PI,IP,001,1,13840,17662,4160,3822,PERF
42123326490000,PI,IP,001,1,12888,17396,5204,4508,PERF
42123326500000,PI,IP,001,1,13418,17235,,3817,PERF
42123326510100,PI,IP,001,1,13540,13752,5556,212,PERF
42123326510100,PI,IP,001,2,13810,14022,5556,212,PERF
42123326510100,PI,IP,001,3,14080,14292,5556,212,PERF
42123326510100,PI,IP,001,4,14350,14442,5556,92,PERF
42123326510100,PI,IP,001,5,14500,14712,5556,212,PERF
42123326510100,PI,IP,001,6,14770,14982,5556,212,PERF
42123326510100,PI,IP,001,7,15050,15252,5556,202,PERF
42123326510100,PI,IP,001,8,15310,15526,5556,216,PERF
42123326510100,PI,IP,001,9,15580,15792,5556,212,PERF
42123326510100,PI,IP,001,10,15850,16062,5556,212,PERF
42123326510100,PI,IP,001,11,16120,16327,5556,207,PERF
42123326510100,PI,IP,001,12,17200,17412,5556,212,PERF
42123326510100,PI,IP,001,13,17470,17682,5556,212,PERF
42123326510100,PI,IP,001,14,17740,17952,5556,212,PERF
42123326520000,PI,IP,001,1,13520,19961,6252,6441,PERF
42123326530000,PI,IP,001,1,13460,19901,6313,6441,PERF
42123326540000,PI,IP,001,1,13460,19901,6337,6441,PERF
42123326550000,PI,IP,001,1,13605,17887,6172,4282,PERF
42123326560000,PI,IP,001,1,13500,16162,,2662,PERF
42123326570000,PI,IP,001,1,13525,18291,5495,4766,PERF
42123326580000,PI,IP,001,1,13719,16678,3555,2959,PERF
42123326590000,PI,IP,001,1,13611,18690,6261,5079,PERF
42123326610000,PI,IP,001,1,13093,18203,,5110,PERF
42123326630000,PI,IP,001,1,13125,18402,,5277,PERF
42123326640000,PI,IP,001,1,12573,18338,6747,5765,PERF
42123326660000,PI,IP,001,1,13600,20181,6881,6581,PERF
42123326670000,PI,IP,001,1,12184,16876,5523,4692,PERF
42123326680000,PI,IP,001,1,13470,19971,6585,6501,PERF
42123326700000,PI,IP,001,1,12299,16530,5113,4231,PERF
42123326710000,PI,IP,001,1,13863,17951,5380,4088,PERF
42123326720000,PI,IP,001,1,13500,19671,6278,6171,PERF
42123326730000,PI,IP,001,1,13724,18225,5078,4501,PERF
42123326740000,PI,IP,001,1,13702,18901,5915,5199,PERF
42123326750000,PI,IP,001,1,13528,18271,4811,4743,PERF
42123326760000,PI,IP,001,1,13480,18181,4797,4701,PERF
42123326770000,PI,IP,001,1,13490,18371,4919,4881,PERF
42123326790000,PI,IP,001,1,13845,17944,4382,4099,PERF
42123326800000,PI,IP,001,1,13893,18340,4786,4447,PERF
42123326810000,PI,IP,001,1,13400,18460,5119,5060,PERF
42123326820000,PI,IP,001,1,12907,17061,5109,4154,PERF
42123326850000,PI,IP,001,1,13690,18419,5057,4729,PERF
42123326860000,PI,IP,001,1,13570,19223,,5653,PERF
42123326870000,PI,IP,001,1,14000,17068,3956,3068,PERF
42123326890000,PI,IP,001,1,13712,18796,5605,5084,PERF
42123326910000,PI,IP,001,1,13800,17314,,3514,PERF
42123326930000,PI,IP,001,1,12539,18992,6568,6453,PERF
42123326940000,PI,IP,001,1,14220,18672,4931,4452,PERF
42123326950000,PI,IP,001,1,13000,18027,5807,5027,PERF
42123326960000,PI,IP,001,1,14027,17743,3918,3716,PERF
42123326970000,PI,IP,001,1,12776,18156,5581,5380,PERF
42123326980000,PI,IP,001,1,13422,19753,7014,6331,PERF
42123326990000,PI,IP,001,1,13500,17889,4800,4389,PERF
42123327000100,PI,IP,001,1,12815,17510,5017,4695,PERF
42123327010000,PI,IP,001,1,13434,17675,4706,4241,PERF
42123327020000,PI,IP,001,1,13351,18460,5390,5109,PERF
42123327030000,PI,IP,001,1,13656,18612,5560,4956,PERF
42123327040000,PI,IP,001,1,13480,18231,4788,4751,PERF
42123327050000,PI,IP,001,1,13504,13751,,247,PERF
42123327050000,PI,IP,001,2,13799,14046,,247,PERF
42123327050000,PI,IP,001,3,14094,14341,,247,PERF
42123327050000,PI,IP,001,4,14389,14635,,246,PERF
42123327050000,PI,IP,001,5,14684,14930,,246,PERF
42123327050000,PI,IP,001,6,14979,15225,,246,PERF
42123327050000,PI,IP,001,7,15273,15520,,247,PERF
42123327050000,PI,IP,001,8,15568,15815,,247,PERF
42123327050000,PI,IP,001,9,15863,16110,,247,PERF
42123327050000,PI,IP,001,10,16158,16405,,247,PERF
42123327050000,PI,IP,001,11,16453,16700,,247,PERF
42123327050000,PI,IP,001,12,16748,16995,,247,PERF
42123327050000,PI,IP,001,13,17043,17290,,247,PERF
42123327050000,PI,IP,001,14,17338,17584,,246,PERF
42123327050000,PI,IP,001,15,17633,17879,,246,PERF
42123327050000,PI,IP,001,16,17928,18191,,263,PERF
42123327060000,PI,IP,001,1,13616,16751,3600,3135,PERF
42123327070000,PI,IP,001,1,13510,17957,5997,4447,PERF
42123327080000,PI,IP,001,1,12622,16327,4495,3705,PERF
42123327090000,PI,IP,001,1,12454,17218,,4764,PERF
42123327100000,PI,IP,001,1,13428,13671,3578,243,PERF
42123327100000,PI,IP,001,2,13735,13992,3578,257,PERF
42123327100000,PI,IP,001,3,14060,14317,3578,257,PERF
42123327100000,PI,IP,001,4,14385,14642,3578,257,PERF
42123327100000,PI,IP,001,5,14710,14967,3578,257,PERF
42123327100000,PI,IP,001,6,15035,15287,3578,252,PERF
42123327100000,PI,IP,001,7,15360,15617,3578,257,PERF
42123327100000,PI,IP,001,8,15685,15942,3578,257,PERF
42123327100000,PI,IP,001,9,16010,16266,3578,256,PERF
42123327100000,PI,IP,001,10,16335,16607,3578,272,PERF
42123327110000,PI,IP,001,1,12373,17050,4789,4677,PERF
42123327120000,PI,IP,001,1,13812,14075,5015,263,PERF
42123327120000,PI,IP,001,2,14153,14416,5015,263,PERF
42123327120000,PI,IP,001,3,14494,14757,5015,263,PERF
42123327120000,PI,IP,001,4,14835,15098,5015,263,PERF
42123327120000,PI,IP,001,5,15176,15439,5015,263,PERF
42123327120000,PI,IP,001,6,15517,15776,5015,259,PERF
42123327120000,PI,IP,001,7,15858,16121,5015,263,PERF
42123327120000,PI,IP,001,8,16199,16462,5015,263,PERF
42123327120000,PI,IP,001,9,16540,16803,5015,263,PERF
42123327120000,PI,IP,001,10,16881,17144,5015,263,PERF
42123327120000,PI,IP,001,11,17222,17485,5015,263,PERF
42123327120000,PI,IP,001,12,17563,17740,5015,177,PERF
42123327120000,PI,IP,001,13,17825,17827,5015,2,PERF
42123327130000,PI,IP,001,1,13649,19515,5998,5866,PERF
42123327140000,PI,IP,001,1,13313,16746,3799,3433,PERF
42123327150000,PI,IP,001,1,13475,13762,5609,287,PERF
42123327150000,PI,IP,001,2,13845,14117,5609,272,PERF
42123327150000,PI,IP,001,3,14195,14467,5609,272,PERF
42123327150000,PI,IP,001,4,14545,14817,5609,272,PERF
42123327150000,PI,IP,001,5,14895,15167,5609,272,PERF
42123327150000,PI,IP,001,6,15245,15517,5609,272,PERF
42123327150000,PI,IP,001,7,15595,15867,5609,272,PERF
42123327150000,PI,IP,001,8,15945,16217,5609,272,PERF
42123327150000,PI,IP,001,9,16295,16567,5609,272,PERF
42123327150000,PI,IP,001,10,16645,16917,5609,272,PERF
42123327150000,PI,IP,001,11,16995,17267,5609,272,PERF
42123327150000,PI,IP,001,12,17345,17617,5609,272,PERF
42123327150000,PI,IP,001,13,17695,17967,5609,272,PERF
42123327150000,PI,IP,001,14,18040,18312,5609,272,PERF
42123327160000,PI,IP,001,1,12864,18755,6555,5891,PERF
42123327170000,PI,IP,001,1,13790,18742,5335,4952,PERF
42123327180000,PI,IP,001,1,13962,18002,4599,4040,PERF
42123327190000,PI,IP,001,1,13548,18295,4926,4747,PERF
42123327210000,PI,IP,001,1,13585,13834,5001,249,PERF
42123327210000,PI,IP,001,2,13912,14163,5001,251,PERF
42123327210000,PI,IP,001,3,14241,14497,5001,256,PERF
42123327210000,PI,IP,001,4,14573,14827,5001,254,PERF
42123327210000,PI,IP,001,5,14905,15159,5001,254,PERF
42123327210000,PI,IP,001,6,15237,15491,5001,254,PERF
42123327210000,PI,IP,001,7,15569,15823,5001,254,PERF
42123327210000,PI,IP,001,8,15901,16155,5001,254,PERF
42123327210000,PI,IP,001,9,16233,16482,5001,249,PERF
42123327210000,PI,IP,001,10,16565,16819,5001,254,PERF
42123327210000,PI,IP,001,11,16901,17151,5001,250,PERF
42123327210000,PI,IP,001,12,17229,17483,5001,254,PERF
42123327210000,PI,IP,001,13,17561,17815,5001,254,PERF
42123327210000,PI,IP,001,14,17893,18147,5001,254,PERF
42123327220000,PI,IP,001,1,13417,18028,4960,4611,PERF
42123327240000,PI,IP,001,1,13570,18642,5456,5072,PERF
42123327260000,PI,IP,001,1,14341,18298,5370,3957,PERF
42123327270000,PI,IP,001,1,13698,18161,4722,4463,PERF
42123327290000,PI,IP,001,1,12788,17967,5561,5179,PERF
42123327320000,PI,IP,001,1,12770,12772,6260,2,PERF
42123327320000,PI,IP,001,2,12858,12860,6260,2,PERF
42123327320000,PI,IP,001,3,12946,12948,6260,2,PERF
42123327320000,PI,IP,001,4,13034,13036,6260,2,PERF
42123327320000,PI,IP,001,5,13127,13129,6260,2,PERF
42123327320000,PI,IP,001,6,13215,13217,6260,2,PERF
42123327320000,PI,IP,001,7,13303,13305,6260,2,PERF
42123327320000,PI,IP,001,8,13391,13393,6260,2,PERF
42123327320000,PI,IP,001,9,13484,13486,6260,2,PERF
42123327320000,PI,IP,001,10,13572,13574,6260,2,PERF
42123327320000,PI,IP,001,11,13660,13662,6260,2,PERF
42123327320000,PI,IP,001,12,13748,13750,6260,2,PERF
42123327320000,PI,IP,001,13,13841,13843,6260,2,PERF
42123327320000,PI,IP,001,14,13929,13931,6260,2,PERF
42123327320000,PI,IP,001,15,14017,14019,6260,2,PERF
42123327320000,PI,IP,001,16,14105,14107,6260,2,PERF
42123327320000,PI,IP,001,17,14198,14200,6260,2,PERF
42123327320000,PI,IP,001,18,14286,14288,6260,2,PERF
42123327320000,PI,IP,001,19,14374,14376,6260,2,PERF
42123327320000,PI,IP,001,20,14462,14464,6260,2,PERF
42123327320000,PI,IP,001,21,14555,14557,6260,2,PERF
42123327320000,PI,IP,001,22,14644,14646,6260,2,PERF
42123327320000,PI,IP,001,23,14736,14738,6260,2,PERF
42123327320000,PI,IP,001,24,14814,14816,6260,2,PERF
42123327320000,PI,IP,001,25,14912,14914,6260,2,PERF
42123327320000,PI,IP,001,26,15000,15002,6260,2,PERF
42123327320000,PI,IP,001,27,15088,15090,6260,2,PERF
42123327320000,PI,IP,001,28,15176,15178,6260,2,PERF
42123327320000,PI,IP,001,29,15266,15268,6260,2,PERF
42123327320000,PI,IP,001,30,15356,15358,6260,2,PERF
42123327320000,PI,IP,001,31,15445,15447,6260,2,PERF
42123327320000,PI,IP,001,32,15533,15535,6260,2,PERF
42123327320000,PI,IP,001,33,15626,15628,6260,2,PERF
42123327320000,PI,IP,001,34,15714,15716,6260,2,PERF
42123327320000,PI,IP,001,35,15802,15804,6260,2,PERF
42123327320000,PI,IP,001,36,15890,15892,6260,2,PERF
42123327320000,PI,IP,001,37,15983,15985,6260,2,PERF
42123327320000,PI,IP,001,38,16071,16073,6260,2,PERF
42123327320000,PI,IP,001,39,16159,16161,6260,2,PERF
42123327320000,PI,IP,001,40,16247,16249,6260,2,PERF
42123327320000,PI,IP,001,41,16340,16342,6260,2,PERF
42123327320000,PI,IP,001,42,16428,16430,6260,2,PERF
42123327320000,PI,IP,001,43,16516,16518,6260,2,PERF
42123327320000,PI,IP,001,44,16604,16606,6260,2,PERF
42123327320000,PI,IP,001,45,16697,16699,6260,2,PERF
42123327320000,PI,IP,001,46,16785,16787,6260,2,PERF
42123327320000,PI,IP,001,47,16873,16875,6260,2,PERF
42123327320000,PI,IP,001,48,16961,16963,6260,2,PERF
42123327320000,PI,IP,001,49,17054,17056,6260,2,PERF
42123327320000,PI,IP,001,50,17142,17144,6260,2,PERF
42123327320000,PI,IP,001,51,17230,17232,6260,2,PERF
42123327320000,PI,IP,001,52,17318,17320,6260,2,PERF
42123327320000,PI,IP,001,53,17411,17413,6260,2,PERF
42123327320000,PI,IP,001,54,17499,17501,6260,2,PERF
42123327320000,PI,IP,001,55,17587,17589,6260,2,PERF
42123327320000,PI,IP,001,56,17675,17677,6260,2,PERF
42123327320000,PI,IP,001,57,17767,17769,6260,2,PERF
42123327320000,PI,IP,001,58,17847,17849,6260,2,PERF
42123327320000,PI,IP,001,59,17927,17929,6260,2,PERF
42123327320000,PI,IP,001,60,18007,18009,6260,2,PERF
42123327330000,PI,IP,001,1,12885,12887,6328,2,PERF
42123327330000,PI,IP,001,2,12973,12975,6328,2,PERF
42123327330000,PI,IP,001,3,13061,13063,6328,2,PERF
42123327330000,PI,IP,001,4,13149,13151,6328,2,PERF
42123327330000,PI,IP,001,5,13244,13246,6328,2,PERF
42123327330000,PI,IP,001,6,13332,13335,6328,3,PERF
42123327330000,PI,IP,001,7,13420,13422,6328,2,PERF
42123327330000,PI,IP,001,8,13508,13510,6328,2,PERF
42123327330000,PI,IP,001,9,13603,13605,6328,2,PERF
42123327330000,PI,IP,001,10,13691,13693,6328,2,PERF
42123327330000,PI,IP,001,11,13779,13781,6328,2,PERF
42123327330000,PI,IP,001,12,13867,13869,6328,2,PERF
42123327330000,PI,IP,001,13,13962,13964,6328,2,PERF
42123327330000,PI,IP,001,14,14050,14052,6328,2,PERF
42123327330000,PI,IP,001,15,14138,14140,6328,2,PERF
42123327330000,PI,IP,001,16,14220,14222,6328,2,PERF
42123327330000,PI,IP,001,17,14321,14323,6328,2,PERF
42123327330000,PI,IP,001,18,14412,14414,6328,2,PERF
42123327330000,PI,IP,001,19,14503,14505,6328,2,PERF
42123327330000,PI,IP,001,20,14582,14584,6328,2,PERF
42123327330000,PI,IP,001,21,14685,14687,6328,2,PERF
42123327330000,PI,IP,001,22,14762,14764,6328,2,PERF
42123327330000,PI,IP,001,23,14854,14856,6328,2,PERF
42123327330000,PI,IP,001,24,14944,14946,6328,2,PERF
42123327330000,PI,IP,001,25,15036,15038,6328,2,PERF
42123327330000,PI,IP,001,26,15127,15129,6328,2,PERF
42123327330000,PI,IP,001,27,15215,15217,6328,2,PERF
42123327330000,PI,IP,001,28,15303,15305,6328,2,PERF
42123327330000,PI,IP,001,29,15398,15400,6328,2,PERF
42123327330000,PI,IP,001,30,15486,15488,6328,2,PERF
42123327330000,PI,IP,001,31,15574,15576,6328,2,PERF
42123327330000,PI,IP,001,32,15662,15664,6328,2,PERF
42123327330000,PI,IP,001,33,15757,15759,6328,2,PERF
42123327330000,PI,IP,001,34,15845,15847,6328,2,PERF
42123327330000,PI,IP,001,35,15933,15935,6328,2,PERF
42123327330000,PI,IP,001,36,16021,16023,6328,2,PERF
42123327330000,PI,IP,001,37,16116,16118,6328,2,PERF
42123327330000,PI,IP,001,38,16204,16206,6328,2,PERF
42123327330000,PI,IP,001,39,16292,16294,6328,2,PERF
42123327330000,PI,IP,001,40,16380,16382,6328,2,PERF
42123327330000,PI,IP,001,41,16475,16477,6328,2,PERF
42123327330000,PI,IP,001,42,16563,16565,6328,2,PERF
42123327330000,PI,IP,001,43,16651,16653,6328,2,PERF
42123327330000,PI,IP,001,44,16739,16741,6328,2,PERF
42123327330000,PI,IP,001,45,16834,16836,6328,2,PERF
42123327330000,PI,IP,001,46,16922,16924,6328,2,PERF
42123327330000,PI,IP,001,47,17010,17012,6328,2,PERF
42123327330000,PI,IP,001,48,17102,17104,6328,2,PERF
42123327330000,PI,IP,001,49,17193,17195,6328,2,PERF
42123327330000,PI,IP,001,50,17281,17283,6328,2,PERF
42123327330000,PI,IP,001,51,17370,17372,6328,2,PERF
42123327330000,PI,IP,001,52,17452,17454,6328,2,PERF
42123327330000,PI,IP,001,53,17552,17554,6328,2,PERF
42123327330000,PI,IP,001,54,17640,17642,6328,2,PERF
42123327330000,PI,IP,001,55,17728,17730,6328,2,PERF
42123327330000,PI,IP,001,56,17816,17818,6328,2,PERF
42123327330000,PI,IP,001,57,17910,17912,6328,2,PERF
42123327330000,PI,IP,001,58,17990,17992,6328,2,PERF
42123327330000,PI,IP,001,59,18070,18072,6328,2,PERF
42123327330000,PI,IP,001,60,18150,18152,6328,2,PERF
42123327340000,PI,IP,001,1,13640,19603,6261,5963,PERF
42123327390000,PI,IP,001,1,13600,16654,3985,3054,PERF
42123327400000,PI,IP,001,1,13544,17911,5019,4367,PERF
42123327410000,PI,IP,001,1,13161,17585,4874,4424,PERF
42123327420000,PI,IP,001,1,13154,17323,,4169,PERF
42123327430000,PI,IP,001,1,13650,18971,5564,5321,PERF
42123327440000,PI,IP,001,1,13760,19081,5682,5321,PERF
42123327460000,PI,IP,001,1,12340,16400,4224,4060,PERF
42123327470000,PI,IP,001,1,12446,16506,4207,4060,PERF
42123327480000,PI,IP,001,1,12484,16544,4179,4060,PERF
42123327490000,PI,IP,001,1,12428,16488,4350,4060,PERF
42123327500000,PI,IP,001,1,13640,18921,5780,5281,PERF
42123327510000,PI,IP,001,1,13643,13897,5189,254,PERF
42123327510000,PI,IP,001,2,13960,14232,5189,272,PERF
42123327510000,PI,IP,001,3,14300,14572,5189,272,PERF
42123327510000,PI,IP,001,4,14637,14909,5189,272,PERF
42123327510000,PI,IP,001,5,14980,15252,5189,272,PERF
42123327510000,PI,IP,001,6,15320,15592,5189,272,PERF
42123327510000,PI,IP,001,7,15660,15932,5189,272,PERF
42123327510000,PI,IP,001,8,16000,16272,5189,272,PERF
42123327510000,PI,IP,001,9,16340,16612,5189,272,PERF
42123327510000,PI,IP,001,10,16680,16952,5189,272,PERF
42123327510000,PI,IP,001,11,17020,17292,5189,272,PERF
42123327510000,PI,IP,001,12,17360,17662,5189,302,PERF
42123327510000,PI,IP,001,13,17700,17972,5189,272,PERF
42123327510000,PI,IP,001,14,18040,18282,5189,242,PERF
42123327520000,PI,IP,001,1,12973,17820,5281,4847,PERF
42123327540000,PI,IP,001,1,13086,18293,5284,5207,PERF
42123327580000,PI,IP,001,1,13447,17862,,4415,PERF
42123327590000,PI,IP,001,1,13249,18453,5448,5204,PERF
42123327600000,PI,IP,001,1,13308,17354,5395,4046,PERF
42123327610000,PI,IP,001,1,13065,17150,4694,4085,PERF
42123327620000,PI,IP,001,1,14134,18185,4575,4051,PERF
42123327630000,PI,IP,001,1,13702,16570,3183,2868,PERF
42123327640100,PI,IP,001,1,12713,19330,6986,6617,PERF
42123327650000,PI,IP,001,1,13453,20065,6841,6612,PERF
42123327660000,PI,IP,001,1,13690,18591,5202,4901,PERF
42123327670000,PI,IP,001,1,13241,17769,5562,4528,PERF
42123327680000,PI,IP,001,1,13750,19311,,5561,PERF
42123327690000,PI,IP,001,1,13558,17501,4240,3943,PERF
42123327700000,PI,IP,001,1,13760,17821,,4061,PERF
42123327710000,PI,IP,001,1,13286,19044,5781,5758,PERF
42123327720000,PI,IP,001,1,13034,18573,6030,5539,PERF
42123327730000,PI,IP,001,1,13700,16841,3225,3141,PERF
42123327740000,PI,IP,001,1,13026,17695,5486,4669,PERF
42123327750000,PI,IP,001,1,12765,12767,6429,2,PERF
42123327750000,PI,IP,001,2,12850,12852,6429,2,PERF
42123327750000,PI,IP,001,3,12936,12938,6429,2,PERF
42123327750000,PI,IP,001,4,13024,13026,6429,2,PERF
42123327750000,PI,IP,001,5,13104,13106,6429,2,PERF
42123327750000,PI,IP,001,6,13195,13197,6429,2,PERF
42123327750000,PI,IP,001,7,13280,13282,6429,2,PERF
42123327750000,PI,IP,001,8,13365,13367,6429,2,PERF
42123327750000,PI,IP,001,9,13455,13457,6429,2,PERF
42123327750000,PI,IP,001,10,13540,13542,6429,2,PERF
42123327750000,PI,IP,001,11,13625,13627,6429,2,PERF
42123327750000,PI,IP,001,12,13710,13712,6429,2,PERF
42123327750000,PI,IP,001,13,13800,13802,6429,2,PERF
42123327750000,PI,IP,001,14,13888,13890,6429,2,PERF
42123327750000,PI,IP,001,15,13968,13970,6429,2,PERF
42123327750000,PI,IP,001,16,14055,14057,6429,2,PERF
42123327750000,PI,IP,001,17,14145,14147,6429,2,PERF
42123327750000,PI,IP,001,18,14230,14232,6429,2,PERF
42123327750000,PI,IP,001,19,14315,14317,6429,2,PERF
42123327750000,PI,IP,001,20,14400,14402,6429,2,PERF
42123327750000,PI,IP,001,21,14490,14492,6429,2,PERF
42123327750000,PI,IP,001,22,14575,14577,6429,2,PERF
42123327750000,PI,IP,001,23,14660,14662,6429,2,PERF
42123327750000,PI,IP,001,24,14740,14742,6429,2,PERF
42123327750000,PI,IP,001,25,14832,14834,6429,2,PERF
42123327750000,PI,IP,001,26,14920,14922,6429,2,PERF
42123327750000,PI,IP,001,27,15005,15007,6429,2,PERF
42123327750000,PI,IP,001,28,15090,15092,6429,2,PERF
42123327750000,PI,IP,001,29,15180,15182,6429,2,PERF
42123327750000,PI,IP,001,30,15265,15267,6429,2,PERF
42123327750000,PI,IP,001,31,15350,15352,6429,2,PERF
42123327750000,PI,IP,001,32,15435,15437,6429,2,PERF
42123327750000,PI,IP,001,33,15525,15527,6429,2,PERF
42123327750000,PI,IP,001,34,15616,15618,6429,2,PERF
42123327750000,PI,IP,001,35,15692,15694,6429,2,PERF
42123327750000,PI,IP,001,36,15780,15782,6429,2,PERF
42123327750000,PI,IP,001,37,15870,15872,6429,2,PERF
42123327750000,PI,IP,001,38,15955,15957,6429,2,PERF
42123327750000,PI,IP,001,39,16040,16042,6429,2,PERF
42123327750000,PI,IP,001,40,16125,16127,6429,2,PERF
42123327750000,PI,IP,001,41,16215,16217,6429,2,PERF
42123327750000,PI,IP,001,42,16300,16302,6429,2,PERF
42123327750000,PI,IP,001,43,16387,16389,6429,2,PERF
42123327750000,PI,IP,001,44,16466,16468,6429,2,PERF
42123327750000,PI,IP,001,45,16556,16558,6429,2,PERF
42123327750000,PI,IP,001,46,16645,16647,6429,2,PERF
42123327750000,PI,IP,001,47,16730,16732,6429,2,PERF
42123327750000,PI,IP,001,48,16815,16817,6429,2,PERF
42123327750000,PI,IP,001,49,16905,16907,6429,2,PERF
42123327750000,PI,IP,001,50,16990,16992,6429,2,PERF
42123327750000,PI,IP,001,51,17075,17077,6429,2,PERF
42123327750000,PI,IP,001,52,17164,17166,6429,2,PERF
42123327750000,PI,IP,001,53,17250,17252,6429,2,PERF
42123327750000,PI,IP,001,54,17335,17337,6429,2,PERF
42123327750000,PI,IP,001,55,17420,17422,6429,2,PERF
42123327750000,PI,IP,001,56,17505,17507,6429,2,PERF
42123327750000,PI,IP,001,57,17595,17597,6429,2,PERF
42123327750000,PI,IP,001,58,17675,17677,6429,2,PERF
42123327750000,PI,IP,001,59,17755,17757,6429,2,PERF
42123327750000,PI,IP,001,60,17835,17837,6429,2,PERF
42123327770000,PI,IP,001,1,13513,13758,5429,245,PERF
42123327770000,PI,IP,001,2,13827,14072,5429,245,PERF
42123327770000,PI,IP,001,3,14141,14407,5429,266,PERF
42123327770000,PI,IP,001,4,14491,14763,5429,272,PERF
42123327770000,PI,IP,001,5,14841,15113,5429,272,PERF
42123327770000,PI,IP,001,6,15191,15463,5429,272,PERF
42123327770000,PI,IP,001,7,15538,15813,5429,275,PERF
42123327770000,PI,IP,001,8,15891,16163,5429,272,PERF
42123327770000,PI,IP,001,9,16241,16507,5429,266,PERF
42123327770000,PI,IP,001,10,16591,16863,5429,272,PERF
42123327770000,PI,IP,001,11,16941,17213,5429,272,PERF
42123327770000,PI,IP,001,12,17291,17563,5429,272,PERF
42123327770000,PI,IP,001,13,17641,17883,5429,242,PERF
42123327780000,PI,IP,001,1,13520,17329,5404,3809,PERF
42123327790000,PI,IP,001,1,13972,19483,6322,5511,PERF
42123327800000,PI,IP,001,1,14059,19881,6632,5822,PERF
42123327810000,PI,IP,001,1,13835,14047,5198,212,PERF
42123327810000,PI,IP,001,2,14115,14327,5198,212,PERF
42123327810000,PI,IP,001,3,14395,14607,5198,212,PERF
42123327810000,PI,IP,001,4,14675,14887,5198,212,PERF
42123327810000,PI,IP,001,5,14955,15167,5198,212,PERF
42123327810000,PI,IP,001,6,15231,15445,5198,214,PERF
42123327810000,PI,IP,001,7,15518,15727,5198,209,PERF
42123327810000,PI,IP,001,8,15795,16007,5198,212,PERF
42123327810000,PI,IP,001,9,16047,16287,5198,240,PERF
42123327810000,PI,IP,001,10,16355,16569,5198,214,PERF
42123327810000,PI,IP,001,11,16635,16850,5198,215,PERF
42123327810000,PI,IP,001,12,16915,17123,5198,208,PERF
42123327810000,PI,IP,001,13,17195,17407,5198,212,PERF
42123327810000,PI,IP,001,14,17475,17687,5198,212,PERF
42123327810000,PI,IP,001,15,17755,17967,5198,212,PERF
42123327810000,PI,IP,001,16,18035,18307,5198,272,PERF
42123327820000,PI,IP,001,1,13550,13810,5590,260,PERF
42123327820000,PI,IP,001,2,13888,14148,5590,260,PERF
42123327820000,PI,IP,001,3,14226,14486,5590,260,PERF
42123327820000,PI,IP,001,4,14564,14824,5590,260,PERF
42123327820000,PI,IP,001,5,14902,15162,5590,260,PERF
42123327820000,PI,IP,001,6,15240,15500,5590,260,PERF
42123327820000,PI,IP,001,7,15578,15838,5590,260,PERF
42123327820000,PI,IP,001,8,15916,16176,5590,260,PERF
42123327820000,PI,IP,001,9,16254,16514,5590,260,PERF
42123327820000,PI,IP,001,10,16592,16852,5590,260,PERF
42123327820000,PI,IP,001,11,16930,17190,5590,260,PERF
42123327820000,PI,IP,001,12,17268,17528,5590,260,PERF
42123327820000,PI,IP,001,13,17606,17866,5590,260,PERF
42123327820000,PI,IP,001,14,17944,18204,5590,260,PERF
42123327820000,PI,IP,001,15,18282,18452,5590,170,PERF
42123327830000,PI,IP,001,1,13048,18100,,5052,PERF
42123327840000,PI,PT,001,1,,,,,PERF
42123327850000,PI,IP,001,1,12830,17701,5225,4871,PERF
42123327860000,PI,IP,001,1,13592,17208,,3616,PERF
42123327870000,PI,IP,001,1,13280,17709,,4429,PERF
42123327900000,PI,IP,001,1,13671,17799,4666,4128,PERF
42123327920000,PI,IP,001,1,13002,19281,6566,6279,PERF
42123327930000,PI,IP,001,1,13048,19383,6941,6335,PERF
42123327980000,PI,IP,001,1,13005,19208,6816,6203,PERF
42123327990000,PI,IP,001,1,13289,19207,5945,5918,PERF
42123328000000,PI,IP,001,1,13331,18994,,5663,PERF
42123328010000,PI,IP,001,1,13015,19631,7123,6616,PERF
42123328020000,PI,IP,001,1,13620,19541,5833,5921,PERF
42123328030000,PI,IP,001,1,12850,16838,,3988,PERF
42123328070000,PI,IP,001,1,12637,17681,5202,5044,PERF
42123328080000,PI,IP,001,1,12804,12806,4306,2,PERF
42123328080000,PI,IP,001,2,12866,12868,4306,2,PERF
42123328080000,PI,IP,001,3,12930,12932,4306,2,PERF
42123328080000,PI,IP,001,4,12996,12998,4306,2,PERF
42123328080000,PI,IP,001,5,13062,13064,4306,2,PERF
42123328080000,PI,IP,001,6,13127,13129,4306,2,PERF
42123328080000,PI,IP,001,7,13192,13194,4306,2,PERF
42123328080000,PI,IP,001,8,13257,13259,4306,2,PERF
42123328080000,PI,IP,001,9,13323,13325,4306,2,PERF
42123328080000,PI,IP,001,10,13390,13392,4306,2,PERF
42123328080000,PI,IP,001,11,13453,13455,4306,2,PERF
42123328080000,PI,IP,001,12,13516,13518,4306,2,PERF
42123328080000,PI,IP,001,13,13584,13586,4306,2,PERF
42123328080000,PI,IP,001,14,13649,13651,4306,2,PERF
42123328080000,PI,IP,001,15,13714,13716,4306,2,PERF
42123328080000,PI,IP,001,16,13779,13781,4306,2,PERF
42123328080000,PI,IP,001,17,13845,13847,4306,2,PERF
42123328080000,PI,IP,001,18,13910,13912,4306,2,PERF
42123328080000,PI,IP,001,19,13975,13977,4306,2,PERF
42123328080000,PI,IP,001,20,14040,14042,4306,2,PERF
42123328080000,PI,IP,001,21,14100,14102,4306,2,PERF
42123328080000,PI,IP,001,22,14171,14173,4306,2,PERF
42123328080000,PI,IP,001,23,14236,14238,4306,2,PERF
42123328080000,PI,IP,001,24,14301,14303,4306,2,PERF
42123328080000,PI,IP,001,25,14367,14369,4306,2,PERF
42123328080000,PI,IP,001,26,14432,14434,4306,2,PERF
42123328080000,PI,IP,001,27,14497,14499,4306,2,PERF
42123328080000,PI,IP,001,28,14564,14566,4306,2,PERF
42123328080000,PI,IP,001,29,14628,14630,4306,2,PERF
42123328080000,PI,IP,001,30,14689,14691,4306,2,PERF
42123328080000,PI,IP,001,31,14758,14760,4306,2,PERF
42123328080000,PI,IP,001,32,14823,14825,4306,2,PERF
42123328080000,PI,IP,001,33,14889,14891,4306,2,PERF
42123328080000,PI,IP,001,34,14954,14956,4306,2,PERF
42123328080000,PI,IP,001,35,15019,15021,4306,2,PERF
42123328080000,PI,IP,001,36,15084,15086,4306,2,PERF
42123328080000,PI,IP,001,37,15150,15152,4306,2,PERF
42123328080000,PI,IP,001,38,15204,15206,4306,2,PERF
42123328080000,PI,IP,001,39,15258,15260,4306,2,PERF
42123328080000,PI,IP,001,40,15312,15314,4306,2,PERF
42123328090000,PI,IP,001,1,12577,12579,4348,2,PERF
42123328090000,PI,IP,001,2,12648,12650,4348,2,PERF
42123328090000,PI,IP,001,3,12719,12721,4348,2,PERF
42123328090000,PI,IP,001,4,12790,12792,4348,2,PERF
42123328090000,PI,IP,001,5,12860,12862,4348,2,PERF
42123328090000,PI,IP,001,6,12934,12936,4348,2,PERF
42123328090000,PI,IP,001,7,13006,13008,4348,2,PERF
42123328090000,PI,IP,001,8,13076,13078,4348,2,PERF
42123328090000,PI,IP,001,9,13149,13151,4348,2,PERF
42123328090000,PI,IP,001,10,13220,13222,4348,2,PERF
42123328090000,PI,IP,001,11,13291,13293,4348,2,PERF
42123328090000,PI,IP,001,12,13356,13358,4348,2,PERF
42123328090000,PI,IP,001,13,13435,13437,4348,2,PERF
42123328090000,PI,IP,001,14,13577,13579,4348,2,PERF
42123328090000,PI,IP,001,15,13648,13650,4348,2,PERF
42123328090000,PI,IP,001,16,13656,13658,4348,2,PERF
42123328090000,PI,IP,001,17,13721,13723,4348,2,PERF
42123328090000,PI,IP,001,18,13792,13794,4348,2,PERF
42123328090000,PI,IP,001,19,13863,13865,4348,2,PERF
42123328090000,PI,IP,001,20,13934,13936,4348,2,PERF
42123328090000,PI,IP,001,21,14007,14009,4348,2,PERF
42123328090000,PI,IP,001,22,14072,14074,4348,2,PERF
42123328090000,PI,IP,001,23,14149,14151,4348,2,PERF
42123328090000,PI,IP,001,24,14220,14222,4348,2,PERF
42123328090000,PI,IP,001,25,14293,14295,4348,2,PERF
42123328090000,PI,IP,001,26,14364,14366,4348,2,PERF
42123328090000,PI,IP,001,27,14435,14437,4348,2,PERF
42123328090000,PI,IP,001,28,14506,14508,4348,2,PERF
42123328090000,PI,IP,001,29,14572,14574,4348,2,PERF
42123328090000,PI,IP,001,30,14650,14652,4348,2,PERF
42123328090000,PI,IP,001,31,14721,14723,4348,2,PERF
42123328090000,PI,IP,001,32,14792,14794,4348,2,PERF
42123328090000,PI,IP,001,33,14865,14867,4348,2,PERF
42123328090000,PI,IP,001,34,14936,14938,4348,2,PERF
42123328090000,PI,IP,001,35,15007,15009,4348,2,PERF
42123328090000,PI,IP,001,36,15078,15080,4348,2,PERF
42123328090000,PI,IP,001,37,15150,15152,4348,2,PERF
42123328090000,PI,IP,001,38,15230,15232,4348,2,PERF
42123328090000,PI,IP,001,39,15310,15312,4348,2,PERF
42123328090000,PI,IP,001,40,15390,15392,4348,2,PERF
42123328100000,PI,IP,001,1,12633,15447,4227,2814,PERF
42123328110000,PI,IP,001,1,12654,12656,4164,2,PERF
42123328110000,PI,IP,001,2,12734,12736,4164,2,PERF
42123328110000,PI,IP,001,3,12810,12812,4164,2,PERF
42123328110000,PI,IP,001,4,12882,12884,4164,2,PERF
42123328110000,PI,IP,001,5,12962,12964,4164,2,PERF
42123328110000,PI,IP,001,6,13038,13040,4164,2,PERF
42123328110000,PI,IP,001,7,13110,13112,4164,2,PERF
42123328110000,PI,IP,001,8,13190,13192,4164,2,PERF
42123328110000,PI,IP,001,9,13266,13268,4164,2,PERF
42123328110000,PI,IP,001,10,13336,13338,4164,2,PERF
42123328110000,PI,IP,001,11,13418,13420,4164,2,PERF
42123328110000,PI,IP,001,12,13494,13496,4164,2,PERF
42123328110000,PI,IP,001,13,13574,13576,4164,2,PERF
42123328110000,PI,IP,001,14,13646,13648,4164,2,PERF
42123328110000,PI,IP,001,15,13722,13724,4164,2,PERF
42123328110000,PI,IP,001,16,13804,13806,4164,2,PERF
42123328110000,PI,IP,001,17,13870,13872,4164,2,PERF
42123328110000,PI,IP,001,18,13950,13952,4164,2,PERF
42123328110000,PI,IP,001,19,14028,14030,4164,2,PERF
42123328110000,PI,IP,001,20,14102,14104,4164,2,PERF
42123328110000,PI,IP,001,21,14178,14180,4164,2,PERF
42123328110000,PI,IP,001,22,14256,14258,4164,2,PERF
42123328110000,PI,IP,001,23,14330,14332,4164,2,PERF
42123328110000,PI,IP,001,24,14406,14408,4164,2,PERF
42123328110000,PI,IP,001,25,14484,14486,4164,2,PERF
42123328110000,PI,IP,001,26,14558,14560,4164,2,PERF
42123328110000,PI,IP,001,27,14634,14636,4164,2,PERF
42123328110000,PI,IP,001,28,14710,14712,4164,2,PERF
42123328110000,PI,IP,001,29,14786,14788,4164,2,PERF
42123328110000,PI,IP,001,30,14862,14864,4164,2,PERF
42123328110000,PI,IP,001,31,14938,14940,4164,2,PERF
42123328110000,PI,IP,001,32,15014,15016,4164,2,PERF
42123328110000,PI,IP,001,33,15090,15092,4164,2,PERF
42123328110000,PI,IP,001,34,15166,15168,4164,2,PERF
42123328110000,PI,IP,001,35,15242,15244,4164,2,PERF
42123328110000,PI,IP,001,36,15318,15320,4164,2,PERF
42123328110000,PI,IP,001,37,15394,15396,4164,2,PERF
42123328110000,PI,IP,001,38,15474,15476,4164,2,PERF
42123328110000,PI,IP,001,39,15554,15556,4164,2,PERF
42123328110000,PI,IP,001,40,15622,15624,4164,2,PERF
42123328130000,PI,IP,001,1,14104,18145,,4041,PERF
42123328150000,PI,IP,001,1,12829,17592,6001,4763,PERF
42123328180000,PI,IP,001,1,13109,18172,5182,5063,PERF
42123328200000,PI,IP,001,1,13253,17264,5134,4011,PERF
42123328220000,PI,IP,001,1,12869,16994,5202,4125,PERF
42123328230000,PI,IP,001,1,12961,17089,4785,4128,PERF
42123328240000,PI,IP,001,1,12804,17338,5129,4534,PERF
42123328250000,PI,IP,001,1,16432,19051,,2619,PERF
42123328320000,PI,IP,001,1,13670,19711,6078,6041,PERF
42123328330000,PI,IP,001,1,13886,17908,4811,4022,PERF
42123328340000,PI,IP,001,1,13863,17885,4832,4022,PERF
42123328350000,PI,IP,001,1,13796,18112,5036,4316,PERF
42123328360000,PI,IP,001,1,13857,17924,4904,4067,PERF
42123328370000,PI,IP,001,1,13003,16902,4324,3899,PERF
42123328380000,PI,IP,001,1,13708,18333,5492,4625,PERF
42123328540000,PI,IP,001,1,13399,18529,5799,5130,PERF
42123328570000,PI,IP,001,1,12787,17564,4971,4777,PERF
42123328600000,PI,IP,001,1,12208,14578,2402,2370,PERF
42123328690000,PI,IP,001,1,12611,16623,4978,4012,PERF
42123328710000,PI,IP,001,1,13455,19207,,5752,PERF
42123328890000,PI,IP,001,1,12450,18937,7085,6487,PERF
42123329130000,PI,IP,001,1,13865,18053,4613,4188,PERF
42123329140000,PI,IP,001,1,13696,18049,4621,4353,PERF
42123329170000,PI,IP,001,1,13389,18469,5789,5080,PERF
42123329210000,PI,IP,001,1,13593,16925,3395,3332,PERF
42127333980100,PI,IP,001,1,7443,11094,3337,3651,PERF
42127334110100,PI,IP,001,1,5682,9512,,3830,OPENHOLE
42127334210100,PI,IP,001,1,6936,10664,3014,3728,OPENHOLE
42127335920000,PI,IP,001,1,6141,8747,,2606,PERF
42127336120000,PI,IP,001,1,8800,8805,3620,5,PERF
42127336120000,PI,IP,001,2,8900,8905,3620,5,PERF
42127336120000,PI,IP,001,3,9000,9005,3620,5,PERF
42127336120000,PI,IP,001,4,9100,9105,3620,5,PERF
42127336120000,PI,IP,001,5,9200,9205,3620,5,PERF
42127336120000,PI,IP,001,6,9300,9305,3620,5,PERF
42127336120000,PI,IP,001,7,9400,9405,3620,5,PERF
42127336120000,PI,IP,001,8,9500,9505,3620,5,PERF
42127336120000,PI,IP,001,9,9600,9605,3620,5,PERF
42127336120000,PI,IP,001,10,9700,9705,3620,5,PERF
42127336120000,PI,IP,001,11,9810,9812,3620,2,PERF
42127336120000,PI,IP,001,12,9850,9852,3620,2,PERF
42127336120000,PI,IP,001,13,9890,9892,3620,2,PERF
42127336120000,PI,IP,001,14,9930,9932,3620,2,PERF
42127336120000,PI,IP,001,15,9970,9972,3620,2,PERF
42127336120000,PI,IP,001,16,10070,10080,3620,10,PERF
42127336120000,PI,IP,001,17,10120,10130,3620,10,PERF
42127336120000,PI,IP,001,18,10220,10222,3620,2,PERF
42127336120000,PI,IP,001,19,10260,10262,3620,2,PERF
42127336120000,PI,IP,001,20,10300,10302,3620,2,PERF
42127336120000,PI,IP,001,21,10340,10342,3620,2,PERF
42127336120000,PI,IP,001,22,10380,10382,3620,2,PERF
42127336120000,PI,IP,001,23,10480,10482,3620,2,PERF
42127336120000,PI,IP,001,24,10520,10522,3620,2,PERF
42127336120000,PI,IP,001,25,10560,10562,3620,2,PERF
42127336120000,PI,IP,001,26,10600,10602,3620,2,PERF
42127336120000,PI,IP,001,27,10640,10642,3620,2,PERF
42127336120000,PI,IP,001,28,10740,10742,3620,2,PERF
42127336120000,PI,IP,001,29,10780,10782,3620,2,PERF
42127336120000,PI,IP,001,30,10820,10822,3620,2,PERF
42127336120000,PI,IP,001,31,10860,10862,3620,2,PERF
42127336120000,PI,IP,001,32,10900,10902,3620,2,PERF
42127336120000,PI,IP,001,33,11000,11010,3620,10,PERF
42127336120000,PI,IP,001,34,11100,11110,3620,10,PERF
42127336130000,PI,IP,001,1,7616,7749,4408,133,PERF
42127336130000,PI,IP,001,2,7836,7969,4408,133,PERF
42127336130000,PI,IP,001,3,8056,8189,4408,133,PERF
42127336130000,PI,IP,001,4,8276,8409,4408,133,PERF
42127336130000,PI,IP,001,5,8496,8629,4408,133,PERF
42127336130000,PI,IP,001,6,8716,8849,4408,133,PERF
42127336130000,PI,IP,001,7,8936,9069,4408,133,PERF
42127336130000,PI,IP,001,8,9156,9289,4408,133,PERF
42127336130000,PI,IP,001,9,9376,9509,4408,133,PERF
42127336130000,PI,IP,001,10,9596,9729,4408,133,PERF
42127336130000,PI,IP,001,11,9816,9949,4408,133,PERF
42127336130000,PI,IP,001,12,10036,10169,4408,133,PERF
42127336130000,PI,IP,001,13,10256,10389,4408,133,PERF
42127336130000,PI,IP,001,14,10476,10665,4408,189,PERF
42127336130000,PI,IP,001,15,10696,10829,4408,133,PERF
42127336130000,PI,IP,001,16,10916,11049,4408,133,PERF
42127336130000,PI,IP,001,17,11134,11310,4408,176,PERF
42127336150000,PI,IP,001,1,8595,8600,3420,5,PERF
42127336150000,PI,IP,001,2,8706,8711,3420,5,PERF
42127336150000,PI,IP,001,3,8925,8930,3420,5,PERF
42127336150000,PI,IP,001,4,9100,9105,3420,5,PERF
42127336150000,PI,IP,001,5,9210,9215,3420,5,PERF
42127336150000,PI,IP,001,6,9285,9290,3420,5,PERF
42127336150000,PI,IP,001,7,9420,9425,3420,5,PERF
42127336150000,PI,IP,001,8,9520,9525,3420,5,PERF
42127336150000,PI,IP,001,9,9612,9617,3420,5,PERF
42127336150000,PI,IP,001,10,9695,9700,3420,5,PERF
42127336150000,PI,IP,001,11,9820,9825,3420,5,PERF
42127336150000,PI,IP,001,12,9920,9925,3420,5,PERF
42127336150000,PI,IP,001,13,10042,10047,3420,5,PERF
42127336150000,PI,IP,001,14,10095,10100,3420,5,PERF
42127336150000,PI,IP,001,15,10220,10225,3420,5,PERF
42127336150000,PI,IP,001,16,10286,10291,3420,5,PERF
42127336150000,PI,IP,001,17,10353,10358,3420,5,PERF
42127336150000,PI,IP,001,18,10429,10434,3420,5,PERF
42127336150000,PI,IP,001,19,10610,10620,3420,10,PERF
42127336150000,PI,IP,001,20,10720,10725,3420,5,PERF
42127336180000,PI,IP,001,1,6415,9364,3931,2949,PERF
42127336200000,PI,IP,001,1,8980,12530,4700,3550,PERF
42127336210000,PI,IP,001,1,8668,11455,4195,2787,PERF
42127336210000,PI,IP,001,2,11645,12000,4195,355,OPENHOLE
42127336240000,PI,IP,001,1,8920,11585,4063,2665,PERF
42127336260000,PI,IP,001,1,6087,9359,3813,3272,PERF
42127336280000,PI,IP,001,1,7340,9653,3774,2313,PERF
42127336290000,PI,IP,001,1,8490,12064,5012,3574,COMB
42127336330000,PI,IP,001,1,7950,11643,5308,3693,PERF
42127336340000,PI,IP,001,1,6760,10744,5394,3984,PERF
42127336360000,PI,IP,001,1,8030,11153,4582,3123,PERF
42127336370000,PI,IP,001,1,8580,12904,5871,4324,PERF
42127336430000,PI,IP,001,1,8724,12956,5646,4232,PERF
42127336440000,PI,IP,001,1,8775,13328,5910,4553,PERF
42127336460000,PI,IP,001,1,8590,11854,4671,3264,PERF
42127336480000,PI,IP,001,1,8250,12404,5452,4154,PERF
42127336550100,PI,IP,001,1,8634,8636,5155,2,PERF
42127336550100,PI,IP,001,2,8679,8681,5155,2,PERF
42127336550100,PI,IP,001,3,8724,8726,5155,2,PERF
42127336550100,PI,IP,001,4,8769,8771,5155,2,PERF
42127336550100,PI,IP,001,5,8814,8816,5155,2,PERF
42127336550100,PI,IP,001,6,8859,8861,5155,2,PERF
42127336550100,PI,IP,001,7,8949,8951,5155,2,PERF
42127336550100,PI,IP,001,8,8994,8996,5155,2,PERF
42127336550100,PI,IP,001,9,9039,9041,5155,2,PERF
42127336550100,PI,IP,001,10,9084,9086,5155,2,PERF
42127336550100,PI,IP,001,11,9129,9131,5155,2,PERF
42127336550100,PI,IP,001,12,9174,9176,5155,2,PERF
42127336550100,PI,IP,001,13,9264,9266,5155,2,PERF
42127336550100,PI,IP,001,14,9309,9311,5155,2,PERF
42127336550100,PI,IP,001,15,9354,9356,5155,2,PERF
42127336550100,PI,IP,001,16,9399,9401,5155,2,PERF
42127336550100,PI,IP,001,17,9444,9446,5155,2,PERF
42127336550100,PI,IP,001,18,9489,9491,5155,2,PERF
42127336550100,PI,IP,001,19,9579,9581,5155,2,PERF
42127336550100,PI,IP,001,20,9624,9626,5155,2,PERF
42127336550100,PI,IP,001,21,9669,9671,5155,2,PERF
42127336550100,PI,IP,001,22,9714,9716,5155,2,PERF
42127336550100,PI,IP,001,23,9759,9761,5155,2,PERF
42127336550100,PI,IP,001,24,9804,9806,5155,2,PERF
42127336550100,PI,IP,001,25,9894,9896,5155,2,PERF
42127336550100,PI,IP,001,26,9939,9941,5155,2,PERF
42127336550100,PI,IP,001,27,9984,9986,5155,2,PERF
42127336550100,PI,IP,001,28,10029,10031,5155,2,PERF
42127336550100,PI,IP,001,29,10074,10076,5155,2,PERF
42127336550100,PI,IP,001,30,10119,10121,5155,2,PERF
42127336550100,PI,IP,001,31,10209,10211,5155,2,PERF
42127336550100,PI,IP,001,32,10254,10256,5155,2,PERF
42127336550100,PI,IP,001,33,10299,10301,5155,2,PERF
42127336550100,PI,IP,001,34,10344,10346,5155,2,PERF
42127336550100,PI,IP,001,35,10389,10391,5155,2,PERF
42127336550100,PI,IP,001,36,10434,10436,5155,2,PERF
42127336550100,PI,IP,001,37,10524,10526,5155,2,PERF
42127336550100,PI,IP,001,38,10569,10571,5155,2,PERF
42127336550100,PI,IP,001,39,10614,10616,5155,2,PERF
42127336550100,PI,IP,001,40,10659,10661,5155,2,PERF
42127336550100,PI,IP,001,41,10704,10706,5155,2,PERF
42127336550100,PI,IP,001,42,10749,10751,5155,2,PERF
42127336550100,PI,IP,001,43,10839,10841,5155,2,PERF
42127336550100,PI,IP,001,44,10884,10886,5155,2,PERF
42127336550100,PI,IP,001,45,10929,10931,5155,2,PERF
42127336550100,PI,IP,001,46,10974,10976,5155,2,PERF
42127336550100,PI,IP,001,47,11019,11021,5155,2,PERF
42127336550100,PI,IP,001,48,11064,11066,5155,2,PERF
42127336550100,PI,IP,001,49,11154,11156,5155,2,PERF
42127336550100,PI,IP,001,50,11199,11201,5155,2,PERF
42127336550100,PI,IP,001,51,11244,11246,5155,2,PERF
42127336550100,PI,IP,001,52,11289,11291,5155,2,PERF
42127336550100,PI,IP,001,53,11334,11336,5155,2,PERF
42127336550100,PI,IP,001,54,11379,11381,5155,2,PERF
42127336550100,PI,IP,001,55,11469,11471,5155,2,PERF
42127336550100,PI,IP,001,56,11514,11516,5155,2,PERF
42127336550100,PI,IP,001,57,11559,11561,5155,2,PERF
42127336550100,PI,IP,001,58,11604,11606,5155,2,PERF
42127336550100,PI,IP,001,59,11649,11651,5155,2,PERF
42127336550100,PI,IP,001,60,11694,11696,5155,2,PERF
42127336550100,PI,IP,001,61,11784,11786,5155,2,PERF
42127336550100,PI,IP,001,62,11829,11831,5155,2,PERF
42127336550100,PI,IP,001,63,11874,11876,5155,2,PERF
42127336550100,PI,IP,001,64,11919,11921,5155,2,PERF
42127336550100,PI,IP,001,65,11964,11966,5155,2,PERF
42127336550100,PI,IP,001,66,12009,12011,5155,2,PERF
42127336550100,PI,IP,001,67,12099,12101,5155,2,PERF
42127336550100,PI,IP,001,68,12144,12146,5155,2,PERF
42127336550100,PI,IP,001,69,12189,12191,5155,2,PERF
42127336550100,PI,IP,001,70,12234,12236,5155,2,PERF
42127336550100,PI,IP,001,71,12279,12281,5155,2,PERF
42127336550100,PI,IP,001,72,12324,12326,5155,2,PERF
42127336550100,PI,IP,001,73,12414,12416,5155,2,PERF
42127336550100,PI,IP,001,74,12459,12461,5155,2,PERF
42127336550100,PI,IP,001,75,12504,12506,5155,2,PERF
42127336550100,PI,IP,001,76,12549,12551,5155,2,PERF
42127336550100,PI,IP,001,77,12594,12596,5155,2,PERF
42127336550100,PI,IP,001,78,12639,12641,5155,2,PERF
42127336550100,PI,IP,001,79,12729,12731,5155,2,PERF
42127336550100,PI,IP,001,80,12774,12776,5155,2,PERF
42127336550100,PI,IP,001,81,12819,12821,5155,2,PERF
42127336550100,PI,IP,001,82,12864,12866,5155,2,PERF
42127336550100,PI,IP,001,83,12909,12911,5155,2,PERF
42127336550100,PI,IP,001,84,12954,12956,5155,2,PERF
42127336570000,PI,IP,001,1,8430,11783,4981,3353,PERF
42127336580000,PI,IP,001,1,8350,12752,5614,4402,PERF
42127336590000,PI,IP,001,1,8918,12562,5021,3644,PERF
42127336600000,PI,IP,001,1,7345,10853,4486,3508,PERF
42127336610000,PI,IP,001,1,8700,13102,6228,4402,PERF
42127336620000,PI,IP,001,1,8850,13403,5618,4553,PERF
42127336640000,PI,IP,001,1,8860,13103,5616,4243,PERF
42127336650000,PI,IP,001,1,7699,7860,6763,161,PERF
42127336650000,PI,IP,001,2,7949,8110,6763,161,PERF
42127336650000,PI,IP,001,3,8199,8360,6763,161,PERF
42127336650000,PI,IP,001,4,8449,8610,6763,161,PERF
42127336650000,PI,IP,001,5,8699,8860,6763,161,PERF
42127336650000,PI,IP,001,6,8949,9110,6763,161,PERF
42127336650000,PI,IP,001,7,9199,9369,6763,170,PERF
42127336650000,PI,IP,001,8,9449,9610,6763,161,PERF
42127336650000,PI,IP,001,9,9699,9860,6763,161,PERF
42127336650000,PI,IP,001,10,9949,10110,6763,161,PERF
42127336650000,PI,IP,001,11,10199,10360,6763,161,PERF
42127336650000,PI,IP,001,12,10449,10610,6763,161,PERF
42127336650000,PI,IP,001,13,10699,10860,6763,161,PERF
42127336650000,PI,IP,001,14,10949,11110,6763,161,PERF
42127336650000,PI,IP,001,15,11199,11360,6763,161,PERF
42127336650000,PI,IP,001,16,11449,11654,6763,205,PERF
42127336650000,PI,IP,001,17,11699,11860,6763,161,PERF
42127336650000,PI,IP,001,18,11949,12110,6763,161,PERF
42127336650000,PI,IP,001,19,12199,12360,6763,161,PERF
42127336650000,PI,IP,001,20,12449,12610,6763,161,PERF
42127336650000,PI,IP,001,21,12699,12860,6763,161,PERF
42127336650000,PI,IP,001,22,12949,13110,6763,161,PERF
42127336650000,PI,IP,001,23,13199,13360,6763,161,PERF
42127336650000,PI,IP,001,24,13449,13610,6763,161,PERF
42127336650000,PI,IP,001,25,13699,13860,6763,161,PERF
42127336660000,PI,IP,001,1,8153,12552,5836,4399,PERF
42127336670000,PI,IP,001,1,8324,13383,5613,5059,PERF
42127336680000,PI,IP,001,1,8947,13408,5621,4461,PERF
42127336690000,PI,IP,001,1,8990,13233,5613,4243,PERF
42127336700000,PI,IP,001,1,9005,13468,5617,4463,PERF
42127336710000,PI,IP,001,1,9900,14228,6287,4328,PERF
42127336720000,PI,IP,001,1,9140,14003,6214,4863,PERF
42127336730000,PI,IP,001,1,6570,10952,5637,4382,PERF
42127336740000,PI,IP,001,1,8765,13767,6640,5002,PERF
42127336760000,PI,IP,001,1,6664,9589,3512,2925,PERF
42127336770000,PI,IP,001,1,8670,13223,6209,4553,PERF
42127336780000,PI,IP,001,1,9230,14253,6304,5023,PERF
42127336790000,PI,IP,001,1,7670,11772,5330,4102,PERF
42127336800000,PI,IP,001,1,9100,13802,6429,4702,PERF
42127336810000,PI,IP,001,1,7445,11863,5806,4418,PERF
42127336840000,PI,IP,001,1,8500,12403,5305,3903,PERF
42127336850000,PI,IP,001,1,8012,13083,6169,5071,PERF
42127336860000,PI,IP,001,1,7640,10798,4827,3158,PERF
42127336860000,PI,PT,001,1,7640,10798,4827,3158,PERF
42127336860000,PI,PT,001,2,10895,11108,4827,213,PERF
42127336870000,PI,IP,001,1,8170,13633,6320,5463,PERF
42127336890000,PI,IP,001,1,8554,12837,5519,4283,PERF
42127336900000,PI,IP,001,1,8868,13788,6264,4920,PERF
42127336910000,PI,IP,001,1,6255,9847,4753,3592,PERF
42127336920000,PI,IP,001,1,7050,7732,7156,682,PERF
42127336920000,PI,IP,001,2,7830,8772,7156,942,PERF
42127336920000,PI,IP,001,3,8870,9812,7156,942,PERF
42127336920000,PI,IP,001,4,9910,10852,7156,942,PERF
42127336920000,PI,IP,001,5,10950,11892,7156,942,PERF
42127336920000,PI,IP,001,6,11990,12932,7156,942,PERF
42127336920000,PI,IP,001,7,13030,13452,7156,422,PERF
42127336920000,PI,IP,001,8,13550,13712,7156,162,PERF
42127336930000,PI,IP,001,1,8044,13268,6284,5224,PERF
42127336940000,PI,IP,001,1,7859,12530,5453,4671,PERF
42127336950000,PI,IP,001,1,9130,11813,6761,2683,PERF
42127336950000,PI,IP,001,2,11908,12275,6761,367,OPENHOLE
42127336960000,PI,IP,001,1,8658,13633,6215,4975,PERF
42127336980000,PI,IP,001,1,6463,6686,5669,223,PERF
42127336980000,PI,IP,001,2,6782,6998,5669,216,PERF
42127336980000,PI,IP,001,3,7087,7303,5669,216,PERF
42127336980000,PI,IP,001,4,7402,7622,5669,220,PERF
42127336980000,PI,IP,001,5,7711,7934,5669,223,PERF
42127336980000,PI,IP,001,6,8030,8246,5669,216,PERF
42127336980000,PI,IP,001,7,8335,8558,5669,223,PERF
42127336980000,PI,IP,001,8,8647,8870,5669,223,PERF
42127336980000,PI,IP,001,9,9010,9173,5669,163,PERF
42127336980000,PI,IP,001,10,9271,9494,5669,223,PERF
42127336980000,PI,IP,001,11,9583,9806,5669,223,PERF
42127336980000,PI,IP,001,12,9895,10118,5669,223,PERF
42127336980000,PI,IP,001,13,10207,10430,5669,223,PERF
42127336980000,PI,IP,001,14,10523,10742,5669,219,PERF
42127336980000,PI,IP,001,15,10831,11048,5669,217,PERF
42127336980000,PI,IP,001,16,11143,11386,5669,243,PERF
42127336990000,PI,IP,001,1,8160,13423,6203,5263,PERF
42127337000000,PI,IP,001,1,8472,13633,6282,5161,PERF
42127337010000,PI,IP,001,1,6344,6409,6767,65,PERF
42127337010000,PI,IP,001,2,6804,7165,6767,361,PERF
42127337010000,PI,IP,001,3,7264,7625,6767,361,PERF
42127337010000,PI,IP,001,4,7724,8085,6767,361,PERF
42127337010000,PI,IP,001,5,8184,8545,6767,361,PERF
42127337010000,PI,IP,001,6,8644,9005,6767,361,PERF
42127337010000,PI,IP,001,7,9104,9465,6767,361,PERF
42127337010000,PI,IP,001,8,9564,9925,6767,361,PERF
42127337010000,PI,IP,001,9,10024,10385,6767,361,PERF
42127337010000,PI,IP,001,10,10484,10845,6767,361,PERF
42127337010000,PI,IP,001,11,10944,11305,6767,361,PERF
42127337010000,PI,IP,001,12,11404,11765,6767,361,PERF
42127337010000,PI,IP,001,13,11864,12225,6767,361,PERF
42127337010000,PI,IP,001,14,12354,12510,6767,156,PERF
42127337020000,PI,IP,001,1,6424,6580,5521,156,PERF
42127337020000,PI,IP,001,2,6679,6835,5521,156,PERF
42127337020000,PI,IP,001,3,6934,7090,5521,156,PERF
42127337020000,PI,IP,001,4,7189,7345,5521,156,PERF
42127337020000,PI,IP,001,5,7444,7600,5521,156,PERF
42127337020000,PI,IP,001,6,7699,7855,5521,156,PERF
42127337020000,PI,IP,001,7,7954,8110,5521,156,PERF
42127337020000,PI,IP,001,8,8209,8365,5521,156,PERF
42127337020000,PI,IP,001,9,8464,8620,5521,156,PERF
42127337020000,PI,IP,001,10,8719,8875,5521,156,PERF
42127337020000,PI,IP,001,11,8974,9130,5521,156,PERF
42127337020000,PI,IP,001,12,9229,9385,5521,156,PERF
42127337020000,PI,IP,001,13,9484,9640,5521,156,PERF
42127337020000,PI,IP,001,14,9739,9895,5521,156,PERF
42127337020000,PI,IP,001,15,9994,10150,5521,156,PERF
42127337020000,PI,IP,001,16,10249,10405,5521,156,PERF
42127337020000,PI,IP,001,17,10504,10660,5521,156,PERF
42127337020000,PI,IP,001,18,10759,10915,5521,156,PERF
42127337020000,PI,IP,001,19,11014,11170,5521,156,PERF
42127337020000,PI,IP,001,20,11269,11425,5521,156,PERF
42127337020000,PI,IP,001,21,11524,11680,5521,156,PERF
42127337030000,PI,IP,001,1,7128,7350,5841,222,PERF
42127337030000,PI,IP,001,2,7440,7669,5841,229,PERF
42127337030000,PI,IP,001,3,7758,7982,5841,224,PERF
42127337030000,PI,IP,001,4,8082,8298,5841,216,PERF
42127337030000,PI,IP,001,5,8388,8614,5841,226,PERF
42127337030000,PI,IP,001,6,8704,8925,5841,221,PERF
42127337030000,PI,IP,001,7,9020,9246,5841,226,PERF
42127337030000,PI,IP,001,8,9336,9562,5841,226,PERF
42127337030000,PI,IP,001,9,9652,9873,5841,221,PERF
42127337030000,PI,IP,001,10,9968,10194,5841,226,PERF
42127337030000,PI,IP,001,11,10290,10510,5841,220,PERF
42127337030000,PI,IP,001,12,10600,10818,5841,218,PERF
42127337030000,PI,IP,001,13,10916,11142,5841,226,PERF
42127337030000,PI,IP,001,14,11237,11458,5841,221,PERF
42127337030000,PI,IP,001,15,11548,11774,5841,226,PERF
42127337030000,PI,IP,001,16,11864,12090,5841,226,PERF
42127337050000,PI,IP,001,1,7890,11783,5813,3893,PERF
42127337050000,PI,IP,001,2,11975,12245,5813,270,OPENHOLE
42127337060000,PI,IP,001,1,7720,11963,5798,4243,PERF
42127337070100,PI,IP,001,1,8379,8381,6005,2,PERF
42127337070100,PI,IP,001,2,8454,8456,6005,2,PERF
42127337070100,PI,IP,001,3,8526,8528,6005,2,PERF
42127337070100,PI,IP,001,4,8604,8606,6005,2,PERF
42127337070100,PI,IP,001,5,8721,8723,6005,2,PERF
42127337070100,PI,IP,001,6,8800,8802,6005,2,PERF
42127337070100,PI,IP,001,7,8871,8873,6005,2,PERF
42127337070100,PI,IP,001,8,8946,8948,6005,2,PERF
42127337070100,PI,IP,001,9,9063,9065,6005,2,PERF
42127337070100,PI,IP,001,10,9138,9140,6005,2,PERF
42127337070100,PI,IP,001,11,9213,9215,6005,2,PERF
42127337070100,PI,IP,001,12,9288,9290,6005,2,PERF
42127337070100,PI,IP,001,13,9410,9412,6005,2,PERF
42127337070100,PI,IP,001,14,9480,9482,6005,2,PERF
42127337070100,PI,IP,001,15,9555,9557,6005,2,PERF
42127337070100,PI,IP,001,16,9630,9632,6005,2,PERF
42127337070100,PI,IP,001,17,9754,9756,6005,2,PERF
42127337070100,PI,IP,001,18,9822,9824,6005,2,PERF
42127337070100,PI,IP,001,19,9897,9899,6005,2,PERF
42127337070100,PI,IP,001,20,9972,9974,6005,2,PERF
42127337070100,PI,IP,001,21,10089,10091,6005,2,PERF
42127337070100,PI,IP,001,22,10164,10166,6005,2,PERF
42127337070100,PI,IP,001,23,10239,10241,6005,2,PERF
42127337070100,PI,IP,001,24,10318,10320,6005,2,PERF
42127337070100,PI,IP,001,25,10431,10433,6005,2,PERF
42127337070100,PI,IP,001,26,10506,10508,6005,2,PERF
42127337070100,PI,IP,001,27,10581,10583,6005,2,PERF
42127337070100,PI,IP,001,28,10664,10666,6005,2,PERF
42127337070100,PI,IP,001,29,10773,10775,6005,2,PERF
42127337070100,PI,IP,001,30,10848,10850,6005,2,PERF
42127337070100,PI,IP,001,31,10923,10925,6005,2,PERF
42127337070100,PI,IP,001,32,11004,11006,6005,2,PERF
42127337070100,PI,IP,001,33,11115,11117,6005,2,PERF
42127337070100,PI,IP,001,34,11190,11192,6005,2,PERF
42127337070100,PI,IP,001,35,11265,11267,6005,2,PERF
42127337070100,PI,IP,001,36,11334,11336,6005,2,PERF
42127337070100,PI,IP,001,37,11457,11459,6005,2,PERF
42127337070100,PI,IP,001,38,11532,11534,6005,2,PERF
42127337070100,PI,IP,001,39,11610,11612,6005,2,PERF
42127337070100,PI,IP,001,40,11682,11684,6005,2,PERF
42127337070100,PI,IP,001,41,11799,11801,6005,2,PERF
42127337070100,PI,IP,001,42,11874,11876,6005,2,PERF
42127337070100,PI,IP,001,43,11940,11942,6005,2,PERF
42127337070100,PI,IP,001,44,12024,12026,6005,2,PERF
42127337070100,PI,IP,001,45,12141,12143,6005,2,PERF
42127337070100,PI,IP,001,46,12216,12218,6005,2,PERF
42127337070100,PI,IP,001,47,12291,12293,6005,2,PERF
42127337070100,PI,IP,001,48,12366,12368,6005,2,PERF
42127337070100,PI,IP,001,49,12483,12485,6005,2,PERF
42127337070100,PI,IP,001,50,12558,12560,6005,2,PERF
42127337070100,PI,IP,001,51,12633,12635,6005,2,PERF
42127337070100,PI,IP,001,52,12708,12710,6005,2,PERF
42127337070100,PI,IP,001,53,12825,12825,6005,0,PERF
42127337070100,PI,IP,001,54,12900,12900,6005,0,PERF
42127337070100,PI,IP,001,55,12975,12975,6005,0,PERF
42127337070100,PI,IP,001,56,13050,13050,6005,0,PERF
42127337080000,PI,IP,001,1,9228,13108,5652,3880,PERF
42127337090000,PI,IP,001,1,9135,13103,5696,3968,PERF
42127337100000,PI,IP,001,1,5419,5653,3574,234,PERF
42127337100000,PI,IP,001,2,5745,5979,3574,234,PERF
42127337100000,PI,IP,001,3,6075,6247,3574,172,PERF
42127337100000,PI,IP,001,4,6397,6648,3574,251,PERF
42127337100000,PI,IP,001,5,6723,6957,3574,234,PERF
42127337100000,PI,IP,001,6,7049,7283,3574,234,PERF
42127337100000,PI,IP,001,7,7375,7609,3574,234,PERF
42127337100000,PI,IP,001,8,7703,7935,3574,232,PERF
42127337100000,PI,IP,001,9,8027,8261,3574,234,PERF
42127337100000,PI,IP,001,10,8353,8582,3574,229,PERF
42127337120000,PI,IP,001,1,7190,7431,5853,241,PERF
42127337120000,PI,IP,001,2,7513,7743,5853,230,PERF
42127337120000,PI,IP,001,3,7840,8071,5853,231,PERF
42127337120000,PI,IP,001,4,8159,8394,5853,235,PERF
42127337120000,PI,IP,001,5,8482,8733,5853,251,PERF
42127337120000,PI,IP,001,6,8805,9040,5853,235,PERF
42127337120000,PI,IP,001,7,9138,9363,5853,225,PERF
42127337120000,PI,IP,001,8,9448,9686,5853,238,PERF
42127337120000,PI,IP,001,9,9774,9984,5853,210,PERF
42127337120000,PI,IP,001,10,10097,10338,5853,241,PERF
42127337120000,PI,IP,001,11,10420,10651,5853,231,PERF
42127337120000,PI,IP,001,12,10743,10978,5853,235,PERF
42127337120000,PI,IP,001,13,11060,11301,5853,241,PERF
42127337120000,PI,IP,001,14,11389,11624,5853,235,PERF
42127337120000,PI,IP,001,15,11712,11947,5853,235,PERF
42127337120000,PI,IP,001,16,12035,12270,5853,235,PERF
42127337130000,PI,IP,001,1,8484,8485,5155,1,PERF
42127337130000,PI,IP,001,2,8562,8563,5155,1,PERF
42127337130000,PI,IP,001,3,8640,8641,5155,1,PERF
42127337130000,PI,IP,001,4,8718,8719,5155,1,PERF
42127337130000,PI,IP,001,5,8796,8797,5155,1,PERF
42127337130000,PI,IP,001,6,8874,8875,5155,1,PERF
42127337130000,PI,IP,001,7,8952,8953,5155,1,PERF
42127337130000,PI,IP,001,8,9030,9031,5155,1,PERF
42127337130000,PI,IP,001,9,9109,9110,5155,1,PERF
42127337130000,PI,IP,001,10,9187,9188,5155,1,PERF
42127337130000,PI,IP,001,11,9265,9266,5155,1,PERF
42127337130000,PI,IP,001,12,9343,9344,5155,1,PERF
42127337130000,PI,IP,001,13,9421,9422,5155,1,PERF
42127337130000,PI,IP,001,14,9499,9500,5155,1,PERF
42127337130000,PI,IP,001,15,9577,9578,5155,1,PERF
42127337130000,PI,IP,001,16,9655,9656,5155,1,PERF
42127337130000,PI,IP,001,17,9734,9735,5155,1,PERF
42127337130000,PI,IP,001,18,9812,9813,5155,1,PERF
42127337130000,PI,IP,001,19,9890,9891,5155,1,PERF
42127337130000,PI,IP,001,20,9968,9969,5155,1,PERF
42127337130000,PI,IP,001,21,10046,10047,5155,1,PERF
42127337130000,PI,IP,001,22,10124,10125,5155,1,PERF
42127337130000,PI,IP,001,23,10202,10203,5155,1,PERF
42127337130000,PI,IP,001,24,10280,10281,5155,1,PERF
42127337130000,PI,IP,001,25,10359,10360,5155,1,PERF
42127337130000,PI,IP,001,26,10437,10438,5155,1,PERF
42127337130000,PI,IP,001,27,10515,10516,5155,1,PERF
42127337130000,PI,IP,001,28,10593,10594,5155,1,PERF
42127337130000,PI,IP,001,29,10671,10672,5155,1,PERF
42127337130000,PI,IP,001,30,10749,10750,5155,1,PERF
42127337130000,PI,IP,001,31,10827,10828,5155,1,PERF
42127337130000,PI,IP,001,32,10905,10906,5155,1,PERF
42127337130000,PI,IP,001,33,10984,10985,5155,1,PERF
42127337130000,PI,IP,001,34,11062,11063,5155,1,PERF
42127337130000,PI,IP,001,35,11140,11141,5155,1,PERF
42127337130000,PI,IP,001,36,11218,11219,5155,1,PERF
42127337130000,PI,IP,001,37,11296,11297,5155,1,PERF
42127337130000,PI,IP,001,38,11374,11375,5155,1,PERF
42127337130000,PI,IP,001,39,11452,11453,5155,1,PERF
42127337130000,PI,IP,001,40,11530,11531,5155,1,PERF
42127337130000,PI,IP,001,41,11609,11610,5155,1,PERF
42127337130000,PI,IP,001,42,11687,11688,5155,1,PERF
42127337130000,PI,IP,001,43,11765,11766,5155,1,PERF
42127337130000,PI,IP,001,44,11843,11844,5155,1,PERF
42127337130000,PI,IP,001,45,11921,11922,5155,1,PERF
42127337130000,PI,IP,001,46,11999,12000,5155,1,PERF
42127337130000,PI,IP,001,47,12077,12078,5155,1,PERF
42127337130000,PI,IP,001,48,12155,12156,5155,1,PERF
42127337130000,PI,IP,001,49,12234,12235,5155,1,PERF
42127337130000,PI,IP,001,50,12312,12313,5155,1,PERF
42127337130000,PI,IP,001,51,12390,12391,5155,1,PERF
42127337130000,PI,IP,001,52,12468,12469,5155,1,PERF
42127337130000,PI,IP,001,53,12546,12547,5155,1,PERF
42127337130000,PI,IP,001,54,12624,12625,5155,1,PERF
42127337130000,PI,IP,001,55,12702,12703,5155,1,PERF
42127337130000,PI,IP,001,56,12780,12781,5155,1,PERF
42127337130000,PI,IP,001,57,12858,12859,5155,1,PERF
42127337130000,PI,IP,001,58,12936,12937,5155,1,PERF
42127337130000,PI,IP,001,59,13014,13015,5155,1,PERF
42127337130000,PI,IP,001,60,13058,13059,5155,1,PERF
42127337140000,PI,IP,001,1,6478,6752,,274,PERF
42127337140000,PI,IP,001,2,6851,7125,,274,PERF
42127337140000,PI,IP,001,3,7224,7498,,274,PERF
42127337140000,PI,IP,001,4,7597,7871,,274,PERF
42127337140000,PI,IP,001,5,7970,8244,,274,PERF
42127337140000,PI,IP,001,6,8343,8617,,274,PERF
42127337140000,PI,IP,001,7,8716,8990,,274,PERF
42127337140000,PI,IP,001,8,9089,9363,,274,PERF
42127337140000,PI,IP,001,9,9462,9736,,274,PERF
42127337140000,PI,IP,001,10,9835,10109,,274,PERF
42127337140000,PI,IP,001,11,10208,10482,,274,PERF
42127337140000,PI,IP,001,12,10581,10855,,274,PERF
42127337140000,PI,IP,001,13,10954,11228,,274,PERF
42127337140000,PI,IP,001,14,11327,11601,,274,PERF
42127337140000,PI,IP,001,15,11700,11974,,274,PERF
42127337140000,PI,IP,001,16,12073,12347,,274,PERF
42127337140000,PI,IP,001,17,12446,12720,,274,PERF
42127337140000,PI,IP,001,18,12819,13093,,274,PERF
42127337140000,PI,IP,001,19,13192,13466,,274,PERF
42127337150000,PI,IP,001,1,6142,11855,6145,5713,PERF
42127337160000,PI,IP,001,1,6078,11836,6126,5758,PERF
42127337170000,PI,IP,001,1,8134,13093,5833,4959,PERF
42127337190000,PI,IP,001,1,8565,13208,5964,4643,PERF
42127337200000,PI,IP,001,1,9128,14133,6254,5005,PERF
42127337210000,PI,IP,001,1,8665,14028,6217,5363,PERF
42127337220000,PI,IP,001,1,9360,14093,6334,4733,PERF
42127337230000,PI,IP,001,1,8330,13813,6465,5483,PERF
42127337240000,PI,IP,001,1,8212,12100,4903,3888,PERF
42127337250000,PI,IP,001,1,9225,13328,6008,4103,PERF
42127337280000,PI,IP,001,1,7185,13374,6710,6189,PERF
42127337290000,PI,IP,001,1,9050,12873,5124,3823,PERF
42127337300000,PI,IP,001,1,8299,8300,4928,1,PERF
42127337300000,PI,IP,001,2,8379,8380,4928,1,PERF
42127337300000,PI,IP,001,3,8469,8470,4928,1,PERF
42127337300000,PI,IP,001,4,8559,8560,4928,1,PERF
42127337300000,PI,IP,001,5,8639,8640,4928,1,PERF
42127337300000,PI,IP,001,6,8729,8730,4928,1,PERF
42127337300000,PI,IP,001,7,8819,8820,4928,1,PERF
42127337300000,PI,IP,001,8,8909,8910,4928,1,PERF
42127337300000,PI,IP,001,9,8979,8980,4928,1,PERF
42127337300000,PI,IP,001,10,9059,9060,4928,1,PERF
42127337300000,PI,IP,001,11,9139,9140,4928,1,PERF
42127337300000,PI,IP,001,12,9219,9220,4928,1,PERF
42127337300000,PI,IP,001,13,9280,9281,4928,1,PERF
42127337300000,PI,IP,001,14,9343,9344,4928,1,PERF
42127337300000,PI,IP,001,15,9406,9407,4928,1,PERF
42127337300000,PI,IP,001,16,9469,9470,4928,1,PERF
42127337300000,PI,IP,001,17,9530,9531,4928,1,PERF
42127337300000,PI,IP,001,18,9593,9594,4928,1,PERF
42127337300000,PI,IP,001,19,9656,9657,4928,1,PERF
42127337300000,PI,IP,001,20,9719,9720,4928,1,PERF
42127337300000,PI,IP,001,21,9780,9781,4928,1,PERF
42127337300000,PI,IP,001,22,9843,9844,4928,1,PERF
42127337300000,PI,IP,001,23,9906,9907,4928,1,PERF
42127337300000,PI,IP,001,24,9969,9970,4928,1,PERF
42127337300000,PI,IP,001,25,10030,10031,4928,1,PERF
42127337300000,PI,IP,001,26,10093,10094,4928,1,PERF
42127337300000,PI,IP,001,27,10156,10157,4928,1,PERF
42127337300000,PI,IP,001,28,10219,10220,4928,1,PERF
42127337300000,PI,IP,001,29,10279,10280,4928,1,PERF
42127337300000,PI,IP,001,30,10359,10360,4928,1,PERF
42127337300000,PI,IP,001,31,10439,10440,4928,1,PERF
42127337300000,PI,IP,001,32,10519,10520,4928,1,PERF
42127337300000,PI,IP,001,33,10579,10580,4928,1,PERF
42127337300000,PI,IP,001,34,10659,10660,4928,1,PERF
42127337300000,PI,IP,001,35,10739,10740,4928,1,PERF
42127337300000,PI,IP,001,36,10819,10820,4928,1,PERF
42127337300000,PI,IP,001,37,10880,10881,4928,1,PERF
42127337300000,PI,IP,001,38,10943,10944,4928,1,PERF
42127337300000,PI,IP,001,39,11056,11057,4928,1,PERF
42127337300000,PI,IP,001,40,11069,11070,4928,1,PERF
42127337300000,PI,IP,001,41,11130,11131,4928,1,PERF
42127337300000,PI,IP,001,42,11193,11194,4928,1,PERF
42127337300000,PI,IP,001,43,11256,11257,4928,1,PERF
42127337300000,PI,IP,001,44,11319,11320,4928,1,PERF
42127337300000,PI,IP,001,45,11380,11380,4928,0,PERF
42127337300000,PI,IP,001,46,11459,11460,4928,1,PERF
42127337300000,PI,IP,001,47,11539,11540,4928,1,PERF
42127337300000,PI,IP,001,48,11619,11620,4928,1,PERF
42127337300000,PI,IP,001,49,11680,11681,4928,1,PERF
42127337300000,PI,IP,001,50,11743,11744,4928,1,PERF
42127337300000,PI,IP,001,51,11806,11807,4928,1,PERF
42127337300000,PI,IP,001,52,11869,11870,4928,1,PERF
42127337300000,PI,IP,001,53,11930,11931,4928,1,PERF
42127337300000,PI,IP,001,54,11993,11994,4928,1,PERF
42127337300000,PI,IP,001,55,12056,12057,4928,1,PERF
42127337300000,PI,IP,001,56,12119,12120,4928,1,PERF
42127337300000,PI,IP,001,57,12176,12178,4928,2,PERF
42127337300000,PI,IP,001,58,12250,12252,4928,2,PERF
42127337300000,PI,IP,001,59,12324,12326,4928,2,PERF
42127337300000,PI,IP,001,60,12398,12400,4928,2,PERF
42127337330000,PI,IP,001,1,7767,11858,5521,4091,PERF
42127337350000,PI,IP,001,1,7263,10878,4753,3615,PERF
42127337360000,PI,IP,001,1,7622,11683,5390,4061,PERF
42127337370000,PI,IP,001,1,5597,5821,6094,224,PERF
42127337370000,PI,IP,001,2,5915,6139,6094,224,PERF
42127337370000,PI,IP,001,3,6236,6457,6094,221,PERF
42127337370000,PI,IP,001,4,6551,6779,6094,228,PERF
42127337370000,PI,IP,001,5,6869,7093,6094,224,PERF
42127337370000,PI,IP,001,6,7187,7411,6094,224,PERF
42127337370000,PI,IP,001,7,7505,7729,6094,224,PERF
42127337370000,PI,IP,001,8,7823,8047,6094,224,PERF
42127337370000,PI,IP,001,9,8141,8365,6094,224,PERF
42127337370000,PI,IP,001,10,8459,8683,6094,224,PERF
42127337370000,PI,IP,001,11,8777,9001,6094,224,PERF
42127337370000,PI,IP,001,12,9095,9319,6094,224,PERF
42127337370000,PI,IP,001,13,9410,9637,6094,227,PERF
42127337370000,PI,IP,001,14,9731,9953,6094,222,PERF
42127337370000,PI,IP,001,15,10049,10273,6094,224,PERF
42127337370000,PI,IP,001,16,10367,10591,6094,224,PERF
42127337380000,PI,IP,001,1,7074,12617,6054,5543,PERF
42127337400000,PI,IP,001,1,6513,11941,6826,5428,PERF
42127337450000,PI,IP,001,1,9000,9002,5340,2,PERF
42127337450000,PI,IP,001,2,9078,9079,5340,1,PERF
42127337450000,PI,IP,001,3,9155,9156,5340,1,PERF
42127337450000,PI,IP,001,4,9232,9233,5340,1,PERF
42127337450000,PI,IP,001,5,9292,9293,5340,1,PERF
42127337450000,PI,IP,001,6,9369,9370,5340,1,PERF
42127337450000,PI,IP,001,7,9446,9447,5340,1,PERF
42127337450000,PI,IP,001,8,9553,9554,5340,1,PERF
42127337450000,PI,IP,001,9,9583,9584,5340,1,PERF
42127337450000,PI,IP,001,10,9660,9661,5340,1,PERF
42127337450000,PI,IP,001,11,9737,9738,5340,1,PERF
42127337450000,PI,IP,001,12,9814,9815,5340,1,PERF
42127337450000,PI,IP,001,13,9874,9875,5340,1,PERF
42127337450000,PI,IP,001,14,9951,9952,5340,1,PERF
42127337450000,PI,IP,001,15,10028,10029,5340,1,PERF
42127337450000,PI,IP,001,16,10105,10106,5340,1,PERF
42127337450000,PI,IP,001,17,10165,10166,5340,1,PERF
42127337450000,PI,IP,001,18,10242,10243,5340,1,PERF
42127337450000,PI,IP,001,19,10319,10320,5340,1,PERF
42127337450000,PI,IP,001,20,10394,10397,5340,3,PERF
42127337450000,PI,IP,001,21,10456,10457,5340,1,PERF
42127337450000,PI,IP,001,22,10533,10534,5340,1,PERF
42127337450000,PI,IP,001,23,10610,10611,5340,1,PERF
42127337450000,PI,IP,001,24,10687,10688,5340,1,PERF
42127337450000,PI,IP,001,25,10747,10748,5340,1,PERF
42127337450000,PI,IP,001,26,10824,10825,5340,1,PERF
42127337450000,PI,IP,001,27,10901,10902,5340,1,PERF
42127337450000,PI,IP,001,28,10978,10979,5340,1,PERF
42127337450000,PI,IP,001,29,11038,11039,5340,1,PERF
42127337450000,PI,IP,001,30,11115,11116,5340,1,PERF
42127337450000,PI,IP,001,31,11192,11193,5340,1,PERF
42127337450000,PI,IP,001,32,11272,11274,5340,2,PERF
42127337450000,PI,IP,001,33,11329,11330,5340,1,PERF
42127337450000,PI,IP,001,34,11408,11410,5340,2,PERF
42127337450000,PI,IP,001,35,11483,11484,5340,1,PERF
42127337450000,PI,IP,001,36,11560,11561,5340,1,PERF
42127337450000,PI,IP,001,37,11620,11621,5340,1,PERF
42127337450000,PI,IP,001,38,11697,11698,5340,1,PERF
42127337450000,PI,IP,001,39,11774,11775,5340,1,PERF
42127337450000,PI,IP,001,40,11851,11852,5340,1,PERF
42127337450000,PI,IP,001,41,11911,11912,5340,1,PERF
42127337450000,PI,IP,001,42,11988,11989,5340,1,PERF
42127337450000,PI,IP,001,43,12065,12066,5340,1,PERF
42127337450000,PI,IP,001,44,12142,12143,5340,1,PERF
42127337450000,PI,IP,001,45,12202,12203,5340,1,PERF
42127337450000,PI,IP,001,46,12279,12280,5340,1,PERF
42127337450000,PI,IP,001,47,12356,12357,5340,1,PERF
42127337450000,PI,IP,001,48,12433,12434,5340,1,PERF
42127337450000,PI,IP,001,49,12493,12494,5340,1,PERF
42127337450000,PI,IP,001,50,12570,12571,5340,1,PERF
42127337450000,PI,IP,001,51,12647,12648,5340,1,PERF
42127337450000,PI,IP,001,52,12724,12725,5340,1,PERF
42127337450000,PI,IP,001,53,12785,12787,5340,2,PERF
42127337450000,PI,IP,001,54,12855,12857,5340,2,PERF
42127337450000,PI,IP,001,55,12925,12927,5340,2,PERF
42127337450000,PI,IP,001,56,12995,12997,5340,2,PERF
42127337460000,PI,IP,001,1,7039,7041,7408,2,PERF
42127337460000,PI,IP,001,2,7080,7082,7408,2,PERF
42127337460000,PI,IP,001,3,7121,7123,7408,2,PERF
42127337460000,PI,IP,001,4,7162,7164,7408,2,PERF
42127337460000,PI,IP,001,5,7203,7205,7408,2,PERF
42127337460000,PI,IP,001,6,7308,7310,7408,2,PERF
42127337460000,PI,IP,001,7,7349,7351,7408,2,PERF
42127337460000,PI,IP,001,8,7390,7392,7408,2,PERF
42127337460000,PI,IP,001,9,7431,7433,7408,2,PERF
42127337460000,PI,IP,001,10,7472,7474,7408,2,PERF
42127337460000,PI,IP,001,11,7577,7579,7408,2,PERF
42127337460000,PI,IP,001,12,7618,7620,7408,2,PERF
42127337460000,PI,IP,001,13,7659,7661,7408,2,PERF
42127337460000,PI,IP,001,14,7700,7702,7408,2,PERF
42127337460000,PI,IP,001,15,7741,7743,7408,2,PERF
42127337460000,PI,IP,001,16,7846,7848,7408,2,PERF
42127337460000,PI,IP,001,17,7887,7889,7408,2,PERF
42127337460000,PI,IP,001,18,7928,7930,7408,2,PERF
42127337460000,PI,IP,001,19,7969,7971,7408,2,PERF
42127337460000,PI,IP,001,20,8010,8012,7408,2,PERF
42127337460000,PI,IP,001,21,8115,8117,7408,2,PERF
42127337460000,PI,IP,001,22,8156,8158,7408,2,PERF
42127337460000,PI,IP,001,23,8197,8199,7408,2,PERF
42127337460000,PI,IP,001,24,8238,8240,7408,2,PERF
42127337460000,PI,IP,001,25,8279,8281,7408,2,PERF
42127337460000,PI,IP,001,26,8384,8386,7408,2,PERF
42127337460000,PI,IP,001,27,8425,8427,7408,2,PERF
42127337460000,PI,IP,001,28,8466,8468,7408,2,PERF
42127337460000,PI,IP,001,29,8507,8509,7408,2,PERF
42127337460000,PI,IP,001,30,8548,8550,7408,2,PERF
42127337460000,PI,IP,001,31,8653,8655,7408,2,PERF
42127337460000,PI,IP,001,32,8694,8696,7408,2,PERF
42127337460000,PI,IP,001,33,8735,8737,7408,2,PERF
42127337460000,PI,IP,001,34,8776,8778,7408,2,PERF
42127337460000,PI,IP,001,35,8817,8819,7408,2,PERF
42127337460000,PI,IP,001,36,8922,8924,7408,2,PERF
42127337460000,PI,IP,001,37,8963,8965,7408,2,PERF
42127337460000,PI,IP,001,38,9004,9006,7408,2,PERF
42127337460000,PI,IP,001,39,9045,9047,7408,2,PERF
42127337460000,PI,IP,001,40,9086,9088,7408,2,PERF
42127337460000,PI,IP,001,41,9191,9193,7408,2,PERF
42127337460000,PI,IP,001,42,9232,9234,7408,2,PERF
42127337460000,PI,IP,001,43,9273,9275,7408,2,PERF
42127337460000,PI,IP,001,44,9314,9316,7408,2,PERF
42127337460000,PI,IP,001,45,9355,9357,7408,2,PERF
42127337460000,PI,IP,001,46,9460,9462,7408,2,PERF
42127337460000,PI,IP,001,47,9501,9503,7408,2,PERF
42127337460000,PI,IP,001,48,9542,9544,7408,2,PERF
42127337460000,PI,IP,001,49,9583,9585,7408,2,PERF
42127337460000,PI,IP,001,50,9624,9626,7408,2,PERF
42127337460000,PI,IP,001,51,9729,9731,7408,2,PERF
42127337460000,PI,IP,001,52,9770,9772,7408,2,PERF
42127337460000,PI,IP,001,53,9811,9813,7408,2,PERF
42127337460000,PI,IP,001,54,9852,9854,7408,2,PERF
42127337460000,PI,IP,001,55,9893,9895,7408,2,PERF
42127337460000,PI,IP,001,56,9998,10000,7408,2,PERF
42127337460000,PI,IP,001,57,10039,10041,7408,2,PERF
42127337460000,PI,IP,001,58,10080,10082,7408,2,PERF
42127337460000,PI,IP,001,59,10121,10123,7408,2,PERF
42127337460000,PI,IP,001,60,10162,10164,7408,2,PERF
42127337460000,PI,IP,001,61,10267,10269,7408,2,PERF
42127337460000,PI,IP,001,62,10308,10310,7408,2,PERF
42127337460000,PI,IP,001,63,10349,10351,7408,2,PERF
42127337460000,PI,IP,001,64,10390,10392,7408,2,PERF
42127337460000,PI,IP,001,65,10431,10433,7408,2,PERF
42127337460000,PI,IP,001,66,10536,10538,7408,2,PERF
42127337460000,PI,IP,001,67,10577,10579,7408,2,PERF
42127337460000,PI,IP,001,68,10618,10620,7408,2,PERF
42127337460000,PI,IP,001,69,10659,10661,7408,2,PERF
42127337460000,PI,IP,001,70,10700,10702,7408,2,PERF
42127337460000,PI,IP,001,71,10805,10807,7408,2,PERF
42127337460000,PI,IP,001,72,10846,10848,7408,2,PERF
42127337460000,PI,IP,001,73,10887,10889,7408,2,PERF
42127337460000,PI,IP,001,74,10928,10930,7408,2,PERF
42127337460000,PI,IP,001,75,10969,10971,7408,2,PERF
42127337460000,PI,IP,001,76,11074,11076,7408,2,PERF
42127337460000,PI,IP,001,77,11115,11117,7408,2,PERF
42127337460000,PI,IP,001,78,11156,11158,7408,2,PERF
42127337460000,PI,IP,001,79,11197,11199,7408,2,PERF
42127337460000,PI,IP,001,80,11238,11240,7408,2,PERF
42127337460000,PI,IP,001,81,11343,11345,7408,2,PERF
42127337460000,PI,IP,001,82,11384,11386,7408,2,PERF
42127337460000,PI,IP,001,83,11425,11427,7408,2,PERF
42127337460000,PI,IP,001,84,11466,11468,7408,2,PERF
42127337460000,PI,IP,001,85,11507,11509,7408,2,PERF
42127337460000,PI,IP,001,86,11612,11614,7408,2,PERF
42127337460000,PI,IP,001,87,11653,11655,7408,2,PERF
42127337460000,PI,IP,001,88,11694,11696,7408,2,PERF
42127337460000,PI,IP,001,89,11735,11737,7408,2,PERF
42127337460000,PI,IP,001,90,11776,11778,7408,2,PERF
42127337460000,PI,IP,001,91,11881,11883,7408,2,PERF
42127337460000,PI,IP,001,92,11922,11924,7408,2,PERF
42127337460000,PI,IP,001,93,11963,11965,7408,2,PERF
42127337460000,PI,IP,001,94,12004,12006,7408,2,PERF
42127337460000,PI,IP,001,95,12045,12047,7408,2,PERF
42127337460000,PI,IP,001,96,12150,12152,7408,2,PERF
42127337460000,PI,IP,001,97,12191,12193,7408,2,PERF
42127337460000,PI,IP,001,98,12232,12234,7408,2,PERF
42127337460000,PI,IP,001,99,12273,12275,7408,2,PERF
42127337460000,PI,IP,001,100,12314,12316,7408,2,PERF
42127337460000,PI,IP,001,101,12419,12421,7408,2,PERF
42127337460000,PI,IP,001,102,12460,12462,7408,2,PERF
42127337460000,PI,IP,001,103,12501,12503,7408,2,PERF
42127337460000,PI,IP,001,104,12542,12544,7408,2,PERF
42127337460000,PI,IP,001,105,12583,12585,7408,2,PERF
42127337460000,PI,IP,001,106,12688,12690,7408,2,PERF
42127337460000,PI,IP,001,107,12729,12731,7408,2,PERF
42127337460000,PI,IP,001,108,12770,12772,7408,2,PERF
42127337460000,PI,IP,001,109,12811,12813,7408,2,PERF
42127337460000,PI,IP,001,110,12852,12854,7408,2,PERF
42127337460000,PI,IP,001,111,12957,12959,7408,2,PERF
42127337460000,PI,IP,001,112,12998,13000,7408,2,PERF
42127337460000,PI,IP,001,113,13039,13041,7408,2,PERF
42127337460000,PI,IP,001,114,13080,13082,7408,2,PERF
42127337460000,PI,IP,001,115,13121,13123,7408,2,PERF
42127337460000,PI,IP,001,116,13226,13228,7408,2,PERF
42127337460000,PI,IP,001,117,13267,13269,7408,2,PERF
42127337460000,PI,IP,001,118,13308,13310,7408,2,PERF
42127337460000,PI,IP,001,119,13349,13351,7408,2,PERF
42127337460000,PI,IP,001,120,13390,13392,7408,2,PERF
42127337460000,PI,IP,001,121,13495,13497,7408,2,PERF
42127337460000,PI,IP,001,122,13536,13538,7408,2,PERF
42127337460000,PI,IP,001,123,13577,13579,7408,2,PERF
42127337460000,PI,IP,001,124,13618,13620,7408,2,PERF
42127337460000,PI,IP,001,125,13659,13661,7408,2,PERF
42127337460000,PI,IP,001,126,13800,13801,7408,1,PERF
42127337460000,PI,IP,001,127,13834,13835,7408,1,PERF
42127337460000,PI,IP,001,128,13869,13870,7408,1,PERF
42127337460000,PI,IP,001,129,13904,13905,7408,1,PERF
42127337460000,PI,IP,001,130,13939,13940,7408,1,PERF
42127337480000,PI,IP,001,1,6771,11782,5740,5011,PERF
42127337490000,PI,IP,001,1,8047,12503,6818,4456,PERF
42127337500000,PI,IP,001,1,7665,12687,6080,5022,PERF
42127337520100,PI,IP,001,1,9067,13570,5816,4503,PERF
42127337530000,PI,IP,001,1,8486,13353,6281,4867,PERF
42127337550000,PI,IP,001,1,8920,13653,5991,4733,PERF
42127337560000,PI,IP,001,1,8540,13408,5902,4868,PERF
42127337570000,PI,IP,001,1,9090,13418,6031,4328,PERF
42127337580000,PI,IP,001,1,5800,6023,5929,223,PERF
42127337580000,PI,IP,001,2,6120,6336,5929,216,PERF
42127337580000,PI,IP,001,3,6426,6646,5929,220,PERF
42127337580000,PI,IP,001,4,6739,6962,5929,223,PERF
42127337580000,PI,IP,001,5,7052,7275,5929,223,PERF
42127337580000,PI,IP,001,6,7365,7583,5929,218,PERF
42127337580000,PI,IP,001,7,7678,7901,5929,223,PERF
42127337580000,PI,IP,001,8,7991,8213,5929,222,PERF
42127337580000,PI,IP,001,9,8304,8527,5929,223,PERF
42127337580000,PI,IP,001,10,8617,8840,5929,223,PERF
42127337580000,PI,IP,001,11,8930,9153,5929,223,PERF
42127337580000,PI,IP,001,12,9243,9463,5929,220,PERF
42127337580000,PI,IP,001,13,9556,9779,5929,223,PERF
42127337580000,PI,IP,001,14,9869,10092,5929,223,PERF
42127337580000,PI,IP,001,15,10182,10405,5929,223,PERF
42127337580000,PI,IP,001,16,10495,10718,5929,223,PERF
42127337590000,PI,IP,001,1,8150,12883,6012,4733,PERF
42127337600000,PI,IP,001,1,8448,12995,5394,4547,PERF
42127337610000,PI,IP,001,1,8510,13063,5515,4553,PERF
42127337620000,PI,IP,001,1,8085,13309,6147,5224,PERF
42127337630000,PI,IP,001,1,8632,13040,5880,4408,PERF
42127337640000,PI,IP,001,1,6740,7847,6495,1107,PERF
42127337640000,PI,IP,001,2,7960,9067,6495,1107,PERF
42127337640000,PI,IP,001,3,9180,9982,6495,802,PERF
42127337640000,PI,IP,001,4,10095,10897,6495,802,PERF
42127337640000,PI,IP,001,5,11010,11812,6495,802,PERF
42127337640000,PI,IP,001,6,11925,12727,6495,802,PERF
42127337650000,PI,IP,001,1,7234,7235,8130,1,PERF
42127337650000,PI,IP,001,2,7277,7278,8130,1,PERF
42127337650000,PI,IP,001,3,7320,7321,8130,1,PERF
42127337650000,PI,IP,001,4,7363,7364,8130,1,PERF
42127337650000,PI,IP,001,5,7406,7407,8130,1,PERF
42127337650000,PI,IP,001,6,7449,7450,8130,1,PERF
42127337650000,PI,IP,001,7,7492,7493,8130,1,PERF
42127337650000,PI,IP,001,8,7535,7536,8130,1,PERF
42127337650000,PI,IP,001,9,7578,7579,8130,1,PERF
42127337650000,PI,IP,001,10,7621,7622,8130,1,PERF
42127337650000,PI,IP,001,11,7721,7722,8130,1,PERF
42127337650000,PI,IP,001,12,7764,7765,8130,1,PERF
42127337650000,PI,IP,001,13,7807,7808,8130,1,PERF
42127337650000,PI,IP,001,14,7850,7851,8130,1,PERF
42127337650000,PI,IP,001,15,7893,7894,8130,1,PERF
42127337650000,PI,IP,001,16,7936,7937,8130,1,PERF
42127337650000,PI,IP,001,17,7979,7980,8130,1,PERF
42127337650000,PI,IP,001,18,8022,8023,8130,1,PERF
42127337650000,PI,IP,001,19,8065,8066,8130,1,PERF
42127337650000,PI,IP,001,20,8108,8109,8130,1,PERF
42127337650000,PI,IP,001,21,8208,8209,8130,1,PERF
42127337650000,PI,IP,001,22,8251,8252,8130,1,PERF
42127337650000,PI,IP,001,23,8294,8295,8130,1,PERF
42127337650000,PI,IP,001,24,8337,8338,8130,1,PERF
42127337650000,PI,IP,001,25,8380,8381,8130,1,PERF
42127337650000,PI,IP,001,26,8423,8424,8130,1,PERF
42127337650000,PI,IP,001,27,8466,8467,8130,1,PERF
42127337650000,PI,IP,001,28,8509,8510,8130,1,PERF
42127337650000,PI,IP,001,29,8552,8553,8130,1,PERF
42127337650000,PI,IP,001,30,8595,8596,8130,1,PERF
42127337650000,PI,IP,001,31,8695,8696,8130,1,PERF
42127337650000,PI,IP,001,32,8738,8739,8130,1,PERF
42127337650000,PI,IP,001,33,8781,8782,8130,1,PERF
42127337650000,PI,IP,001,34,8824,8825,8130,1,PERF
42127337650000,PI,IP,001,35,8867,8868,8130,1,PERF
42127337650000,PI,IP,001,36,8910,8911,8130,1,PERF
42127337650000,PI,IP,001,37,8953,8954,8130,1,PERF
42127337650000,PI,IP,001,38,8996,8997,8130,1,PERF
42127337650000,PI,IP,001,39,9039,9040,8130,1,PERF
42127337650000,PI,IP,001,40,9082,9083,8130,1,PERF
42127337650000,PI,IP,001,41,9182,9183,8130,1,PERF
42127337650000,PI,IP,001,42,9225,9226,8130,1,PERF
42127337650000,PI,IP,001,43,9268,9269,8130,1,PERF
42127337650000,PI,IP,001,44,9311,9312,8130,1,PERF
42127337650000,PI,IP,001,45,9354,9355,8130,1,PERF
42127337650000,PI,IP,001,46,9397,9398,8130,1,PERF
42127337650000,PI,IP,001,47,9440,9441,8130,1,PERF
42127337650000,PI,IP,001,48,9483,9484,8130,1,PERF
42127337650000,PI,IP,001,49,9526,9527,8130,1,PERF
42127337650000,PI,IP,001,50,9569,9570,8130,1,PERF
42127337650000,PI,IP,001,51,9669,9670,8130,1,PERF
42127337650000,PI,IP,001,52,9712,9713,8130,1,PERF
42127337650000,PI,IP,001,53,9755,9756,8130,1,PERF
42127337650000,PI,IP,001,54,9798,9799,8130,1,PERF
42127337650000,PI,IP,001,55,9841,9842,8130,1,PERF
42127337650000,PI,IP,001,56,9884,9885,8130,1,PERF
42127337650000,PI,IP,001,57,9927,9928,8130,1,PERF
42127337650000,PI,IP,001,58,9970,9971,8130,1,PERF
42127337650000,PI,IP,001,59,10013,10014,8130,1,PERF
42127337650000,PI,IP,001,60,10056,10057,8130,1,PERF
42127337650000,PI,IP,001,61,10156,10157,8130,1,PERF
42127337650000,PI,IP,001,62,10199,10200,8130,1,PERF
42127337650000,PI,IP,001,63,10242,10243,8130,1,PERF
42127337650000,PI,IP,001,64,10285,10286,8130,1,PERF
42127337650000,PI,IP,001,65,10328,10329,8130,1,PERF
42127337650000,PI,IP,001,66,10371,10372,8130,1,PERF
42127337650000,PI,IP,001,67,10414,10415,8130,1,PERF
42127337650000,PI,IP,001,68,10457,10458,8130,1,PERF
42127337650000,PI,IP,001,69,10500,10501,8130,1,PERF
42127337650000,PI,IP,001,70,10543,10544,8130,1,PERF
42127337650000,PI,IP,001,71,10643,10644,8130,1,PERF
42127337650000,PI,IP,001,72,10686,10687,8130,1,PERF
42127337650000,PI,IP,001,73,10729,10730,8130,1,PERF
42127337650000,PI,IP,001,74,10772,10773,8130,1,PERF
42127337650000,PI,IP,001,75,10815,10816,8130,1,PERF
42127337650000,PI,IP,001,76,10858,10859,8130,1,PERF
42127337650000,PI,IP,001,77,10901,10902,8130,1,PERF
42127337650000,PI,IP,001,78,10944,10945,8130,1,PERF
42127337650000,PI,IP,001,79,10987,10988,8130,1,PERF
42127337650000,PI,IP,001,80,11030,11031,8130,1,PERF
42127337650000,PI,IP,001,81,11130,11131,8130,1,PERF
42127337650000,PI,IP,001,82,11173,11174,8130,1,PERF
42127337650000,PI,IP,001,83,11216,11217,8130,1,PERF
42127337650000,PI,IP,001,84,11259,11260,8130,1,PERF
42127337650000,PI,IP,001,85,11302,11303,8130,1,PERF
42127337650000,PI,IP,001,86,11345,11346,8130,1,PERF
42127337650000,PI,IP,001,87,11388,11389,8130,1,PERF
42127337650000,PI,IP,001,88,11431,11432,8130,1,PERF
42127337650000,PI,IP,001,89,11474,11475,8130,1,PERF
42127337650000,PI,IP,001,90,11517,11518,8130,1,PERF
42127337650000,PI,IP,001,91,11617,11618,8130,1,PERF
42127337650000,PI,IP,001,92,11660,11661,8130,1,PERF
42127337650000,PI,IP,001,93,11703,11704,8130,1,PERF
42127337650000,PI,IP,001,94,11746,11747,8130,1,PERF
42127337650000,PI,IP,001,95,11789,11790,8130,1,PERF
42127337650000,PI,IP,001,96,11832,11833,8130,1,PERF
42127337650000,PI,IP,001,97,11875,11876,8130,1,PERF
42127337650000,PI,IP,001,98,11918,11919,8130,1,PERF
42127337650000,PI,IP,001,99,11961,11962,8130,1,PERF
42127337650000,PI,IP,001,100,12004,12005,8130,1,PERF
42127337650000,PI,IP,001,101,12104,12105,8130,1,PERF
42127337650000,PI,IP,001,102,12147,12148,8130,1,PERF
42127337650000,PI,IP,001,103,12190,12191,8130,1,PERF
42127337650000,PI,IP,001,104,12233,12234,8130,1,PERF
42127337650000,PI,IP,001,105,12276,12277,8130,1,PERF
42127337650000,PI,IP,001,106,12319,12320,8130,1,PERF
42127337650000,PI,IP,001,107,12362,12363,8130,1,PERF
42127337650000,PI,IP,001,108,12405,12406,8130,1,PERF
42127337650000,PI,IP,001,109,12448,12449,8130,1,PERF
42127337650000,PI,IP,001,110,12491,12492,8130,1,PERF
42127337650000,PI,IP,001,111,12591,12592,8130,1,PERF
42127337650000,PI,IP,001,112,12634,12635,8130,1,PERF
42127337650000,PI,IP,001,113,12677,12678,8130,1,PERF
42127337650000,PI,IP,001,114,12720,12721,8130,1,PERF
42127337650000,PI,IP,001,115,12763,12764,8130,1,PERF
42127337650000,PI,IP,001,116,12806,12807,8130,1,PERF
42127337650000,PI,IP,001,117,12849,12850,8130,1,PERF
42127337650000,PI,IP,001,118,12892,12893,8130,1,PERF
42127337650000,PI,IP,001,119,12935,12936,8130,1,PERF
42127337650000,PI,IP,001,120,12978,12979,8130,1,PERF
42127337650000,PI,IP,001,121,13078,13079,8130,1,PERF
42127337650000,PI,IP,001,122,13121,13122,8130,1,PERF
42127337650000,PI,IP,001,123,13164,13165,8130,1,PERF
42127337650000,PI,IP,001,124,13207,13208,8130,1,PERF
42127337650000,PI,IP,001,125,13250,13251,8130,1,PERF
42127337650000,PI,IP,001,126,13293,13294,8130,1,PERF
42127337650000,PI,IP,001,127,13336,13337,8130,1,PERF
42127337650000,PI,IP,001,128,13379,13380,8130,1,PERF
42127337650000,PI,IP,001,129,13422,13423,8130,1,PERF
42127337650000,PI,IP,001,130,13465,13466,8130,1,PERF
42127337650000,PI,IP,001,131,13565,13566,8130,1,PERF
42127337650000,PI,IP,001,132,13608,13609,8130,1,PERF
42127337650000,PI,IP,001,133,13651,13652,8130,1,PERF
42127337650000,PI,IP,001,134,13694,13695,8130,1,PERF
42127337650000,PI,IP,001,135,13737,13738,8130,1,PERF
42127337650000,PI,IP,001,136,13780,13781,8130,1,PERF
42127337650000,PI,IP,001,137,13823,13824,8130,1,PERF
42127337650000,PI,IP,001,138,13866,13867,8130,1,PERF
42127337650000,PI,IP,001,139,13909,13910,8130,1,PERF
42127337650000,PI,IP,001,140,13952,13953,8130,1,PERF
42127337650000,PI,IP,001,141,14052,14053,8130,1,PERF
42127337650000,PI,IP,001,142,14095,14096,8130,1,PERF
42127337650000,PI,IP,001,143,14138,14139,8130,1,PERF
42127337650000,PI,IP,001,144,14181,14182,8130,1,PERF
42127337650000,PI,IP,001,145,14224,14225,8130,1,PERF
42127337650000,PI,IP,001,146,14267,14268,8130,1,PERF
42127337650000,PI,IP,001,147,14310,14311,8130,1,PERF
42127337650000,PI,IP,001,148,14353,14354,8130,1,PERF
42127337650000,PI,IP,001,149,14396,14397,8130,1,PERF
42127337650000,PI,IP,001,150,14439,14440,8130,1,PERF
42127337660100,PI,IP,001,1,9024,13550,6254,4526,PERF
42127337670000,PI,IP,001,1,6097,6303,6264,206,PERF
42127337670000,PI,IP,001,2,6397,6603,6264,206,PERF
42127337670000,PI,IP,001,3,6697,6903,6264,206,PERF
42127337670000,PI,IP,001,4,6997,7207,6264,210,PERF
42127337670000,PI,IP,001,5,8217,8398,6264,181,PERF
42127337670000,PI,IP,001,6,8487,8663,6264,176,PERF
42127337670000,PI,IP,001,7,8762,8933,6264,171,PERF
42127337670000,PI,IP,001,8,9027,9203,6264,176,PERF
42127337670000,PI,IP,001,9,9302,9473,6264,171,PERF
42127337670000,PI,IP,001,10,9567,9743,6264,176,PERF
42127337670000,PI,IP,001,11,9837,10018,6264,181,PERF
42127337670000,PI,IP,001,12,10107,10283,6264,176,PERF
42127337670000,PI,IP,001,13,10377,10553,6264,176,PERF
42127337670000,PI,IP,001,14,10647,10823,6264,176,PERF
42127337670000,PI,IP,001,15,10917,11093,6264,176,PERF
42127337670000,PI,IP,001,16,11187,11363,6264,176,PERF
42127337680000,PI,IP,001,1,8710,13088,5687,4378,PERF
42127337690000,PI,IP,001,1,8610,13329,6128,4719,PERF
42127337700000,PI,IP,001,1,8087,13238,6023,5151,PERF
42127337710000,PI,IP,001,1,8449,13168,6088,4719,PERF
42127337720000,PI,IP,001,1,8610,12848,5676,4238,PERF
42127337730000,PI,IP,001,1,8220,12683,5555,4463,PERF
42127337760000,PI,IP,001,1,7207,7208,,1,PERF
42127337760000,PI,IP,001,2,7257,7258,,1,PERF
42127337760000,PI,IP,001,3,7307,7308,,1,PERF
42127337760000,PI,IP,001,4,7357,7358,,1,PERF
42127337760000,PI,IP,001,5,7407,7408,,1,PERF
42127337760000,PI,IP,001,6,7457,7458,,1,PERF
42127337760000,PI,IP,001,7,7507,7508,,1,PERF
42127337760000,PI,IP,001,8,7557,7558,,1,PERF
42127337760000,PI,IP,001,9,7696,7697,,1,PERF
42127337760000,PI,IP,001,10,7746,7747,,1,PERF
42127337760000,PI,IP,001,11,7796,7797,,1,PERF
42127337760000,PI,IP,001,12,7846,7847,,1,PERF
42127337760000,PI,IP,001,13,7896,7897,,1,PERF
42127337760000,PI,IP,001,14,7946,7947,,1,PERF
42127337760000,PI,IP,001,15,7996,7997,,1,PERF
42127337760000,PI,IP,001,16,8046,8047,,1,PERF
42127337760000,PI,IP,001,17,8185,8186,,1,PERF
42127337760000,PI,IP,001,18,8235,8236,,1,PERF
42127337760000,PI,IP,001,19,8285,8286,,1,PERF
42127337760000,PI,IP,001,20,8335,8336,,1,PERF
42127337760000,PI,IP,001,21,8385,8386,,1,PERF
42127337760000,PI,IP,001,22,8435,8436,,1,PERF
42127337760000,PI,IP,001,23,8485,8486,,1,PERF
42127337760000,PI,IP,001,24,8535,8536,,1,PERF
42127337760000,PI,IP,001,25,8674,8675,,1,PERF
42127337760000,PI,IP,001,26,8724,8725,,1,PERF
42127337760000,PI,IP,001,27,8774,8775,,1,PERF
42127337760000,PI,IP,001,28,8824,8825,,1,PERF
42127337760000,PI,IP,001,29,8874,8875,,1,PERF
42127337760000,PI,IP,001,30,8924,8925,,1,PERF
42127337760000,PI,IP,001,31,8974,8975,,1,PERF
42127337760000,PI,IP,001,32,9024,9025,,1,PERF
42127337760000,PI,IP,001,33,9163,9164,,1,PERF
42127337760000,PI,IP,001,34,9213,9214,,1,PERF
42127337760000,PI,IP,001,35,9263,9264,,1,PERF
42127337760000,PI,IP,001,36,9313,9314,,1,PERF
42127337760000,PI,IP,001,37,9363,9364,,1,PERF
42127337760000,PI,IP,001,38,9413,9414,,1,PERF
42127337760000,PI,IP,001,39,9463,9464,,1,PERF
42127337760000,PI,IP,001,40,9513,9514,,1,PERF
42127337760000,PI,IP,001,41,9652,9653,,1,PERF
42127337760000,PI,IP,001,42,9702,9703,,1,PERF
42127337760000,PI,IP,001,43,9752,9753,,1,PERF
42127337760000,PI,IP,001,44,9802,9803,,1,PERF
42127337760000,PI,IP,001,45,9852,9853,,1,PERF
42127337760000,PI,IP,001,46,9902,9903,,1,PERF
42127337760000,PI,IP,001,47,9952,9953,,1,PERF
42127337760000,PI,IP,001,48,10002,10003,,1,PERF
42127337760000,PI,IP,001,49,10141,10142,,1,PERF
42127337760000,PI,IP,001,50,10191,10192,,1,PERF
42127337760000,PI,IP,001,51,10241,10242,,1,PERF
42127337760000,PI,IP,001,52,10291,10292,,1,PERF
42127337760000,PI,IP,001,53,10341,10342,,1,PERF
42127337760000,PI,IP,001,54,10391,10392,,1,PERF
42127337760000,PI,IP,001,55,10441,10442,,1,PERF
42127337760000,PI,IP,001,56,10491,10492,,1,PERF
42127337760000,PI,IP,001,57,10630,10631,,1,PERF
42127337760000,PI,IP,001,58,10680,10681,,1,PERF
42127337760000,PI,IP,001,59,10730,10731,,1,PERF
42127337760000,PI,IP,001,60,10780,10781,,1,PERF
42127337760000,PI,IP,001,61,10830,10831,,1,PERF
42127337760000,PI,IP,001,62,10880,10881,,1,PERF
42127337760000,PI,IP,001,63,10930,10931,,1,PERF
42127337760000,PI,IP,001,64,10980,10981,,1,PERF
42127337760000,PI,IP,001,65,11119,11120,,1,PERF
42127337760000,PI,IP,001,66,11169,11170,,1,PERF
42127337760000,PI,IP,001,67,11219,11220,,1,PERF
42127337760000,PI,IP,001,68,11269,11270,,1,PERF
42127337760000,PI,IP,001,69,11319,11320,,1,PERF
42127337760000,PI,IP,001,70,11369,11370,,1,PERF
42127337760000,PI,IP,001,71,11419,11420,,1,PERF
42127337760000,PI,IP,001,72,11469,11470,,1,PERF
42127337760000,PI,IP,001,73,11608,11609,,1,PERF
42127337760000,PI,IP,001,74,11658,11659,,1,PERF
42127337760000,PI,IP,001,75,11708,11709,,1,PERF
42127337760000,PI,IP,001,76,11758,11759,,1,PERF
42127337760000,PI,IP,001,77,11808,11809,,1,PERF
42127337760000,PI,IP,001,78,11858,11859,,1,PERF
42127337760000,PI,IP,001,79,11908,11909,,1,PERF
42127337760000,PI,IP,001,80,11958,11959,,1,PERF
42127337760000,PI,IP,001,81,12097,12098,,1,PERF
42127337760000,PI,IP,001,82,12147,12148,,1,PERF
42127337760000,PI,IP,001,83,12197,12198,,1,PERF
42127337760000,PI,IP,001,84,12247,12248,,1,PERF
42127337760000,PI,IP,001,85,12297,12298,,1,PERF
42127337760000,PI,IP,001,86,12347,12348,,1,PERF
42127337760000,PI,IP,001,87,12397,12398,,1,PERF
42127337760000,PI,IP,001,88,12447,12448,,1,PERF
42127337760000,PI,IP,001,89,12586,12587,,1,PERF
42127337760000,PI,IP,001,90,12636,12637,,1,PERF
42127337760000,PI,IP,001,91,12686,12687,,1,PERF
42127337760000,PI,IP,001,92,12736,12737,,1,PERF
42127337760000,PI,IP,001,93,12786,12787,,1,PERF
42127337760000,PI,IP,001,94,12836,12837,,1,PERF
42127337760000,PI,IP,001,95,12886,12887,,1,PERF
42127337760000,PI,IP,001,96,12936,12937,,1,PERF
42127337760000,PI,IP,001,97,13075,13076,,1,PERF
42127337760000,PI,IP,001,98,13125,13126,,1,PERF
42127337760000,PI,IP,001,99,13174,13175,,1,PERF
42127337760000,PI,IP,001,100,13224,13225,,1,PERF
42127337760000,PI,IP,001,101,13274,13275,,1,PERF
42127337760000,PI,IP,001,102,13324,13325,,1,PERF
42127337760000,PI,IP,001,103,13374,13375,,1,PERF
42127337760000,PI,IP,001,104,13424,13425,,1,PERF
42127337770000,PI,IP,001,1,8548,13459,6262,4911,PERF
42127337780000,PI,IP,001,1,8276,13158,6221,4882,PERF
42127337790000,PI,IP,001,1,8500,13298,6293,4798,PERF
42127337800000,PI,IP,001,1,8929,13542,6230,4613,PERF
42127337810000,PI,IP,001,1,8324,13691,6177,5367,PERF
42127337820000,PI,IP,001,1,9005,13854,6253,4849,PERF
42127337830000,PI,IP,001,1,8831,13502,6350,4671,PERF
42127337840000,PI,IP,001,1,8856,13479,6267,4623,PERF
42127337850000,PI,IP,001,1,8908,13341,6223,4433,PERF
42127337860000,PI,IP,001,1,8484,13433,6269,4949,PERF
42127337870000,PI,IP,001,1,8047,14426,6880,6379,PERF
42127337890000,PI,IP,001,1,7576,11810,4941,4234,PERF
42127337900000,PI,IP,001,1,8856,13532,6017,4676,PERF
42127337910000,PI,IP,001,1,8370,13625,6207,5255,PERF
42127337920000,PI,IP,001,1,8809,13682,6325,4873,PERF
42127337950000,PI,IP,001,1,6797,13495,7466,6698,PERF
42127337960000,PI,IP,001,1,6981,7332,7226,351,PERF
42127337960000,PI,IP,001,2,7429,7780,7226,351,PERF
42127337960000,PI,IP,001,3,7877,8228,7226,351,PERF
42127337960000,PI,IP,001,4,8325,8676,7226,351,PERF
42127337960000,PI,IP,001,5,8773,9124,7226,351,PERF
42127337960000,PI,IP,001,6,9221,9572,7226,351,PERF
42127337960000,PI,IP,001,7,9669,10020,7226,351,PERF
42127337960000,PI,IP,001,8,10117,10468,7226,351,PERF
42127337960000,PI,IP,001,9,10565,10916,7226,351,PERF
42127337960000,PI,IP,001,10,11013,11364,7226,351,PERF
42127337960000,PI,IP,001,11,11461,11812,7226,351,PERF
42127337960000,PI,IP,001,12,11909,12260,7226,351,PERF
42127337960000,PI,IP,001,13,12357,12708,7226,351,PERF
42127337960000,PI,IP,001,14,12805,13156,7226,351,PERF
42127337960000,PI,IP,001,15,13253,13604,7226,351,PERF
42127337960000,PI,IP,001,16,13680,13833,7226,153,PERF
42127337970000,PI,IP,001,1,9561,14256,7325,4695,PERF
42127337980000,PI,IP,001,1,7994,14317,,6323,PERF
42127337990000,PI,IP,001,1,7987,14267,,6280,PERF
42127338000000,PI,IP,001,1,14228,14229,7074,1,PERF
42127338000000,PI,IP,001,2,14266,14267,7074,1,PERF
42127338000000,PI,IP,001,3,14304,14305,7074,1,PERF
42127338000000,PI,IP,001,4,14341,14342,7074,1,PERF
42127338000000,PI,IP,001,5,14379,14380,7074,1,PERF
42127338010000,PI,IP,001,1,7996,13008,6009,5012,PERF
42127338030000,PI,IP,001,1,5841,12650,7279,6809,PERF
42127338040000,PI,IP,002,1,8603,13180,5882,4577,PERF
42127338040000,PI,PT,001,1,8603,13180,5882,4577,PERF
42127338050000,PI,IP,001,1,8092,13003,5815,4911,PERF
42127338060000,PI,IP,001,1,8616,13143,5839,4527,PERF
42127338080000,PI,IP,001,1,6731,6733,,2,PERF
42127338080000,PI,IP,001,2,6781,6783,,2,PERF
42127338080000,PI,IP,001,3,6831,6833,,2,PERF
42127338080000,PI,IP,001,4,6931,6933,,2,PERF
42127338080000,PI,IP,001,5,6981,6983,,2,PERF
42127338080000,PI,IP,001,6,7031,7033,,2,PERF
42127338080000,PI,IP,001,7,7081,7083,,2,PERF
42127338080000,PI,IP,001,8,7226,7228,,2,PERF
42127338080000,PI,IP,001,9,7276,7278,,2,PERF
42127338080000,PI,IP,001,10,7326,7328,,2,PERF
42127338080000,PI,IP,001,11,7376,7378,,2,PERF
42127338080000,PI,IP,001,12,7426,7428,,2,PERF
42127338080000,PI,IP,001,13,7476,7478,,2,PERF
42127338080000,PI,IP,001,14,7526,7528,,2,PERF
42127338080000,PI,IP,001,15,7576,7578,,2,PERF
42127338080000,PI,IP,001,16,7721,7723,,2,PERF
42127338080000,PI,IP,001,17,7771,7773,,2,PERF
42127338080000,PI,IP,001,18,7821,7823,,2,PERF
42127338080000,PI,IP,001,19,7871,7873,,2,PERF
42127338080000,PI,IP,001,20,7921,7923,,2,PERF
42127338080000,PI,IP,001,21,7971,7973,,2,PERF
42127338080000,PI,IP,001,22,8021,8023,,2,PERF
42127338080000,PI,IP,001,23,8071,8073,,2,PERF
42127338080000,PI,IP,001,24,8216,8218,,2,PERF
42127338080000,PI,IP,001,25,8266,8268,,2,PERF
42127338080000,PI,IP,001,26,8316,8318,,2,PERF
42127338080000,PI,IP,001,27,8366,8368,,2,PERF
42127338080000,PI,IP,001,28,8416,8418,,2,PERF
42127338080000,PI,IP,001,29,8466,8468,,2,PERF
42127338080000,PI,IP,001,30,8516,8518,,2,PERF
42127338080000,PI,IP,001,31,8566,8568,,2,PERF
42127338080000,PI,IP,001,32,8711,8713,,2,PERF
42127338080000,PI,IP,001,33,8761,8763,,2,PERF
42127338080000,PI,IP,001,34,8811,8813,,2,PERF
42127338080000,PI,IP,001,35,8861,8863,,2,PERF
42127338080000,PI,IP,001,36,8911,8913,,2,PERF
42127338080000,PI,IP,001,37,8961,8963,,2,PERF
42127338080000,PI,IP,001,38,9011,9013,,2,PERF
42127338080000,PI,IP,001,39,9061,9063,,2,PERF
42127338080000,PI,IP,001,40,9206,9208,,2,PERF
42127338080000,PI,IP,001,41,9256,9258,,2,PERF
42127338080000,PI,IP,001,42,9306,9308,,2,PERF
42127338080000,PI,IP,001,43,9356,9358,,2,PERF
42127338080000,PI,IP,001,44,9406,9408,,2,PERF
42127338080000,PI,IP,001,45,9456,9458,,2,PERF
42127338080000,PI,IP,001,46,9506,9508,,2,PERF
42127338080000,PI,IP,001,47,9556,9558,,2,PERF
42127338080000,PI,IP,001,48,9701,9703,,2,PERF
42127338080000,PI,IP,001,49,9751,9753,,2,PERF
42127338080000,PI,IP,001,50,9801,9803,,2,PERF
42127338080000,PI,IP,001,51,9851,9853,,2,PERF
42127338080000,PI,IP,001,52,9901,9903,,2,PERF
42127338080000,PI,IP,001,53,9951,9953,,2,PERF
42127338080000,PI,IP,001,54,10001,10003,,2,PERF
42127338080000,PI,IP,001,55,10051,10053,,2,PERF
42127338080000,PI,IP,001,56,10196,10198,,2,PERF
42127338080000,PI,IP,001,57,10246,10248,,2,PERF
42127338080000,PI,IP,001,58,10296,10298,,2,PERF
42127338080000,PI,IP,001,59,10346,10348,,2,PERF
42127338080000,PI,IP,001,60,10396,10398,,2,PERF
42127338080000,PI,IP,001,61,10446,10448,,2,PERF
42127338080000,PI,IP,001,62,10496,10498,,2,PERF
42127338080000,PI,IP,001,63,10546,10548,,2,PERF
42127338080000,PI,IP,001,64,10691,10693,,2,PERF
42127338080000,PI,IP,001,65,10741,10743,,2,PERF
42127338080000,PI,IP,001,66,10791,10793,,2,PERF
42127338080000,PI,IP,001,67,10841,10843,,2,PERF
42127338080000,PI,IP,001,68,10891,10893,,2,PERF
42127338080000,PI,IP,001,69,10941,10943,,2,PERF
42127338080000,PI,IP,001,70,10991,10993,,2,PERF
42127338080000,PI,IP,001,71,11041,11043,,2,PERF
42127338080000,PI,IP,001,72,11186,11188,,2,PERF
42127338080000,PI,IP,001,73,11236,11238,,2,PERF
42127338080000,PI,IP,001,74,11286,11288,,2,PERF
42127338080000,PI,IP,001,75,11336,11338,,2,PERF
42127338080000,PI,IP,001,76,11386,11388,,2,PERF
42127338080000,PI,IP,001,77,11436,11438,,2,PERF
42127338080000,PI,IP,001,78,11486,11488,,2,PERF
42127338080000,PI,IP,001,79,11536,11538,,2,PERF
42127338080000,PI,IP,001,80,11681,11683,,2,PERF
42127338080000,PI,IP,001,81,11731,11733,,2,PERF
42127338080000,PI,IP,001,82,11781,11783,,2,PERF
42127338080000,PI,IP,001,83,11831,11833,,2,PERF
42127338080000,PI,IP,001,84,11881,11883,,2,PERF
42127338080000,PI,IP,001,85,11931,11933,,2,PERF
42127338080000,PI,IP,001,86,11981,11983,,2,PERF
42127338080000,PI,IP,001,87,12031,12033,,2,PERF
42127338080000,PI,IP,001,88,12176,12178,,2,PERF
42127338080000,PI,IP,001,89,12226,12228,,2,PERF
42127338080000,PI,IP,001,90,12276,12278,,2,PERF
42127338080000,PI,IP,001,91,12326,12328,,2,PERF
42127338080000,PI,IP,001,92,12376,12378,,2,PERF
42127338080000,PI,IP,001,93,12426,12428,,2,PERF
42127338080000,PI,IP,001,94,12476,12478,,2,PERF
42127338080000,PI,IP,001,95,12526,12528,,2,PERF
42127338090000,PI,IP,001,1,6900,11923,6007,5023,PERF
42127338100000,PI,IP,001,1,7202,13313,6703,6111,PERF
42127338130000,PI,IP,001,1,8462,15798,7835,7336,PERF
42127338140000,PI,IP,001,1,8277,16102,8355,7825,PERF
42127338180000,PI,IP,001,1,7073,7424,6261,351,PERF
42127338180000,PI,IP,001,2,7575,7926,6261,351,PERF
42127338180000,PI,IP,001,3,8077,8428,6261,351,PERF
42127338180000,PI,IP,001,4,8579,8930,6261,351,PERF
42127338180000,PI,IP,001,5,9081,9432,6261,351,PERF
42127338180000,PI,IP,001,6,9583,9934,6261,351,PERF
42127338180000,PI,IP,001,7,10085,10436,6261,351,PERF
42127338180000,PI,IP,001,8,10587,10938,6261,351,PERF
42127338180000,PI,IP,001,9,11089,11440,6261,351,PERF
42127338180000,PI,IP,001,10,11591,11942,6261,351,PERF
42127338180000,PI,IP,001,11,12093,12444,6261,351,PERF
42127338180000,PI,IP,001,12,12595,12947,6261,352,PERF
42127338190000,PI,IP,001,1,8394,13293,6285,4899,PERF
42127338200000,PI,IP,001,1,8107,8346,,239,PERF
42127338200000,PI,IP,001,2,8422,8661,,239,PERF
42127338200000,PI,IP,001,3,8737,8976,,239,PERF
42127338200000,PI,IP,001,4,9052,9291,,239,PERF
42127338200000,PI,IP,001,5,9367,9605,,238,PERF
42127338200000,PI,IP,001,6,9681,9920,,239,PERF
42127338200000,PI,IP,001,7,9996,10235,,239,PERF
42127338200000,PI,IP,001,8,10311,10550,,239,PERF
42127338200000,PI,IP,001,9,10626,10865,,239,PERF
42127338200000,PI,IP,001,10,10941,11218,,277,PERF
42127338200000,PI,IP,001,11,11256,11533,,277,PERF
42127338200000,PI,IP,001,12,11571,11810,,239,PERF
42127338200000,PI,IP,001,13,11886,12125,,239,PERF
42127338200000,PI,IP,001,14,12201,12440,,239,PERF
42127338200000,PI,IP,001,15,12516,12755,,239,PERF
42127338200000,PI,IP,001,16,12831,13069,,238,PERF
42127338200000,PI,IP,001,17,13142,13422,,280,PERF
42127338200000,PI,IP,001,18,13460,13737,,277,PERF
42127338200000,PI,IP,001,19,13775,14052,,277,PERF
42127338200000,PI,IP,001,20,14090,14329,,239,PERF
42127338210000,PI,IP,001,1,8043,8238,5191,195,PERF
42127338210000,PI,IP,001,2,8314,8509,5191,195,PERF
42127338210000,PI,IP,001,3,8585,8780,5191,195,PERF
42127338210000,PI,IP,001,4,8856,9052,5191,196,PERF
42127338210000,PI,IP,001,5,9128,9323,5191,195,PERF
42127338210000,PI,IP,001,6,9400,9594,5191,194,PERF
42127338210000,PI,IP,001,7,9670,9865,5191,195,PERF
42127338210000,PI,IP,001,8,9941,10132,5191,191,PERF
42127338210000,PI,IP,001,9,10212,10407,5191,195,PERF
42127338210000,PI,IP,001,10,10483,10678,5191,195,PERF
42127338210000,PI,IP,001,11,10754,10949,5191,195,PERF
42127338210000,PI,IP,001,12,11025,11221,5191,196,PERF
42127338210000,PI,IP,001,13,11292,11492,5191,200,PERF
42127338210000,PI,IP,001,14,11568,11760,5191,192,PERF
42127338210000,PI,IP,001,15,11839,12034,5191,195,PERF
42127338210000,PI,IP,001,16,12110,12305,5191,195,PERF
42127338220000,PI,IP,001,1,7801,12303,4986,4502,PERF
42127338230000,PI,IP,001,1,7752,11972,4454,4220,PERF
42127338240000,PI,IP,001,1,7749,7960,5925,211,PERF
42127338240000,PI,IP,001,2,8050,8261,5925,211,PERF
42127338240000,PI,IP,001,3,8351,8562,5925,211,PERF
42127338240000,PI,IP,001,4,8652,8863,5925,211,PERF
42127338240000,PI,IP,001,5,8953,9164,5925,211,PERF
42127338240000,PI,IP,001,6,9254,9465,5925,211,PERF
42127338240000,PI,IP,001,7,9555,9766,5925,211,PERF
42127338240000,PI,IP,001,8,9856,10067,5925,211,PERF
42127338240000,PI,IP,001,9,10157,10368,5925,211,PERF
42127338240000,PI,IP,001,10,10458,10669,5925,211,PERF
42127338240000,PI,IP,001,11,10759,10970,5925,211,PERF
42127338240000,PI,IP,001,12,11060,11271,5925,211,PERF
42127338240000,PI,IP,001,13,11361,11572,5925,211,PERF
42127338240000,PI,IP,001,14,11662,11873,5925,211,PERF
42127338240000,PI,IP,001,15,11963,12174,5925,211,PERF
42127338240000,PI,IP,001,16,12264,12475,5925,211,PERF
42127338240000,PI,IP,001,17,12565,12776,5925,211,PERF
42127338240000,PI,IP,001,18,12835,12976,5925,141,PERF
42127338250000,PI,IP,001,1,8555,13473,6077,4918,PERF
42127338260000,PI,IP,001,1,8090,13258,6045,5168,PERF
42127338270000,PI,IP,001,1,8010,12460,6079,4450,PERF
42127338290000,PI,IP,001,1,8540,13518,6093,4978,PERF
42127338300000,PI,IP,001,1,7809,7810,5589,1,PERF
42127338300000,PI,IP,001,2,7839,7840,5589,1,PERF
42127338300000,PI,IP,001,3,7869,7870,5589,1,PERF
42127338300000,PI,IP,001,4,7899,7900,5589,1,PERF
42127338300000,PI,IP,001,5,7929,7930,5589,1,PERF
42127338300000,PI,IP,001,6,7959,7960,5589,1,PERF
42127338300000,PI,IP,001,7,7989,7990,5589,1,PERF
42127338300000,PI,IP,001,8,8019,8020,5589,1,PERF
42127338300000,PI,IP,001,9,8113,8114,5589,1,PERF
42127338300000,PI,IP,001,10,8143,8144,5589,1,PERF
42127338300000,PI,IP,001,11,8173,8174,5589,1,PERF
42127338300000,PI,IP,001,12,8203,8204,5589,1,PERF
42127338300000,PI,IP,001,13,8233,8234,5589,1,PERF
42127338300000,PI,IP,001,14,8263,8264,5589,1,PERF
42127338300000,PI,IP,001,15,8293,8294,5589,1,PERF
42127338300000,PI,IP,001,16,8323,8324,5589,1,PERF
42127338300000,PI,IP,001,17,8417,8418,5589,1,PERF
42127338300000,PI,IP,001,18,8447,8448,5589,1,PERF
42127338300000,PI,IP,001,19,8477,8478,5589,1,PERF
42127338300000,PI,IP,001,20,8507,8508,5589,1,PERF
42127338300000,PI,IP,001,21,8537,8538,5589,1,PERF
42127338300000,PI,IP,001,22,8567,8568,5589,1,PERF
42127338300000,PI,IP,001,23,8597,8598,5589,1,PERF
42127338300000,PI,IP,001,24,8627,8628,5589,1,PERF
42127338300000,PI,IP,001,25,8721,8722,5589,1,PERF
42127338300000,PI,IP,001,26,8751,8752,5589,1,PERF
42127338300000,PI,IP,001,27,8781,8782,5589,1,PERF
42127338300000,PI,IP,001,28,8811,8812,5589,1,PERF
42127338300000,PI,IP,001,29,8841,8842,5589,1,PERF
42127338300000,PI,IP,001,30,8871,8872,5589,1,PERF
42127338300000,PI,IP,001,31,8901,8902,5589,1,PERF
42127338300000,PI,IP,001,32,8931,8932,5589,1,PERF
42127338300000,PI,IP,001,33,9025,9026,5589,1,PERF
42127338300000,PI,IP,001,34,9055,9056,5589,1,PERF
42127338300000,PI,IP,001,35,9085,9086,5589,1,PERF
42127338300000,PI,IP,001,36,9115,9116,5589,1,PERF
42127338300000,PI,IP,001,37,9145,9146,5589,1,PERF
42127338300000,PI,IP,001,38,9175,9176,5589,1,PERF
42127338300000,PI,IP,001,39,9205,9206,5589,1,PERF
42127338300000,PI,IP,001,40,9235,9236,5589,1,PERF
42127338300000,PI,IP,001,41,9329,9330,5589,1,PERF
42127338300000,PI,IP,001,42,9359,9360,5589,1,PERF
42127338300000,PI,IP,001,43,9389,9390,5589,1,PERF
42127338300000,PI,IP,001,44,9419,9420,5589,1,PERF
42127338300000,PI,IP,001,45,9449,9450,5589,1,PERF
42127338300000,PI,IP,001,46,9479,9480,5589,1,PERF
42127338300000,PI,IP,001,47,9509,9510,5589,1,PERF
42127338300000,PI,IP,001,48,9539,9540,5589,1,PERF
42127338300000,PI,IP,001,49,9633,9634,5589,1,PERF
42127338300000,PI,IP,001,50,9663,9664,5589,1,PERF
42127338300000,PI,IP,001,51,9693,9694,5589,1,PERF
42127338300000,PI,IP,001,52,9723,9724,5589,1,PERF
42127338300000,PI,IP,001,53,9753,9754,5589,1,PERF
42127338300000,PI,IP,001,54,9783,9784,5589,1,PERF
42127338300000,PI,IP,001,55,9813,9814,5589,1,PERF
42127338300000,PI,IP,001,56,9843,9844,5589,1,PERF
42127338300000,PI,IP,001,57,9937,9938,5589,1,PERF
42127338300000,PI,IP,001,58,9967,9968,5589,1,PERF
42127338300000,PI,IP,001,59,9997,9998,5589,1,PERF
42127338300000,PI,IP,001,60,10027,10028,5589,1,PERF
42127338300000,PI,IP,001,61,10057,10058,5589,1,PERF
42127338300000,PI,IP,001,62,10087,10088,5589,1,PERF
42127338300000,PI,IP,001,63,10117,10118,5589,1,PERF
42127338300000,PI,IP,001,64,10147,10148,5589,1,PERF
42127338300000,PI,IP,001,65,10241,10242,5589,1,PERF
42127338300000,PI,IP,001,66,10271,10272,5589,1,PERF
42127338300000,PI,IP,001,67,10301,10302,5589,1,PERF
42127338300000,PI,IP,001,68,10331,10332,5589,1,PERF
42127338300000,PI,IP,001,69,10361,10362,5589,1,PERF
42127338300000,PI,IP,001,70,10391,10392,5589,1,PERF
42127338300000,PI,IP,001,71,10421,10422,5589,1,PERF
42127338300000,PI,IP,001,72,10451,10452,5589,1,PERF
42127338300000,PI,IP,001,73,10545,10546,5589,1,PERF
42127338300000,PI,IP,001,74,10575,10576,5589,1,PERF
42127338300000,PI,IP,001,75,10605,10606,5589,1,PERF
42127338300000,PI,IP,001,76,10635,10636,5589,1,PERF
42127338300000,PI,IP,001,77,10665,10666,5589,1,PERF
42127338300000,PI,IP,001,78,10695,10696,5589,1,PERF
42127338300000,PI,IP,001,79,10725,10726,5589,1,PERF
42127338300000,PI,IP,001,80,10755,10756,5589,1,PERF
42127338300000,PI,IP,001,81,10849,10850,5589,1,PERF
42127338300000,PI,IP,001,82,10879,10880,5589,1,PERF
42127338300000,PI,IP,001,83,10909,10910,5589,1,PERF
42127338300000,PI,IP,001,84,10939,10940,5589,1,PERF
42127338300000,PI,IP,001,85,10969,10970,5589,1,PERF
42127338300000,PI,IP,001,86,10999,11000,5589,1,PERF
42127338300000,PI,IP,001,87,11029,11030,5589,1,PERF
42127338300000,PI,IP,001,88,11059,11060,5589,1,PERF
42127338300000,PI,IP,001,89,11153,11154,5589,1,PERF
42127338300000,PI,IP,001,90,11183,11184,5589,1,PERF
42127338300000,PI,IP,001,91,11213,11214,5589,1,PERF
42127338300000,PI,IP,001,92,11243,11244,5589,1,PERF
42127338300000,PI,IP,001,93,11273,11274,5589,1,PERF
42127338300000,PI,IP,001,94,11303,11304,5589,1,PERF
42127338300000,PI,IP,001,95,11333,11334,5589,1,PERF
42127338300000,PI,IP,001,96,11363,11364,5589,1,PERF
42127338300000,PI,IP,001,97,11457,11458,5589,1,PERF
42127338300000,PI,IP,001,98,11487,11488,5589,1,PERF
42127338300000,PI,IP,001,99,11517,11518,5589,1,PERF
42127338300000,PI,IP,001,100,11547,11548,5589,1,PERF
42127338300000,PI,IP,001,101,11577,11578,5589,1,PERF
42127338300000,PI,IP,001,102,11607,11608,5589,1,PERF
42127338300000,PI,IP,001,103,11637,11638,5589,1,PERF
42127338300000,PI,IP,001,104,11667,11668,5589,1,PERF
42127338300000,PI,IP,001,105,11761,11762,5589,1,PERF
42127338300000,PI,IP,001,106,11791,11792,5589,1,PERF
42127338300000,PI,IP,001,107,11821,11822,5589,1,PERF
42127338300000,PI,IP,001,108,11851,11852,5589,1,PERF
42127338300000,PI,IP,001,109,11881,11882,5589,1,PERF
42127338300000,PI,IP,001,110,11911,11912,5589,1,PERF
42127338300000,PI,IP,001,111,11941,11942,5589,1,PERF
42127338300000,PI,IP,001,112,11971,11972,5589,1,PERF
42127338300000,PI,IP,001,113,12065,12066,5589,1,PERF
42127338300000,PI,IP,001,114,12095,12096,5589,1,PERF
42127338300000,PI,IP,001,115,12125,12126,5589,1,PERF
42127338300000,PI,IP,001,116,12155,12156,5589,1,PERF
42127338300000,PI,IP,001,117,12185,12186,5589,1,PERF
42127338300000,PI,IP,001,118,12215,12216,5589,1,PERF
42127338300000,PI,IP,001,119,12245,12246,5589,1,PERF
42127338300000,PI,IP,001,120,12275,12276,5589,1,PERF
42127338300000,PI,IP,001,121,12369,12370,5589,1,PERF
42127338300000,PI,IP,001,122,12399,12400,5589,1,PERF
42127338300000,PI,IP,001,123,12429,12430,5589,1,PERF
42127338300000,PI,IP,001,124,12459,12460,5589,1,PERF
42127338300000,PI,IP,001,125,12489,12490,5589,1,PERF
42127338300000,PI,IP,001,126,12519,12520,5589,1,PERF
42127338300000,PI,IP,001,127,12549,12550,5589,1,PERF
42127338300000,PI,IP,001,128,12579,12580,5589,1,PERF
42127338300000,PI,IP,001,129,12639,12640,5589,1,PERF
42127338300000,PI,IP,001,130,12674,12675,5589,1,PERF
42127338300000,PI,IP,001,131,12709,12710,5589,1,PERF
42127338300000,PI,IP,001,132,12744,12745,5589,1,PERF
42127338300000,PI,IP,001,133,12779,12780,5589,1,PERF
42127338310000,PI,IP,001,1,5940,11987,5276,6047,PERF
42127338320000,PI,IP,001,1,7219,7220,,1,PERF
42127338320000,PI,IP,001,2,7269,7270,,1,PERF
42127338320000,PI,IP,001,3,7319,7320,,1,PERF
42127338320000,PI,IP,001,4,7369,7370,,1,PERF
42127338320000,PI,IP,001,5,7419,7420,,1,PERF
42127338320000,PI,IP,001,6,7469,7470,,1,PERF
42127338320000,PI,IP,001,7,7519,7520,,1,PERF
42127338320000,PI,IP,001,8,7569,7570,,1,PERF
42127338320000,PI,IP,001,9,7659,7660,,1,PERF
42127338320000,PI,IP,001,10,7709,7710,,1,PERF
42127338320000,PI,IP,001,11,7759,7760,,1,PERF
42127338320000,PI,IP,001,12,7809,7810,,1,PERF
42127338320000,PI,IP,001,13,7859,7860,,1,PERF
42127338320000,PI,IP,001,14,7909,7910,,1,PERF
42127338320000,PI,IP,001,15,7959,7960,,1,PERF
42127338320000,PI,IP,001,16,8009,8010,,1,PERF
42127338320000,PI,IP,001,17,8099,8100,,1,PERF
42127338320000,PI,IP,001,18,8149,8150,,1,PERF
42127338320000,PI,IP,001,19,8199,8200,,1,PERF
42127338320000,PI,IP,001,20,8249,8250,,1,PERF
42127338320000,PI,IP,001,21,8299,8300,,1,PERF
42127338320000,PI,IP,001,22,8349,8350,,1,PERF
42127338320000,PI,IP,001,23,8399,8400,,1,PERF
42127338320000,PI,IP,001,24,8449,8450,,1,PERF
42127338320000,PI,IP,001,25,8539,8540,,1,PERF
42127338320000,PI,IP,001,26,8589,8590,,1,PERF
42127338320000,PI,IP,001,27,8639,8640,,1,PERF
42127338320000,PI,IP,001,28,8689,8690,,1,PERF
42127338320000,PI,IP,001,29,8739,8740,,1,PERF
42127338320000,PI,IP,001,30,8789,8790,,1,PERF
42127338320000,PI,IP,001,31,8839,8840,,1,PERF
42127338320000,PI,IP,001,32,8889,8890,,1,PERF
42127338320000,PI,IP,001,33,8979,8980,,1,PERF
42127338320000,PI,IP,001,34,9029,9030,,1,PERF
42127338320000,PI,IP,001,35,9079,9080,,1,PERF
42127338320000,PI,IP,001,36,9129,9130,,1,PERF
42127338320000,PI,IP,001,37,9179,9180,,1,PERF
42127338320000,PI,IP,001,38,9229,9230,,1,PERF
42127338320000,PI,IP,001,39,9279,9280,,1,PERF
42127338320000,PI,IP,001,40,9329,9330,,1,PERF
42127338320000,PI,IP,001,41,9419,9420,,1,PERF
42127338320000,PI,IP,001,42,9469,9470,,1,PERF
42127338320000,PI,IP,001,43,9519,9520,,1,PERF
42127338320000,PI,IP,001,44,9569,9570,,1,PERF
42127338320000,PI,IP,001,45,9619,9620,,1,PERF
42127338320000,PI,IP,001,46,9669,9670,,1,PERF
42127338320000,PI,IP,001,47,9719,9720,,1,PERF
42127338320000,PI,IP,001,48,9769,9770,,1,PERF
42127338320000,PI,IP,001,49,9859,9860,,1,PERF
42127338320000,PI,IP,001,50,9909,9910,,1,PERF
42127338320000,PI,IP,001,51,9959,9960,,1,PERF
42127338320000,PI,IP,001,52,10009,10010,,1,PERF
42127338320000,PI,IP,001,53,10059,10060,,1,PERF
42127338320000,PI,IP,001,54,10109,10110,,1,PERF
42127338320000,PI,IP,001,55,10159,10160,,1,PERF
42127338320000,PI,IP,001,56,10209,10210,,1,PERF
42127338320000,PI,IP,001,57,10299,10300,,1,PERF
42127338320000,PI,IP,001,58,10349,10350,,1,PERF
42127338320000,PI,IP,001,59,10399,10400,,1,PERF
42127338320000,PI,IP,001,60,10449,10450,,1,PERF
42127338320000,PI,IP,001,61,10499,10500,,1,PERF
42127338320000,PI,IP,001,62,10549,10550,,1,PERF
42127338320000,PI,IP,001,63,10599,10600,,1,PERF
42127338320000,PI,IP,001,64,10649,10650,,1,PERF
42127338320000,PI,IP,001,65,10739,10740,,1,PERF
42127338320000,PI,IP,001,66,10789,10790,,1,PERF
42127338320000,PI,IP,001,67,10839,10840,,1,PERF
42127338320000,PI,IP,001,68,10889,10890,,1,PERF
42127338320000,PI,IP,001,69,10939,10940,,1,PERF
42127338320000,PI,IP,001,70,10989,10990,,1,PERF
42127338320000,PI,IP,001,71,11039,11040,,1,PERF
42127338320000,PI,IP,001,72,11089,11090,,1,PERF
42127338320000,PI,IP,001,73,11179,11180,,1,PERF
42127338320000,PI,IP,001,74,11229,11230,,1,PERF
42127338320000,PI,IP,001,75,11279,11280,,1,PERF
42127338320000,PI,IP,001,76,11329,11330,,1,PERF
42127338320000,PI,IP,001,77,11379,11380,,1,PERF
42127338320000,PI,IP,001,78,11429,11430,,1,PERF
42127338320000,PI,IP,001,79,11479,11480,,1,PERF
42127338320000,PI,IP,001,80,11529,11530,,1,PERF
42127338320000,PI,IP,001,81,11619,11620,,1,PERF
42127338320000,PI,IP,001,82,11669,11670,,1,PERF
42127338320000,PI,IP,001,83,11719,11720,,1,PERF
42127338320000,PI,IP,001,84,11769,11770,,1,PERF
42127338320000,PI,IP,001,85,11819,11820,,1,PERF
42127338320000,PI,IP,001,86,11869,11870,,1,PERF
42127338320000,PI,IP,001,87,11919,11920,,1,PERF
42127338320000,PI,IP,001,88,11969,11970,,1,PERF
42127338320000,PI,IP,001,89,12059,12060,,1,PERF
42127338320000,PI,IP,001,90,12109,12110,,1,PERF
42127338320000,PI,IP,001,91,12159,12160,,1,PERF
42127338320000,PI,IP,001,92,12209,12210,,1,PERF
42127338320000,PI,IP,001,93,12259,12260,,1,PERF
42127338320000,PI,IP,001,94,12309,12310,,1,PERF
42127338320000,PI,IP,001,95,12359,12360,,1,PERF
42127338320000,PI,IP,001,96,12409,12410,,1,PERF
42127338320000,PI,IP,001,97,12499,12500,,1,PERF
42127338320000,PI,IP,001,98,12549,12550,,1,PERF
42127338320000,PI,IP,001,99,12599,12600,,1,PERF
42127338320000,PI,IP,001,100,12649,12650,,1,PERF
42127338320000,PI,IP,001,101,12699,12700,,1,PERF
42127338320000,PI,IP,001,102,12749,12750,,1,PERF
42127338320000,PI,IP,001,103,12799,12800,,1,PERF
42127338320000,PI,IP,001,104,12849,12850,,1,PERF
42127338320000,PI,IP,001,105,12939,12940,,1,PERF
42127338320000,PI,IP,001,106,12989,12990,,1,PERF
42127338320000,PI,IP,001,107,13039,13040,,1,PERF
42127338320000,PI,IP,001,108,13089,13090,,1,PERF
42127338320000,PI,IP,001,109,13139,13140,,1,PERF
42127338320000,PI,IP,001,110,13189,13190,,1,PERF
42127338320000,PI,IP,001,111,13239,13240,,1,PERF
42127338320000,PI,IP,001,112,13289,13290,,1,PERF
42127338320000,PI,IP,001,113,13379,13380,,1,PERF
42127338320000,PI,IP,001,114,13429,13430,,1,PERF
42127338320000,PI,IP,001,115,13479,13480,,1,PERF
42127338320000,PI,IP,001,116,13529,13530,,1,PERF
42127338320000,PI,IP,001,117,13579,13580,,1,PERF
42127338320000,PI,IP,001,118,13629,13680,,51,PERF
42127338320000,PI,IP,001,119,13679,13680,,1,PERF
42127338320000,PI,IP,001,120,13729,13730,,1,PERF
42127338320000,PI,IP,001,121,13819,13820,,1,PERF
42127338320000,PI,IP,001,122,13854,13855,,1,PERF
42127338320000,PI,IP,001,123,13889,13890,,1,PERF
42127338320000,PI,IP,001,124,13924,13925,,1,PERF
42127338320000,PI,IP,001,125,13959,13960,,1,PERF
42127338330000,PI,IP,001,1,8756,13282,5661,4526,PERF
42127338340000,PI,IP,001,1,8339,13496,6026,5157,PERF
42127338350000,PI,IP,002,1,8752,14552,6905,5800,PERF
42127338350000,PI,PT,001,1,8752,14552,6905,5800,PERF
42127338360000,PI,IP,001,1,13717,13718,6764,1,PERF
42127338360000,PI,IP,001,2,13755,13756,6764,1,PERF
42127338360000,PI,IP,001,3,13793,13794,6764,1,PERF
42127338360000,PI,IP,001,4,13830,13831,6764,1,PERF
42127338360000,PI,IP,001,5,13868,13869,6764,1,PERF
42127338370000,PI,IP,001,1,9046,13910,6227,4864,PERF
42127338380000,PI,IP,001,1,8846,13712,6203,4866,PERF
42127338390000,PI,IP,001,1,8670,13842,6211,5172,PERF
42127338410100,PI,IP,001,1,9236,14560,6371,5324,PERF
42127338420000,PI,IP,001,1,8922,13500,7097,4578,PERF
42127338430200,PI,IP,001,1,9044,13589,6012,4545,PERF
42127338440000,PI,IP,001,1,8780,13754,5893,4974,PERF
42127338450000,PI,IP,001,1,8381,13100,6126,4719,PERF
42127338460000,PI,IP,001,1,7808,12719,6028,4911,PERF
42127338470000,PI,IP,001,1,8063,12686,6085,4623,PERF
42127338480000,PI,IP,001,1,7856,15392,7850,7536,PERF
42127338490000,PI,IP,001,1,7200,7386,5708,186,PERF
42127338490000,PI,IP,001,2,7490,7676,5708,186,PERF
42127338490000,PI,IP,001,3,7780,7966,5708,186,PERF
42127338490000,PI,IP,001,4,8070,8260,5708,190,PERF
42127338490000,PI,IP,001,5,8349,8550,5708,201,PERF
42127338490000,PI,IP,001,6,8650,8840,5708,190,PERF
42127338490000,PI,IP,001,7,8940,9130,5708,190,PERF
42127338490000,PI,IP,001,8,9230,9420,5708,190,PERF
42127338490000,PI,IP,001,9,9520,9710,5708,190,PERF
42127338490000,PI,IP,001,10,9810,10000,5708,190,PERF
42127338490000,PI,IP,001,11,10100,10290,5708,190,PERF
42127338490000,PI,IP,001,12,10390,10580,5708,190,PERF
42127338490000,PI,IP,001,13,10680,10870,5708,190,PERF
42127338490000,PI,IP,001,14,10970,11160,5708,190,PERF
42127338490000,PI,IP,001,15,11260,11450,5708,190,PERF
42127338490000,PI,IP,001,16,11550,11740,5708,190,PERF
42127338490000,PI,IP,001,17,11840,12030,5708,190,PERF
42127338500000,PI,IP,001,1,8209,8211,5808,2,PERF
42127338500000,PI,IP,001,2,8278,8280,5808,2,PERF
42127338500000,PI,IP,001,3,8342,8344,5808,2,PERF
42127338500000,PI,IP,001,4,8416,8418,5808,2,PERF
42127338500000,PI,IP,001,5,8493,8495,5808,2,PERF
42127338500000,PI,IP,001,6,8564,8566,5808,2,PERF
42127338500000,PI,IP,001,7,8633,8635,5808,2,PERF
42127338500000,PI,IP,001,8,8706,8708,5808,2,PERF
42127338500000,PI,IP,001,9,8783,8785,5808,2,PERF
42127338500000,PI,IP,001,10,8857,8859,5808,2,PERF
42127338500000,PI,IP,001,11,8925,8927,5808,2,PERF
42127338500000,PI,IP,001,12,8996,8998,5808,2,PERF
42127338500000,PI,IP,001,13,9073,9075,5808,2,PERF
42127338500000,PI,IP,001,14,9144,9146,5808,2,PERF
42127338500000,PI,IP,001,15,9215,9217,5808,2,PERF
42127338500000,PI,IP,001,16,9286,9288,5808,2,PERF
42127338500000,PI,IP,001,17,9363,9365,5808,2,PERF
42127338500000,PI,IP,001,18,9434,9436,5808,2,PERF
42127338500000,PI,IP,001,19,9505,9507,5808,2,PERF
42127338500000,PI,IP,001,20,9576,9578,5808,2,PERF
42127338500000,PI,IP,001,21,9655,9657,5808,2,PERF
42127338500000,PI,IP,001,22,9724,9726,5808,2,PERF
42127338500000,PI,IP,001,23,9795,9797,5808,2,PERF
42127338500000,PI,IP,001,24,9866,9868,5808,2,PERF
42127338500000,PI,IP,001,25,9943,9945,5808,2,PERF
42127338500000,PI,IP,001,26,10014,10016,5808,2,PERF
42127338500000,PI,IP,001,27,10085,10087,5808,2,PERF
42127338500000,PI,IP,001,28,10156,10158,5808,2,PERF
42127338500000,PI,IP,001,29,10233,10235,5808,2,PERF
42127338500000,PI,IP,001,30,10304,10306,5808,2,PERF
42127338500000,PI,IP,001,31,10375,10377,5808,2,PERF
42127338500000,PI,IP,001,32,10442,10444,5808,2,PERF
42127338500000,PI,IP,001,33,10523,10525,5808,2,PERF
42127338500000,PI,IP,001,34,10594,10596,5808,2,PERF
42127338500000,PI,IP,001,35,10665,10667,5808,2,PERF
42127338500000,PI,IP,001,36,10736,10738,5808,2,PERF
42127338500000,PI,IP,001,37,10813,10815,5808,2,PERF
42127338500000,PI,IP,001,38,10884,10886,5808,2,PERF
42127338500000,PI,IP,001,39,10955,10957,5808,2,PERF
42127338500000,PI,IP,001,40,11026,11028,5808,2,PERF
42127338500000,PI,IP,001,41,11103,11105,5808,2,PERF
42127338500000,PI,IP,001,42,11174,11176,5808,2,PERF
42127338500000,PI,IP,001,43,11245,11247,5808,2,PERF
42127338500000,PI,IP,001,44,11316,11318,5808,2,PERF
42127338500000,PI,IP,001,45,11393,11395,5808,2,PERF
42127338500000,PI,IP,001,46,11464,11466,5808,2,PERF
42127338500000,PI,IP,001,47,11535,11537,5808,2,PERF
42127338500000,PI,IP,001,48,11606,11608,5808,2,PERF
42127338500000,PI,IP,001,49,11683,11685,5808,2,PERF
42127338500000,PI,IP,001,50,11754,11756,5808,2,PERF
42127338500000,PI,IP,001,51,11825,11827,5808,2,PERF
42127338500000,PI,IP,001,52,11890,11892,5808,2,PERF
42127338500000,PI,IP,001,53,11973,11975,5808,2,PERF
42127338500000,PI,IP,001,54,12044,12046,5808,2,PERF
42127338500000,PI,IP,001,55,12115,12117,5808,2,PERF
42127338500000,PI,IP,001,56,12186,12188,5808,2,PERF
42127338500000,PI,IP,001,57,12263,12265,5808,2,PERF
42127338500000,PI,IP,001,58,12332,12334,5808,2,PERF
42127338500000,PI,IP,001,59,12405,12407,5808,2,PERF
42127338500000,PI,IP,001,60,12476,12478,5808,2,PERF
42127338500000,PI,IP,001,61,12555,12557,5808,2,PERF
42127338500000,PI,IP,001,62,12625,12627,5808,2,PERF
42127338500000,PI,IP,001,63,12696,12698,5808,2,PERF
42127338500000,PI,IP,001,64,12766,12768,5808,2,PERF
42127338500000,PI,IP,001,65,12846,12848,5808,2,PERF
42127338500000,PI,IP,001,66,12909,12910,5808,1,PERF
42127338500000,PI,IP,001,67,12971,12973,5808,2,PERF
42127338500000,PI,IP,001,68,13034,13035,5808,1,PERF
42127338510000,PI,IP,002,1,6417,12935,6619,6518,PERF
42127338510000,PI,PT,001,1,12792,12935,6619,143,PERF
42127338520000,PI,IP,001,1,8470,13285,6100,4815,PERF
42127338530000,PI,IP,001,1,8194,13367,6017,5173,PERF
42127338540000,PI,IP,001,1,8625,13536,6061,4911,PERF
42127338550000,PI,IP,001,1,8253,12996,6070,4743,PERF
42127338560000,PI,IP,002,1,7951,12636,6017,4685,PERF
42127338560000,PI,PT,001,1,7951,12636,6017,4685,PERF
42127338570000,PI,IP,002,1,8299,12960,6144,4661,PERF
42127338570000,PI,PT,001,1,8299,12960,6144,4661,PERF
42127338590000,PI,IP,001,1,8058,12976,6038,4918,PERF
42127338600000,PI,IP,001,1,6631,13609,7311,6978,PERF
42127338620000,PI,IP,001,1,7852,12511,5438,4659,PERF
42127338630000,PI,IP,001,1,8270,12590,5378,4320,PERF
42127338640000,PI,IP,001,1,8023,12519,5937,4496,PERF
42127338650000,PI,IP,001,1,7305,11440,5153,4135,PERF
42127338660000,PI,IP,001,1,7013,11977,5876,4964,PERF
42127338670100,PI,IP,001,1,7524,15825,8528,8301,PERF
42127338680000,PI,IP,001,1,7868,14727,6832,6859,PERF
42127338690000,PI,IP,001,1,6763,12865,6401,6102,PERF
42127338710000,PI,IP,001,1,8678,13817,6335,5139,PERF
42127338720000,PI,IP,001,1,8865,14139,6425,5274,PERF
42127338730000,PI,IP,001,1,6286,10406,5033,4120,PERF
42127338740000,PI,IP,001,1,8476,13147,6142,4671,PERF
42127338750000,PI,IP,001,1,8209,13074,6117,4865,PERF
42127338760000,PI,IP,001,1,7938,12761,5996,4823,PERF
42127338770000,PI,IP,001,1,8096,8311,5901,215,PERF
42127338770000,PI,IP,001,2,8409,8627,5901,218,PERF
42127338770000,PI,IP,001,3,8727,8945,5901,218,PERF
42127338770000,PI,IP,001,4,9045,9260,5901,215,PERF
42127338770000,PI,IP,001,5,9363,9581,5901,218,PERF
42127338770000,PI,IP,001,6,9683,9899,5901,216,PERF
42127338770000,PI,IP,001,7,9999,10217,5901,218,PERF
42127338770000,PI,IP,001,8,10317,10535,5901,218,PERF
42127338780000,PI,IP,001,1,8074,13243,6228,5169,PERF
42127338790000,PI,IP,001,1,8610,14143,6302,5533,PERF
42127338800000,PI,IP,001,1,8489,13783,6235,5294,PERF
42127338810000,PI,IP,001,1,7265,7500,6118,235,PERF
42127338810000,PI,IP,001,2,7620,7855,6118,235,PERF
42127338810000,PI,IP,001,3,7970,8210,6118,240,PERF
42127338810000,PI,IP,001,4,8330,8569,6118,239,PERF
42127338810000,PI,IP,001,5,8685,8920,6118,235,PERF
42127338810000,PI,IP,001,6,9044,9275,6118,231,PERF
42127338810000,PI,IP,001,7,9395,9630,6118,235,PERF
42127338810000,PI,IP,001,8,9750,9985,6118,235,PERF
42127338810000,PI,IP,001,9,10105,10340,6118,235,PERF
42127338810000,PI,IP,001,10,10460,10695,6118,235,PERF
42127338810000,PI,IP,001,11,10815,11050,6118,235,PERF
42127338810000,PI,IP,001,12,11170,11405,6118,235,PERF
42127338810000,PI,IP,001,13,11525,11760,6118,235,PERF
42127338810000,PI,IP,001,14,11880,12115,6118,235,PERF
42127338810000,PI,IP,001,15,12235,12470,6118,235,PERF
42127338830000,PI,IP,001,1,7351,7585,6235,234,PERF
42127338830000,PI,IP,001,2,7695,7929,6235,234,PERF
42127338830000,PI,IP,001,3,8039,8278,6235,239,PERF
42127338830000,PI,IP,001,4,8383,8617,6235,234,PERF
42127338830000,PI,IP,001,5,8727,8961,6235,234,PERF
42127338830000,PI,IP,001,6,9071,9305,6235,234,PERF
42127338830000,PI,IP,001,7,9415,9649,6235,234,PERF
42127338830000,PI,IP,001,8,9756,9993,6235,237,PERF
42127338830000,PI,IP,001,9,10103,10335,6235,232,PERF
42127338830000,PI,IP,001,10,10447,10681,6235,234,PERF
42127338830000,PI,IP,001,11,10788,11025,6235,237,PERF
42127338830000,PI,IP,001,12,11135,11372,6235,237,PERF
42127338830000,PI,IP,001,13,11479,11713,6235,234,PERF
42127338830000,PI,IP,001,14,11823,12057,6235,234,PERF
42127338830000,PI,IP,001,15,12167,12401,6235,234,PERF
42127338830000,PI,IP,001,16,12511,12745,6235,234,PERF
42127338840000,PI,IP,001,1,6168,10554,5000,4386,PERF
42127338850000,PI,IP,001,1,7815,12097,5587,4282,PERF
42127338860000,PI,IP,001,1,7874,12431,4969,4557,PERF
42127338870000,PI,IP,001,1,7094,15150,,8056,PERF
42127338880000,PI,IP,001,1,6785,13134,,6349,PERF
42127338890000,PI,IP,003,1,8264,12935,6054,4671,PERF
42127338890000,PI,PT,001,1,8264,12935,6054,4671,PERF
42127338890000,PI,PT,002,2,8264,12935,6054,4671,PERF
42127338900000,PI,IP,003,1,7856,12685,6017,4829,PERF
42127338900000,PI,PT,001,1,7856,12685,6017,4829,PERF
42127338900000,PI,PT,002,2,7856,12685,6017,4829,PERF
42127338910000,PI,IP,003,1,9234,12987,6118,3753,PERF
42127338910000,PI,PT,001,1,9234,12987,6118,3753,PERF
42127338910000,PI,PT,002,2,9234,12987,6118,3753,PERF
42127338920000,PI,IP,001,1,8022,13056,6371,5034,PERF
42127338930000,PI,IP,001,1,8301,12924,6115,4623,PERF
42127338940000,PI,IP,001,1,7703,12566,6007,4863,PERF
42127338950000,PI,IP,001,1,8468,12976,6095,4508,PERF
42127338970000,PI,IP,001,1,7805,12487,4960,4682,PERF
42127338990000,PI,IP,001,1,7837,12510,4958,4673,PERF
42127339020000,PI,IP,001,1,7628,7815,6096,187,PERF
42127339020000,PI,IP,001,2,7925,8112,6096,187,PERF
42127339020000,PI,IP,001,3,8222,8409,6096,187,PERF
42127339020000,PI,IP,001,4,8519,8706,6096,187,PERF
42127339020000,PI,IP,001,5,8816,9003,6096,187,PERF
42127339020000,PI,IP,001,6,9113,9300,6096,187,PERF
42127339020000,PI,IP,001,7,9410,9597,6096,187,PERF
42127339020000,PI,IP,001,8,9707,9894,6096,187,PERF
42127339020000,PI,IP,001,9,10004,10191,6096,187,PERF
42127339020000,PI,IP,001,10,10301,10488,6096,187,PERF
42127339020000,PI,IP,001,11,10598,10785,6096,187,PERF
42127339020000,PI,IP,001,12,10895,11082,6096,187,PERF
42127339020000,PI,IP,001,13,11192,11379,6096,187,PERF
42127339020000,PI,IP,001,14,11489,11676,6096,187,PERF
42127339020000,PI,IP,001,15,11786,11973,6096,187,PERF
42127339020000,PI,IP,001,16,12083,12270,6096,187,PERF
42127339030000,PI,IP,001,1,8705,13077,5681,4372,PERF
42127339040000,PI,IP,001,1,8515,12782,5470,4267,PERF
42127339050000,PI,IP,001,1,8452,12842,5475,4390,PERF
42127339060000,PI,IP,001,1,7996,12536,5660,4540,PERF
42127339070000,PI,IP,001,1,7680,12950,5418,5270,PERF
42127339080000,PI,IP,002,1,7190,13750,6910,6560,PERF
42127339080000,PI,PT,001,1,7190,13750,6910,6560,PERF
42127339090000,PI,IP,001,1,7136,11509,5513,4373,PERF
42127339100000,PI,IP,001,1,6875,11766,6007,4891,PERF
42127339110000,PI,IP,001,1,7259,15000,8329,7741,PERF
42127339120000,PI,IP,001,1,7923,8111,6085,188,PERF
42127339120000,PI,IP,001,2,8219,8407,6085,188,PERF
42127339120000,PI,IP,001,3,8515,8703,6085,188,PERF
42127339120000,PI,IP,001,4,8911,8999,6085,88,PERF
42127339120000,PI,IP,001,5,9107,9264,6085,157,PERF
42127339120000,PI,IP,001,6,9403,9592,6085,189,PERF
42127339120000,PI,IP,001,7,9699,9888,6085,189,PERF
42127339120000,PI,IP,001,8,9995,10184,6085,189,PERF
42127339120000,PI,IP,001,9,10291,10480,6085,189,PERF
42127339120000,PI,IP,001,10,10587,10776,6085,189,PERF
42127339120000,PI,IP,001,11,10887,11072,6085,185,PERF
42127339120000,PI,IP,001,12,11179,11368,6085,189,PERF
42127339120000,PI,IP,001,13,11475,11664,6085,189,PERF
42127339120000,PI,IP,001,14,11771,11960,6085,189,PERF
42127339120000,PI,IP,001,15,12068,12254,6085,186,PERF
42127339120000,PI,IP,001,16,12364,12550,6085,186,PERF
42127339130000,PI,IP,001,1,8150,12871,5804,4721,PERF
42127339140000,PI,IP,001,1,8980,12788,5104,3808,PERF
42127339150000,PI,IP,001,1,7009,12160,,5151,PERF
42127339160000,PI,IP,002,1,8496,13586,6105,5090,PERF
42127339160000,PI,PT,001,1,8496,13586,6105,5090,PERF
42127339170000,PI,IP,001,1,6772,12879,6565,6107,PERF
42127339190000,PI,IP,001,1,6864,13124,6210,6260,PERF
42127339200000,PI,IP,001,1,6419,6615,6213,196,PERF
42127339200000,PI,IP,001,2,6742,6933,6213,191,PERF
42127339200000,PI,IP,001,3,7065,7256,6213,191,PERF
42127339200000,PI,IP,001,4,7388,7579,6213,191,PERF
42127339200000,PI,IP,001,5,7711,7907,6213,196,PERF
42127339200000,PI,IP,001,6,8034,8230,6213,196,PERF
42127339200000,PI,IP,001,7,8361,8552,6213,191,PERF
42127339200000,PI,IP,001,8,8684,8875,6213,191,PERF
42127339200000,PI,IP,001,9,9007,9198,6213,191,PERF
42127339200000,PI,IP,001,10,9330,9522,6213,192,PERF
42127339200000,PI,IP,001,11,9653,9844,6213,191,PERF
42127339200000,PI,IP,001,12,9976,10167,6213,191,PERF
42127339200000,PI,IP,001,13,10299,10490,6213,191,PERF
42127339200000,PI,IP,001,14,10622,10813,6213,191,PERF
42127339200000,PI,IP,001,15,10945,11136,6213,191,PERF
42127339200000,PI,IP,001,16,11268,11459,6213,191,PERF
42127339210000,PI,IP,001,1,7323,7513,5971,190,PERF
42127339210000,PI,IP,001,2,7637,7827,5971,190,PERF
42127339210000,PI,IP,001,3,7956,8141,5971,185,PERF
42127339210000,PI,IP,001,4,8265,8455,5971,190,PERF
42127339210000,PI,IP,001,5,8570,8769,5971,199,PERF
42127339210000,PI,IP,001,6,8884,9083,5971,199,PERF
42127339210000,PI,IP,001,7,9209,9397,5971,188,PERF
42127339210000,PI,IP,001,8,9512,9711,5971,199,PERF
42127339210000,PI,IP,001,9,9826,10026,5971,200,PERF
42127339210000,PI,IP,001,10,10140,10330,5971,190,PERF
42127339210000,PI,IP,001,11,10454,10644,5971,190,PERF
42127339210000,PI,IP,001,12,10777,10967,5971,190,PERF
42127339210000,PI,IP,001,13,11091,11281,5971,190,PERF
42127339210000,PI,IP,001,14,11405,11595,5971,190,PERF
42127339210000,PI,IP,001,15,11719,11906,5971,187,PERF
42127339210000,PI,IP,001,16,12033,12223,5971,190,PERF
42127339220000,PI,IP,001,1,6519,14052,7942,7533,PERF
42127339230000,PI,IP,001,1,6570,10716,4884,4146,PERF
42127339260100,PI,IP,001,1,6920,6924,4823,4,PERF
42127339260100,PI,IP,001,2,6990,6994,4823,4,PERF
42127339260100,PI,IP,001,3,7060,7064,4823,4,PERF
42127339260100,PI,IP,001,4,7130,7134,4823,4,PERF
42127339260100,PI,IP,001,5,7230,7234,4823,4,PERF
42127339260100,PI,IP,001,6,7330,7334,4823,4,PERF
42127339260100,PI,IP,001,7,7420,7424,4823,4,PERF
42127339260100,PI,IP,001,8,7520,7524,4823,4,PERF
42127339260100,PI,IP,001,9,7616,7620,4823,4,PERF
42127339260100,PI,IP,001,10,7730,7734,4823,4,PERF
42127339260100,PI,IP,001,11,7830,7834,4823,4,PERF
42127339260100,PI,IP,001,12,7930,7934,4823,4,PERF
42127339260100,PI,IP,001,13,8030,8034,4823,4,PERF
42127339260100,PI,IP,001,14,8130,8134,4823,4,PERF
42127339260100,PI,IP,001,15,8230,8234,4823,4,PERF
42127339260100,PI,IP,001,16,8330,8334,4823,4,PERF
42127339260100,PI,IP,001,17,8430,8434,4823,4,PERF
42127339260100,PI,IP,001,18,8530,8534,4823,4,PERF
42127339260100,PI,IP,001,19,8630,8634,4823,4,PERF
42127339260100,PI,IP,001,20,8730,8734,4823,4,PERF
42127339260100,PI,IP,001,21,8830,8834,4823,4,PERF
42127339260100,PI,IP,001,22,8930,8934,4823,4,PERF
42127339260100,PI,IP,001,23,9030,9034,4823,4,PERF
42127339260100,PI,IP,001,24,9130,9134,4823,4,PERF
42127339260100,PI,IP,001,25,9230,9234,4823,4,PERF
42127339260100,PI,IP,001,26,9330,9334,4823,4,PERF
42127339260100,PI,IP,001,27,9430,9434,4823,4,PERF
42127339260100,PI,IP,001,28,9530,9534,4823,4,PERF
42127339260100,PI,IP,001,29,9630,9634,4823,4,PERF
42127339260100,PI,IP,001,30,9730,9734,4823,4,PERF
42127339260100,PI,IP,001,31,9830,9834,4823,4,PERF
42127339260100,PI,IP,001,32,9930,9934,4823,4,PERF
42127339260100,PI,IP,001,33,10030,10034,4823,4,PERF
42127339260100,PI,IP,001,34,10130,10134,4823,4,PERF
42127339260100,PI,IP,001,35,10230,10234,4823,4,PERF
42127339260100,PI,IP,001,36,10330,10334,4823,4,PERF
42127339260100,PI,IP,001,37,10430,10434,4823,4,PERF
42127339260100,PI,IP,001,38,10530,10534,4823,4,PERF
42127339260100,PI,IP,001,39,10630,10634,4823,4,PERF
42127339260100,PI,IP,001,40,10734,10734,4823,0,PERF
42127339260100,PI,IP,001,41,10834,10834,4823,0,PERF
42127339260100,PI,IP,001,42,10934,10934,4823,0,PERF
42127339270000,PI,IP,001,1,7616,7803,5978,187,PERF
42127339270000,PI,IP,001,2,7907,8097,5978,190,PERF
42127339270000,PI,IP,001,3,8201,8391,5978,190,PERF
42127339270000,PI,IP,001,4,8495,8685,5978,190,PERF
42127339270000,PI,IP,001,5,8789,8979,5978,190,PERF
42127339270000,PI,IP,001,6,9083,9273,5978,190,PERF
42127339270000,PI,IP,001,7,9377,9567,5978,190,PERF
42127339270000,PI,IP,001,8,9671,9862,5978,191,PERF
42127339270000,PI,IP,001,9,9965,10155,5978,190,PERF
42127339270000,PI,IP,001,10,10259,10450,5978,191,PERF
42127339270000,PI,IP,001,11,10553,10743,5978,190,PERF
42127339270000,PI,IP,001,12,10851,11037,5978,186,PERF
42127339270000,PI,IP,001,13,11146,11331,5978,185,PERF
42127339270000,PI,IP,001,14,11435,11625,5978,190,PERF
42127339270000,PI,IP,001,15,11732,11919,5978,187,PERF
42127339270000,PI,IP,001,16,12023,12213,5978,190,PERF
42127339280000,PI,IP,002,1,7149,13455,6488,6306,PERF
42127339280000,PI,PT,001,1,7149,13455,6488,6306,PERF
42127339290000,PI,IP,001,1,7054,13276,6986,6222,PERF
42127339300000,PI,IP,001,1,8691,13244,6067,4553,PERF
42127339310000,PI,IP,001,1,8630,13306,6064,4676,PERF
42127339320000,PI,IP,001,1,8378,13048,6015,4670,PERF
42127339330000,PI,IP,001,1,7785,12194,5606,4409,PERF
42127339340000,PI,IP,001,1,8040,12456,5665,4416,PERF
42127339350000,PI,IP,001,1,8076,12314,5614,4238,PERF
42127339360000,PI,IP,001,1,6414,6634,5233,220,PERF
42127339360000,PI,IP,001,2,6691,6925,5233,234,PERF
42127339360000,PI,IP,001,3,7045,7279,5233,234,PERF
42127339360000,PI,IP,001,4,7399,7633,5233,234,PERF
42127339360000,PI,IP,001,5,7753,7987,5233,234,PERF
42127339360000,PI,IP,001,6,8107,8341,5233,234,PERF
42127339360000,PI,IP,001,7,8461,8695,5233,234,PERF
42127339360000,PI,IP,001,8,8815,9049,5233,234,PERF
42127339360000,PI,IP,001,9,9164,9403,5233,239,PERF
42127339360000,PI,IP,001,10,9523,9757,5233,234,PERF
42127339360000,PI,IP,001,11,9877,10111,5233,234,PERF
42127339360000,PI,IP,001,12,10231,10465,5233,234,PERF
42127339370000,PI,IP,001,1,8709,13443,6238,4734,PERF
42127339380000,PI,IP,001,1,7911,12900,6128,4989,PERF
42127339390000,PI,IP,001,1,8080,12898,6124,4818,PERF
42127339400000,PI,IP,001,1,7643,13993,,6350,PERF
42127339440000,PI,IP,001,1,7879,13270,5783,5391,PERF
42127339450000,PI,IP,001,1,6979,13986,7383,7007,PERF
42127339460000,PI,IP,001,1,8329,15466,8194,7137,PERF
42127339470000,PI,IP,001,1,8600,13101,6204,4501,PERF
42127339480000,PI,IP,001,1,8049,12689,6047,4640,PERF
42127339490000,PI,IP,001,1,7988,12909,6068,4921,PERF
42127339510000,PI,IP,002,1,8178,12934,6003,4756,PERF
42127339510000,PI,PT,001,1,8178,12934,6003,4756,PERF
42127339520000,PI,IP,001,1,8123,13116,6011,4993,PERF
42127339530000,PI,IP,002,1,8288,13245,6077,4957,PERF
42127339530000,PI,PT,001,1,8288,13245,6077,4957,PERF
42127339580000,PI,IP,001,1,7339,7340,4775,1,PERF
42127339580000,PI,IP,001,2,7630,11561,4775,3931,PERF
42127339590000,PI,IP,001,1,7590,12142,5028,4552,PERF
42127339600000,PI,IP,001,1,8487,13782,6630,5295,PERF
42127339620000,PI,IP,001,1,7555,14200,6827,6645,PERF
42127339640000,PI,IP,001,1,8970,14341,6593,5371,PERF
42127339650000,PI,IP,001,1,8510,13148,6030,4638,PERF
42127339660000,PI,IP,001,1,7644,13843,6590,6199,PERF
42127339680000,PI,IP,001,1,9082,15124,7395,6042,PERF
42127339700000,PI,IP,001,1,7016,7207,5976,191,PERF
42127339700000,PI,IP,001,2,7337,7528,5976,191,PERF
42127339700000,PI,IP,001,3,7658,7849,5976,191,PERF
42127339700000,PI,IP,001,4,7979,8170,5976,191,PERF
42127339700000,PI,IP,001,5,8300,8491,5976,191,PERF
42127339700000,PI,IP,001,6,8621,8816,5976,195,PERF
42127339700000,PI,IP,001,7,8939,9133,5976,194,PERF
42127339700000,PI,IP,001,8,9263,9454,5976,191,PERF
42127339700000,PI,IP,001,9,9584,9775,5976,191,PERF
42127339700000,PI,IP,001,10,9905,10096,5976,191,PERF
42127339700000,PI,IP,001,11,10226,10417,5976,191,PERF
42127339700000,PI,IP,001,12,10547,10738,5976,191,PERF
42127339700000,PI,IP,001,13,10868,11057,5976,189,PERF
42127339700000,PI,IP,001,14,11189,11380,5976,191,PERF
42127339700000,PI,IP,001,15,11575,11786,5976,211,PERF
42127339700000,PI,IP,001,16,11896,12087,5976,191,PERF
42127339710000,PI,IP,001,1,6945,12740,6494,5795,PERF
42127339720000,PI,IP,001,1,6717,14538,6846,7821,PERF
42127339730000,PI,IP,001,1,6556,13947,8428,7391,PERF
42127339740000,PI,IP,001,1,7558,13694,6476,6136,PERF
42127339760000,PI,IP,001,1,7829,12700,5155,4871,PERF
42127339770000,PI,IP,001,1,8085,12995,5978,4910,PERF
42127339780000,PI,IP,001,1,8067,12882,6042,4815,PERF
42127339790000,PI,IP,001,1,8589,13500,6092,4911,PERF
42127339800000,PI,IP,001,1,7258,15515,8661,8257,PERF
42127339810000,PI,IP,001,1,8292,8294,6289,2,PERF
42127339810000,PI,IP,001,2,8373,8375,6289,2,PERF
42127339810000,PI,IP,001,3,8460,8462,6289,2,PERF
42127339810000,PI,IP,001,4,8534,8536,6289,2,PERF
42127339810000,PI,IP,001,5,8614,8616,6289,2,PERF
42127339810000,PI,IP,001,6,8694,8696,6289,2,PERF
42127339810000,PI,IP,001,7,8778,8780,6289,2,PERF
42127339810000,PI,IP,001,8,8855,8857,6289,2,PERF
42127339810000,PI,IP,001,9,8935,8937,6289,2,PERF
42127339810000,PI,IP,001,10,9016,9018,6289,2,PERF
42127339810000,PI,IP,001,11,9096,9098,6289,2,PERF
42127339810000,PI,IP,001,12,9172,9174,6289,2,PERF
42127339810000,PI,IP,001,13,9257,9259,6289,2,PERF
42127339810000,PI,IP,001,14,9337,9339,6289,2,PERF
42127339810000,PI,IP,001,15,9417,9419,6289,2,PERF
42127339810000,PI,IP,001,16,9490,9492,6289,2,PERF
42127339810000,PI,IP,001,17,9578,9580,6289,2,PERF
42127339810000,PI,IP,001,18,9658,9660,6289,2,PERF
42127339810000,PI,IP,001,19,9738,9740,6289,2,PERF
42127339810000,PI,IP,001,20,9820,9822,6289,2,PERF
42127339810000,PI,IP,001,21,9899,9901,6289,2,PERF
42127339810000,PI,IP,001,22,9979,9981,6289,2,PERF
42127339810000,PI,IP,001,23,10059,10061,6289,2,PERF
42127339810000,PI,IP,001,24,10140,10142,6289,2,PERF
42127339810000,PI,IP,001,25,10218,10220,6289,2,PERF
42127339810000,PI,IP,001,26,10300,10302,6289,2,PERF
42127339810000,PI,IP,001,27,10381,10383,6289,2,PERF
42127339810000,PI,IP,001,28,10461,10463,6289,2,PERF
42127339810000,PI,IP,001,29,10536,10538,6289,2,PERF
42127339810000,PI,IP,001,30,10622,10624,6289,2,PERF
42127339810000,PI,IP,001,31,10702,10704,6289,2,PERF
42127339810000,PI,IP,001,32,10782,10784,6289,2,PERF
42127339810000,PI,IP,001,33,10867,10869,6289,2,PERF
42127339810000,PI,IP,001,34,10943,10945,6289,2,PERF
42127339810000,PI,IP,001,35,11023,11025,6289,2,PERF
42127339810000,PI,IP,001,36,11103,11105,6289,2,PERF
42127339810000,PI,IP,001,37,11184,11186,6289,2,PERF
42127339810000,PI,IP,001,38,11262,11264,6289,2,PERF
42127339810000,PI,IP,001,39,11344,11346,6289,2,PERF
42127339810000,PI,IP,001,40,11424,11426,6289,2,PERF
42127339810000,PI,IP,001,41,11505,11507,6289,2,PERF
42127339810000,PI,IP,001,42,11584,11586,6289,2,PERF
42127339810000,PI,IP,001,43,11665,11667,6289,2,PERF
42127339810000,PI,IP,001,44,11746,11748,6289,2,PERF
42127339810000,PI,IP,001,45,11826,11828,6289,2,PERF
42127339810000,PI,IP,001,46,11906,11908,6289,2,PERF
42127339810000,PI,IP,001,47,11987,11989,6289,2,PERF
42127339810000,PI,IP,001,48,12067,12069,6289,2,PERF
42127339810000,PI,IP,001,49,12147,12149,6289,2,PERF
42127339810000,PI,IP,001,50,12227,12229,6289,2,PERF
42127339810000,PI,IP,001,51,12308,12310,6289,2,PERF
42127339810000,PI,IP,001,52,12388,12390,6289,2,PERF
42127339820000,PI,IP,002,1,8257,13562,6052,5305,COMB
42127339820000,PI,PT,001,1,8257,8259,6052,2,PERF
42127339820000,PI,PT,001,2,8393,8395,6052,2,PERF
42127339820000,PI,PT,001,3,8483,8485,6052,2,PERF
42127339820000,PI,PT,001,4,8573,8575,6052,2,PERF
42127339820000,PI,PT,001,5,8663,8665,6052,2,PERF
42127339820000,PI,PT,001,6,8753,8755,6052,2,PERF
42127339820000,PI,PT,001,7,8843,8845,6052,2,PERF
42127339820000,PI,PT,001,8,8933,8935,6052,2,PERF
42127339820000,PI,PT,001,9,9023,9025,6052,2,PERF
42127339820000,PI,PT,001,10,9114,9116,6052,2,PERF
42127339820000,PI,PT,001,11,9204,9206,6052,2,PERF
42127339820000,PI,PT,001,12,9294,9296,6052,2,PERF
42127339820000,PI,PT,001,13,9384,9386,6052,2,PERF
42127339820000,PI,PT,001,14,9474,9476,6052,2,PERF
42127339820000,PI,PT,001,15,9564,9566,6052,2,PERF
42127339820000,PI,PT,001,16,9654,9656,6052,2,PERF
42127339820000,PI,PT,001,17,9744,9746,6052,2,PERF
42127339820000,PI,PT,001,18,9834,9836,6052,2,PERF
42127339820000,PI,PT,001,19,9924,9926,6052,2,PERF
42127339820000,PI,PT,001,20,10014,10016,6052,2,PERF
42127339820000,PI,PT,001,21,10104,10106,6052,2,PERF
42127339820000,PI,PT,001,22,10194,10196,6052,2,PERF
42127339820000,PI,PT,001,23,10284,10286,6052,2,PERF
42127339820000,PI,PT,001,24,10374,10376,6052,2,PERF
42127339820000,PI,PT,001,25,10464,10466,6052,2,PERF
42127339820000,PI,PT,001,26,10554,10556,6052,2,PERF
42127339820000,PI,PT,001,27,10644,10646,6052,2,PERF
42127339820000,PI,PT,001,28,10734,10736,6052,2,PERF
42127339820000,PI,PT,001,29,10825,10827,6052,2,PERF
42127339820000,PI,PT,001,30,10915,10917,6052,2,PERF
42127339820000,PI,PT,001,31,11005,11007,6052,2,PERF
42127339820000,PI,PT,001,32,11095,11097,6052,2,PERF
42127339820000,PI,PT,001,33,11185,11187,6052,2,PERF
42127339820000,PI,PT,001,34,11275,11277,6052,2,PERF
42127339820000,PI,PT,001,35,11365,11367,6052,2,PERF
42127339820000,PI,PT,001,36,11455,11457,6052,2,PERF
42127339820000,PI,PT,001,37,11548,11550,6052,2,PERF
42127339820000,PI,PT,001,38,11638,11640,6052,2,PERF
42127339820000,PI,PT,001,39,11728,11730,6052,2,PERF
42127339820000,PI,PT,001,40,11818,11820,6052,2,PERF
42127339820000,PI,PT,001,41,11908,11910,6052,2,PERF
42127339820000,PI,PT,001,42,11998,12000,6052,2,PERF
42127339820000,PI,PT,001,43,12080,12082,6052,2,PERF
42127339820000,PI,PT,001,44,12170,12172,6052,2,PERF
42127339820000,PI,PT,001,45,12262,12264,6052,2,PERF
42127339820000,PI,PT,001,46,12353,12355,6052,2,PERF
42127339820000,PI,PT,001,47,12444,12446,6052,2,PERF
42127339820000,PI,PT,001,48,12535,12537,6052,2,PERF
42127339820000,PI,PT,001,49,12626,12628,6052,2,PERF
42127339820000,PI,PT,001,50,12716,12718,6052,2,PERF
42127339820000,PI,PT,001,51,12806,12808,6052,2,PERF
42127339820000,PI,PT,001,52,12896,12898,6052,2,PERF
42127339820000,PI,PT,001,53,12986,12988,6052,2,PERF
42127339820000,PI,PT,001,54,13076,13078,6052,2,PERF
42127339820000,PI,PT,001,55,13166,13168,6052,2,PERF
42127339820000,PI,PT,001,56,13256,13258,6052,2,PERF
42127339820000,PI,PT,001,57,13335,13337,6052,2,PERF
42127339820000,PI,PT,001,58,13410,13412,6052,2,PERF
42127339820000,PI,PT,001,59,13485,13487,6052,2,OPENHOLE
42127339820000,PI,PT,001,60,13560,13562,6052,2,OPENHOLE
42127339830000,PI,IP,001,1,7965,13144,,5179,PERF
42127339840000,PI,IP,001,1,8793,13695,6079,4902,PERF
42127339850000,PI,IP,001,1,8758,13565,6043,4807,PERF
42127339860000,PI,IP,001,1,9080,13817,6129,4737,PERF
42127339870000,PI,IP,002,1,7123,15092,8367,7969,PERF
42127339870000,PI,PT,001,1,7123,15092,8367,7969,PERF
42127339880000,PI,IP,001,1,7516,14209,7065,6693,PERF
42127339890000,PI,IP,001,1,7645,14518,6808,6873,PERF
42127339900000,PI,PT,001,1,8547,13193,,4646,PERF
42127339910000,PI,IP,001,1,9065,13199,5961,4134,PERF
42127339950000,PI,IP,001,1,8833,14068,6738,5235,PERF
42127339960100,PI,IP,001,1,10354,14924,6218,4570,PERF
42127339970000,PI,IP,001,1,7611,7789,,178,PERF
42127339970000,PI,IP,001,2,7919,8097,,178,PERF
42127339970000,PI,IP,001,3,8227,8405,,178,PERF
42127339970000,PI,IP,001,4,8535,8713,,178,PERF
42127339970000,PI,IP,001,5,8843,9021,,178,PERF
42127339970000,PI,IP,001,6,9151,9329,,178,PERF
42127339970000,PI,IP,001,7,9459,9637,,178,PERF
42127339970000,PI,IP,001,8,9767,9945,,178,PERF
42127339970000,PI,IP,001,9,10075,10257,,182,PERF
42127339970000,PI,IP,001,10,10379,10557,,178,PERF
42127339970000,PI,IP,001,11,10691,10869,,178,PERF
42127339970000,PI,IP,001,12,10999,11177,,178,PERF
42127339970000,PI,IP,001,13,11307,11485,,178,PERF
42127339970000,PI,IP,001,14,11615,11793,,178,PERF
42127339970000,PI,IP,001,15,11923,12101,,178,PERF
42127339970000,PI,IP,001,16,12231,12405,,174,PERF
42127339980000,PI,IP,001,1,6734,12730,7128,5996,PERF
42127339990000,PI,IP,002,1,7292,12057,6211,4765,PERF
42127339990000,PI,PT,001,1,7292,12057,6211,4765,PERF
42127340010100,PI,IP,001,1,8626,13465,6176,4839,PERF
42127340100000,PI,IP,001,1,7661,7827,5474,166,PERF
42127340100000,PI,IP,001,2,7957,8128,5474,171,PERF
42127340100000,PI,IP,001,3,8253,8419,5474,166,PERF
42127340100000,PI,IP,001,4,8549,8715,5474,166,PERF
42127340100000,PI,IP,001,5,8845,9011,5474,166,PERF
42127340100000,PI,IP,001,6,9141,9303,5474,162,PERF
42127340100000,PI,IP,001,7,9437,9603,5474,166,PERF
42127340100000,PI,IP,001,8,9733,9899,5474,166,PERF
42127340100000,PI,IP,001,9,10029,10195,5474,166,PERF
42127340100000,PI,IP,001,10,10325,10491,5474,166,PERF
42127340100000,PI,IP,001,11,10621,10787,5474,166,PERF
42127340100000,PI,IP,001,12,10917,11081,5474,164,PERF
42127340100000,PI,IP,001,13,11213,11379,5474,166,PERF
42127340100000,PI,IP,001,14,11509,11675,5474,166,PERF
42127340100000,PI,IP,001,15,11805,11971,5474,166,PERF
42127340100000,PI,IP,001,16,12135,12330,5474,195,PERF
42127340730000,PI,IP,001,1,8043,13105,5216,5062,PERF
42127340740000,PI,IP,002,1,7807,14940,,7133,PERF
42127340740000,PI,PT,001,1,7807,14940,,7133,PERF
42127340750000,PI,IP,001,1,6532,10545,5374,4013,PERF
42127340930000,PI,IP,001,1,7247,11927,5355,4680,PERF
42127340940000,PI,IP,001,1,6734,12670,6519,5936,PERF
42127340950000,PI,IP,001,1,8913,13798,6179,4885,PERF
42127340960000,PI,IP,001,1,8492,13503,6151,5011,PERF
42127340980000,PI,IP,001,1,8681,13303,5571,4622,PERF
42127341010000,PI,IP,001,1,8462,14025,6159,5563,PERF
42127341040000,PI,IP,001,1,7300,12468,6300,5168,PERF
42127341050000,PI,IP,002,1,7039,11330,,4291,PERF
42127341050000,PI,PT,001,1,7039,11330,,4291,PERF
42127341070000,PI,IP,002,1,8694,13860,6255,5166,PERF
42127341070000,PI,PT,001,1,8694,13857,6255,5163,PERF
42127341070000,PI,PT,001,2,13857,13860,6255,3,PERF
42127341080000,PI,IP,001,1,8509,13617,6541,5108,PERF
42127341090000,PI,IP,001,1,8890,13890,6956,5000,PERF
42127341100000,PI,IP,001,1,8658,13501,6262,4843,PERF
42127341110000,PI,IP,001,1,8941,13594,6095,4653,PERF
42127341120000,PI,IP,001,1,6830,7199,4612,369,PERF
42127341120000,PI,IP,001,2,7329,7698,4612,369,PERF
42127341120000,PI,IP,001,3,7828,8197,4612,369,PERF
42127341120000,PI,IP,001,4,8327,8696,4612,369,PERF
42127341120000,PI,IP,001,5,8824,9130,4612,306,PERF
42127341130000,PI,IP,001,1,9169,14508,,5339,PERF
42127341140000,PI,IP,001,1,8485,13824,6149,5339,PERF
42127341150000,PI,IP,001,1,8708,13728,6166,5020,PERF
42127341160000,PI,IP,002,1,8683,13117,5629,4434,PERF
42127341160000,PI,PT,001,1,8683,13117,5629,4434,PERF
42127341170000,PI,IP,002,1,9325,13837,6033,4512,PERF
42127341170000,PI,PT,001,1,9325,13837,6033,4512,PERF
42127341180000,PI,IP,001,1,9030,13362,5642,4332,PERF
42127341280000,PI,IP,001,1,8507,13537,6078,5030,PERF
42127341290000,PI,IP,001,1,8120,13151,6040,5031,PERF
42127341300000,PI,IP,001,1,8651,13458,6035,4807,PERF
42127341310000,PI,IP,001,1,6800,7021,6898,221,PERF
42127341310000,PI,IP,001,2,7131,7352,6898,221,PERF
42127341310000,PI,IP,001,3,7455,7683,6898,228,PERF
42127341310000,PI,IP,001,4,7793,8018,6898,225,PERF
42127341310000,PI,IP,001,5,8124,8345,6898,221,PERF
42127341310000,PI,IP,001,6,8455,8676,6898,221,PERF
42127341310000,PI,IP,001,7,8786,9007,6898,221,PERF
42127341310000,PI,IP,001,8,9112,9338,6898,226,PERF
42127341310000,PI,IP,001,9,9448,9669,6898,221,PERF
42127341310000,PI,IP,001,10,9779,10000,6898,221,PERF
42127341310000,PI,IP,001,11,10110,10331,6898,221,PERF
42127341310000,PI,IP,001,12,10441,10558,6898,117,PERF
42127341310000,PI,IP,001,13,10772,10993,6898,221,PERF
42127341310000,PI,IP,001,14,11103,11324,6898,221,PERF
42127341310000,PI,IP,001,15,11434,11655,6898,221,PERF
42127341330000,PI,IP,001,1,8375,12949,6072,4574,PERF
42127341340000,PI,IP,001,1,8115,12686,6008,4571,PERF
42127341350000,PI,IP,001,1,8440,13036,6153,4596,PERF
42127341360000,PI,IP,001,1,7960,12558,6026,4598,PERF
42127341370000,PI,IP,001,1,8041,12663,6016,4622,PERF
42127341400000,PI,IP,001,1,6530,6754,5886,224,PERF
42127341400000,PI,IP,001,2,6864,7088,5886,224,PERF
42127341400000,PI,IP,001,3,7198,7422,5886,224,PERF
42127341400000,PI,IP,001,4,7532,7756,5886,224,PERF
42127341400000,PI,IP,001,5,7866,8090,5886,224,PERF
42127341400000,PI,IP,001,6,8200,8424,5886,224,PERF
42127341400000,PI,IP,001,7,8534,8758,5886,224,PERF
42127341400000,PI,IP,001,8,8868,9092,5886,224,PERF
42127341400000,PI,IP,001,9,9202,9426,5886,224,PERF
42127341400000,PI,IP,001,10,9540,9765,5886,225,PERF
42127341400000,PI,IP,001,11,9870,10094,5886,224,PERF
42127341400000,PI,IP,001,12,10204,10428,5886,224,PERF
42127341400000,PI,IP,001,13,10538,10762,5886,224,PERF
42127341400000,PI,IP,001,14,10872,11096,5886,224,PERF
42127341400000,PI,IP,001,15,11206,11430,5886,224,PERF
42127341420000,PI,IP,001,1,7503,7734,6085,231,PERF
42127341420000,PI,IP,001,2,7837,8068,6085,231,PERF
42127341420000,PI,IP,001,3,8171,8405,6085,234,PERF
42127341420000,PI,IP,001,4,8505,8739,6085,234,PERF
42127341420000,PI,IP,001,5,8839,9073,6085,234,PERF
42127341420000,PI,IP,001,6,9173,9402,6085,229,PERF
42127341420000,PI,IP,001,7,9507,9741,6085,234,PERF
42127341420000,PI,IP,001,8,9841,10075,6085,234,PERF
42127341420000,PI,IP,001,9,10175,10409,6085,234,PERF
42127341420000,PI,IP,001,10,10509,10743,6085,234,PERF
42127341420000,PI,IP,001,11,10846,11077,6085,231,PERF
42127341420000,PI,IP,001,12,11180,11411,6085,231,PERF
42127341420000,PI,IP,001,13,11697,11923,6085,226,PERF
42127341420000,PI,IP,001,14,12043,12269,6085,226,PERF
42127341420000,PI,IP,001,15,12389,12615,6085,226,PERF
42127341430000,PI,IP,001,1,7587,13828,6616,6241,PERF
42127341440000,PI,IP,001,1,8511,12380,5160,3869,PERF
42127341450000,PI,IP,001,1,8036,12993,5818,4957,PERF
42127341460000,PI,IP,001,1,7560,13825,6414,6265,PERF
42127341470000,PI,IP,001,1,7950,14388,,6438,PERF
42127341480000,PI,IP,001,1,7965,14277,7192,6312,PERF
42127341490000,PI,IP,001,1,6823,14466,7387,7643,PERF
42127341500000,PI,IP,002,1,8953,13770,6446,4817,PERF
42127341500000,PI,PT,001,1,8953,13770,6446,4817,PERF
42127341510000,PI,IP,001,1,8640,13659,6179,5019,PERF
42127341520000,PI,IP,001,1,8816,13704,6193,4888,PERF
42127341530000,PI,IP,001,1,8726,12971,6278,4245,PERF
42127341550000,PI,IP,001,1,8600,13241,6092,4641,PERF
42127341560000,PI,IP,001,1,8160,13001,6035,4841,PERF
42127341570000,PI,IP,001,1,8581,13309,6101,4728,PERF
42127341580000,PI,IP,001,1,8555,13779,6084,5224,PERF
42127341590000,PI,IP,001,1,7455,7666,,211,PERF
42127341590000,PI,IP,001,2,7776,7987,,211,PERF
42127341590000,PI,IP,001,3,8097,8308,,211,PERF
42127341590000,PI,IP,001,4,8418,8633,,215,PERF
42127341590000,PI,IP,001,5,8739,8950,,211,PERF
42127341590000,PI,IP,001,6,9056,9271,,215,PERF
42127341590000,PI,IP,001,7,9381,9592,,211,PERF
42127341590000,PI,IP,001,8,9702,9913,,211,PERF
42127341590000,PI,IP,001,9,10023,10234,,211,PERF
42127341590000,PI,IP,001,10,10344,10346,,2,PERF
42127341590000,PI,IP,001,11,10456,10706,,250,PERF
42127341590000,PI,IP,001,12,10936,11147,,211,PERF
42127341590000,PI,IP,001,13,11257,11468,,211,PERF
42127341590000,PI,IP,001,14,11578,11789,,211,PERF
42127341600000,PI,IP,001,1,6403,12535,6318,6132,PERF
42127341610000,PI,IP,001,1,8882,13420,5914,4538,PERF
42127341620000,PI,IP,001,1,9658,13802,5901,4144,PERF
42127341630000,PI,IP,001,1,6763,12680,6274,5917,PERF
42127341640000,PI,IP,001,1,7550,12101,5048,4551,PERF
42127341650000,PI,IP,001,1,7467,7700,6100,233,PERF
42127341650000,PI,IP,001,2,7814,8047,6100,233,PERF
42127341650000,PI,IP,001,3,8163,8394,6100,231,PERF
42127341650000,PI,IP,001,4,8508,8741,6100,233,PERF
42127341650000,PI,IP,001,5,8855,9088,6100,233,PERF
42127341650000,PI,IP,001,6,9202,9435,6100,233,PERF
42127341650000,PI,IP,001,7,9552,9782,6100,230,PERF
42127341650000,PI,IP,001,8,9896,10129,6100,233,PERF
42127341650000,PI,IP,001,9,10240,10476,6100,236,PERF
42127341650000,PI,IP,001,10,10595,10820,6100,225,PERF
42127341650000,PI,IP,001,11,10930,11152,6100,222,PERF
42127341650000,PI,IP,001,12,11921,12150,6100,229,PERF
42127341650000,PI,IP,001,13,12264,12493,6100,229,PERF
42127341660000,PI,IP,001,1,7942,13191,6263,5249,PERF
42127341670000,PI,IP,001,1,8047,13090,6156,5043,PERF
42127341680000,PI,IP,001,1,6739,13870,7460,7131,PERF
42127341690000,PI,IP,001,1,8068,13041,6063,4973,PERF
42127341700000,PI,IP,001,1,7983,13178,6306,5195,PERF
42127341710000,PI,IP,001,1,8092,13184,6207,5092,PERF
42127341720000,PI,IP,001,1,7831,13114,6121,5283,PERF
42127341730000,PI,IP,001,1,7335,7539,,204,PERF
42127341730000,PI,IP,001,2,7649,7853,,204,PERF
42127341730000,PI,IP,001,3,7963,8167,,204,PERF
42127341730000,PI,IP,001,4,8277,8481,,204,PERF
42127341730000,PI,IP,001,5,8591,8795,,204,PERF
42127341730000,PI,IP,001,6,8905,9109,,204,PERF
42127341730000,PI,IP,001,7,9219,9423,,204,PERF
42127341730000,PI,IP,001,8,9529,9733,,204,PERF
42127341730000,PI,IP,001,9,9847,10051,,204,PERF
42127341730000,PI,IP,001,10,10161,10365,,204,PERF
42127341730000,PI,IP,001,11,10475,10679,,204,PERF
42127341730000,PI,IP,001,12,10737,10844,,107,PERF
42127341730000,PI,IP,001,13,10951,11155,,204,PERF
42127341730000,PI,IP,001,14,11265,11469,,204,PERF
42127341740000,PI,IP,001,1,8144,14314,7429,6170,PERF
42127341750000,PI,IP,001,1,7982,14370,7379,6388,PERF
42127341760000,PI,IP,001,1,8627,14813,7496,6186,PERF
42127341770000,PI,IP,001,1,7500,12051,5051,4551,PERF
42127341780000,PI,IP,001,1,6594,12169,,5575,PERF
42127341810000,PI,IP,001,1,8951,13695,6102,4744,PERF
42127341820000,PI,IP,001,1,8686,13447,6052,4761,PERF
42127341830000,PI,IP,001,1,8410,13593,6028,5183,PERF
42127341840000,PI,IP,001,1,8556,13684,6049,5128,PERF
42127341850000,PI,IP,001,1,8915,13699,6119,4784,PERF
42127341850000,PI,IP,001,2,13758,13820,6119,62,PERF
42127341860000,PI,IP,001,1,6908,13130,,6222,PERF
42127341870000,PI,IP,001,1,6678,13315,6800,6637,PERF
42127341880000,PI,IP,001,1,7113,13634,6709,6521,PERF
42127341890000,PI,IP,001,1,7740,13551,,5811,PERF
42127341900000,PI,IP,001,1,7133,13554,,6421,PERF
42127341910000,PI,IP,001,1,6549,12329,6113,5780,PERF
42127341920000,PI,IP,001,1,6771,13654,,6883,PERF
42127341930000,PI,IP,001,1,8796,13725,6040,4929,PERF
42127341940000,PI,IP,001,1,8546,13558,6008,5012,PERF
42127341950000,PI,IP,001,1,8711,12329,4809,3618,PERF
42127341960000,PI,IP,001,1,8921,14058,5991,5137,PERF
42127341970000,PI,IP,001,1,8141,12455,5587,4314,PERF
42127341980000,PI,IP,001,1,8276,12562,4936,4286,PERF
42127341990000,PI,IP,001,1,8277,13036,5644,4759,PERF
42127342000000,PI,IP,001,1,8320,12674,5078,4354,PERF
42127342010000,PI,IP,001,1,6980,13095,6061,6115,PERF
42127342020100,PI,IP,001,1,7643,14275,,6632,PERF
42127342040000,PI,IP,001,1,7518,11436,5422,3918,PERF
42127342050000,PI,IP,001,1,6852,10515,3936,3663,PERF
42127342060000,PI,IP,001,1,8148,13147,6130,4999,PERF
42127342070000,PI,IP,001,1,7564,14194,7037,6630,PERF
42127342080000,PI,IP,001,1,7920,13066,6072,5146,PERF
42127342090000,PI,IP,001,1,8222,13061,6107,4839,PERF
42127342100000,PI,IP,001,1,6502,14185,8158,7683,PERF
42127342110000,PI,IP,001,1,9250,13346,6107,4096,PERF
42127342120000,PI,IP,001,1,7812,15143,7503,7331,PERF
42127342140000,PI,IP,001,1,8854,13321,6002,4467,PERF
42127342150000,PI,IP,001,1,8758,13439,6001,4681,PERF
42127342160000,PI,IP,001,1,7285,12414,6332,5129,PERF
42127342170000,PI,IP,001,1,8803,13494,6046,4691,PERF
42127342180000,PI,IP,001,1,8980,13661,6131,4681,PERF
42127342190000,PI,IP,001,1,6788,14214,,7426,PERF
42127342200000,PI,IP,001,1,7566,12147,4809,4581,PERF
42127342210000,PI,IP,001,1,8037,11344,4517,3307,PERF
42127342220000,PI,IP,001,1,8193,11543,4465,3350,PERF
42127342230000,PI,IP,001,1,8047,11321,4485,3274,PERF
42127342250000,PI,IP,001,1,7763,13250,5712,5487,PERF
42127342260000,PI,IP,001,1,8076,13052,6003,4976,PERF
42127342270000,PI,IP,001,1,8460,13538,5833,5078,PERF
42127342280000,PI,IP,001,1,8028,13165,6006,5137,PERF
42127342290000,PI,IP,001,1,8016,13161,6026,5145,PERF
42127342300000,PI,IP,001,1,8176,13250,6051,5074,PERF
42127342310000,PI,IP,001,1,8094,12911,6054,4817,PERF
42127342320000,PI,IP,001,1,7812,14050,7128,6238,PERF
42127342330000,PI,IP,001,1,7967,13472,6488,5505,PERF
42127342340000,PI,IP,001,1,8066,13441,6484,5375,PERF
42127342350000,PI,IP,001,1,7985,13413,6480,5428,PERF
42127342360000,PI,IP,001,1,7989,13574,6069,5585,PERF
42127342420000,PI,IP,001,1,7656,14292,6893,6636,PERF
42127342430000,PI,IP,001,1,7036,13975,7157,6939,PERF
42127342440000,PI,IP,001,1,7145,14241,,7096,PERF
42127342450000,PI,IP,001,1,6579,12386,,5807,PERF
42127342460000,PI,IP,001,1,6665,12321,5982,5656,PERF
42127342470000,PI,IP,001,1,7965,14393,,6428,PERF
42127342480000,PI,IP,001,1,7897,12833,5874,4936,PERF
42127342490000,PI,IP,001,1,7748,12278,5621,4530,PERF
42127342510000,PI,IP,001,1,7877,12354,5629,4477,PERF
42127342520000,PI,IP,001,1,7999,13082,6198,5083,PERF
42127342540000,PI,IP,001,1,7660,12156,5119,4496,PERF
42127342550000,PI,IP,001,1,7972,13725,6140,5753,PERF
42127342560000,PI,IP,001,1,7957,13600,6064,5643,PERF
42127342570000,PI,IP,001,1,8020,13712,6149,5692,PERF
42127342590000,PI,IP,001,1,8466,13986,6520,5520,PERF
42127342600000,PI,IP,001,1,8846,13888,6515,5042,PERF
42127342610000,PI,IP,001,1,8554,14005,6467,5451,PERF
42127342620000,PI,IP,001,1,7520,16480,9296,8960,PERF
42127342630000,PI,IP,001,1,7625,15220,7739,7595,PERF
42127342670000,PI,IP,001,1,7562,14573,7454,7011,PERF
42127342680000,PI,IP,001,1,6767,13998,8125,7231,PERF
42127342690000,PI,IP,001,1,7691,13992,6742,6301,PERF
42127342700000,PI,IP,001,1,7792,14342,,6550,PERF
42127342710000,PI,IP,001,1,6549,11743,5719,5194,PERF
42127342730000,PI,IP,001,1,9213,13866,5753,4653,PERF
42127342740000,PI,IP,001,1,8581,13617,5835,5036,PERF
42127342750000,PI,IP,001,1,8513,14032,5803,5519,PERF
42127342760000,PI,IP,001,1,8790,13607,5931,4817,PERF
42127342780000,PI,IP,001,1,7104,14236,7608,7132,PERF
42127342800000,PI,IP,001,1,8059,14399,,6340,PERF
42127342810000,PI,IP,001,1,8344,16860,8825,8516,PERF
42127342830000,PI,IP,001,1,7251,11576,4803,4325,PERF
42127342840000,PI,IP,001,1,8160,8428,5607,268,PERF
42127342840000,PI,IP,001,2,8495,8756,5607,261,PERF
42127342840000,PI,IP,001,3,8825,9086,5607,261,PERF
42127342840000,PI,IP,001,4,9155,9426,5607,271,PERF
42127342840000,PI,IP,001,5,9490,9746,5607,256,PERF
42127342840000,PI,IP,001,6,9810,10066,5607,256,PERF
42127342840000,PI,IP,001,7,10130,10377,5607,247,PERF
42127342840000,PI,IP,001,8,10441,10692,5607,251,PERF
42127342840000,PI,IP,001,9,10756,10997,5607,241,PERF
42127342840000,PI,IP,001,10,11061,11317,5607,256,PERF
42127342840000,PI,IP,001,11,11381,11622,5607,241,PERF
42127342840000,PI,IP,001,12,11681,11922,5607,241,PERF
42127342840000,PI,IP,001,13,11986,12227,5607,241,PERF
42127342840000,PI,IP,001,14,12286,12531,5607,245,PERF
42127342840000,PI,IP,001,15,12590,12831,5607,241,PERF
42127342840000,PI,IP,001,16,12890,13131,5607,241,PERF
42127342840000,PI,IP,001,17,13190,13434,5607,244,PERF
42127342850000,PI,IP,001,1,8148,8439,6183,291,PERF
42127342850000,PI,IP,001,2,8513,8769,6183,256,PERF
42127342850000,PI,IP,001,3,8843,9094,6183,251,PERF
42127342850000,PI,IP,001,4,9168,9414,6183,246,PERF
42127342850000,PI,IP,001,5,9488,9729,6183,241,PERF
42127342850000,PI,IP,001,6,9803,10044,6183,241,PERF
42127342850000,PI,IP,001,7,10115,10356,6183,241,PERF
42127342850000,PI,IP,001,8,10430,10671,6183,241,PERF
42127342850000,PI,IP,001,9,10745,11001,6183,256,PERF
42127342850000,PI,IP,001,10,11065,11316,6183,251,PERF
42127342850000,PI,IP,001,11,11380,11626,6183,246,PERF
42127342850000,PI,IP,001,12,11690,11931,6183,241,PERF
42127342850000,PI,IP,001,13,11995,12241,6183,246,PERF
42127342850000,PI,IP,001,14,12300,12541,6183,241,PERF
42127342850000,PI,IP,001,15,12600,12841,6183,241,PERF
42127342850000,PI,IP,001,16,12900,13141,6183,241,PERF
42127342850000,PI,IP,001,17,13200,13446,6183,246,PERF
42127342860000,PI,IP,001,1,8191,8517,5874,326,PERF
42127342860000,PI,IP,001,2,8596,8862,5874,266,PERF
42127342860000,PI,IP,001,3,8936,9207,5874,271,PERF
42127342860000,PI,IP,001,4,9278,9519,5874,241,PERF
42127342860000,PI,IP,001,5,9593,9834,5874,241,PERF
42127342860000,PI,IP,001,6,9905,10146,5874,241,PERF
42127342860000,PI,IP,001,7,10215,10461,5874,246,PERF
42127342860000,PI,IP,001,8,10532,10788,5874,256,PERF
42127342860000,PI,IP,001,9,10852,11103,5874,251,PERF
42127342860000,PI,IP,001,10,11167,11413,5874,246,PERF
42127342860000,PI,IP,001,11,11477,11728,5874,251,PERF
42127342860000,PI,IP,001,12,11792,12033,5874,241,PERF
42127342860000,PI,IP,001,13,12092,12341,5874,249,PERF
42127342860000,PI,IP,001,14,12400,12641,5874,241,PERF
42127342860000,PI,IP,001,15,12700,12941,5874,241,PERF
42127342860000,PI,IP,001,16,13000,13246,5874,246,PERF
42127342900000,PI,IP,001,1,7119,14440,,7321,PERF
42127342910000,PI,IP,001,1,7621,15113,7718,7492,PERF
42127342930000,PI,IP,001,1,7050,7202,5752,152,PERF
42127342930000,PI,IP,001,2,7470,7696,5752,226,PERF
42127342930000,PI,IP,001,3,7812,8030,5752,218,PERF
42127342930000,PI,IP,001,4,8144,8350,5752,206,PERF
42127342930000,PI,IP,001,5,8480,8698,5752,218,PERF
42127342930000,PI,IP,001,6,8814,9034,5752,220,PERF
42127342930000,PI,IP,001,7,9146,9352,5752,206,PERF
42127342930000,PI,IP,001,8,9410,9628,5752,218,PERF
42127342930000,PI,IP,001,9,9744,9958,5752,214,PERF
42127342930000,PI,IP,001,10,10076,10296,5752,220,PERF
42127342930000,PI,IP,001,11,10416,10630,5752,214,PERF
42127342930000,PI,IP,001,12,10746,10964,5752,218,PERF
42127342930000,PI,IP,001,13,11080,11298,5752,218,PERF
42127342930000,PI,IP,001,14,11414,11632,5752,218,PERF
42127342950000,PI,IP,001,1,8045,8047,6056,2,PERF
42127342950000,PI,IP,001,2,8132,8134,6056,2,PERF
42127342950000,PI,IP,001,3,8219,8221,6056,2,PERF
42127342950000,PI,IP,001,4,8306,8308,6056,2,PERF
42127342950000,PI,IP,001,5,8399,8401,6056,2,PERF
42127342950000,PI,IP,001,6,8486,8488,6056,2,PERF
42127342950000,PI,IP,001,7,8573,8575,6056,2,PERF
42127342950000,PI,IP,001,8,8660,8662,6056,2,PERF
42127342950000,PI,IP,001,9,8753,8755,6056,2,PERF
42127342950000,PI,IP,001,10,8840,8842,6056,2,PERF
42127342950000,PI,IP,001,11,8927,8929,6056,2,PERF
42127342950000,PI,IP,001,12,9014,9016,6056,2,PERF
42127342950000,PI,IP,001,13,9107,9109,6056,2,PERF
42127342950000,PI,IP,001,14,9194,9196,6056,2,PERF
42127342950000,PI,IP,001,15,9281,9283,6056,2,PERF
42127342950000,PI,IP,001,16,9368,9370,6056,2,PERF
42127342950000,PI,IP,001,17,9461,9463,6056,2,PERF
42127342950000,PI,IP,001,18,9548,9550,6056,2,PERF
42127342950000,PI,IP,001,19,9635,9637,6056,2,PERF
42127342950000,PI,IP,001,20,9722,9724,6056,2,PERF
42127342950000,PI,IP,001,21,9815,9817,6056,2,PERF
42127342950000,PI,IP,001,22,9902,9904,6056,2,PERF
42127342950000,PI,IP,001,23,9989,9991,6056,2,PERF
42127342950000,PI,IP,001,24,10076,10078,6056,2,PERF
42127342950000,PI,IP,001,25,10169,10171,6056,2,PERF
42127342950000,PI,IP,001,26,10256,10258,6056,2,PERF
42127342950000,PI,IP,001,27,10343,10345,6056,2,PERF
42127342950000,PI,IP,001,28,10430,10432,6056,2,PERF
42127342950000,PI,IP,001,29,10523,10525,6056,2,PERF
42127342950000,PI,IP,001,30,10610,10612,6056,2,PERF
42127342950000,PI,IP,001,31,10697,10699,6056,2,PERF
42127342950000,PI,IP,001,32,10784,10786,6056,2,PERF
42127342950000,PI,IP,001,33,10877,10879,6056,2,PERF
42127342950000,PI,IP,001,34,10964,10966,6056,2,PERF
42127342950000,PI,IP,001,35,11052,11054,6056,2,PERF
42127342950000,PI,IP,001,36,11142,11144,6056,2,PERF
42127342950000,PI,IP,001,37,11231,11233,6056,2,PERF
42127342950000,PI,IP,001,38,11320,11322,6056,2,PERF
42127342950000,PI,IP,001,39,11409,11411,6056,2,PERF
42127342950000,PI,IP,001,40,11488,11490,6056,2,PERF
42127342950000,PI,IP,001,41,11582,11584,6056,2,PERF
42127342950000,PI,IP,001,42,11660,11662,6056,2,PERF
42127342950000,PI,IP,001,43,11663,11665,6056,2,PERF
42127342950000,PI,IP,001,44,11751,11753,6056,2,PERF
42127342950000,PI,IP,001,45,11934,11936,6056,2,PERF
42127342950000,PI,IP,001,46,12022,12024,6056,2,PERF
42127342950000,PI,IP,001,47,12113,12115,6056,2,PERF
42127342950000,PI,IP,001,48,12200,12202,6056,2,PERF
42127342950000,PI,IP,001,49,12290,12292,6056,2,PERF
42127342950000,PI,IP,001,50,12380,12382,6056,2,PERF
42127342950000,PI,IP,001,51,12467,12469,6056,2,PERF
42127342950000,PI,IP,001,52,12554,12556,6056,2,PERF
42127342950000,PI,IP,001,53,12647,12649,6056,2,PERF
42127342950000,PI,IP,001,54,12734,12736,6056,2,PERF
42127342950000,PI,IP,001,55,12821,12883,6056,62,PERF
42127342950000,PI,IP,001,56,12908,12910,6056,2,PERF
42127342950000,PI,IP,001,57,13000,13002,6056,2,PERF
42127342950000,PI,IP,001,58,13080,13082,6056,2,PERF
42127342950000,PI,IP,001,59,13160,13162,6056,2,PERF
42127342950000,PI,IP,001,60,13240,13242,6056,2,PERF
42127342960000,PI,IP,001,1,6441,11871,,5430,PERF
42127342970000,PI,IP,001,1,8481,14734,7187,6253,PERF
42127342980000,PI,IP,001,1,6688,14554,8019,7866,PERF
42127342990000,PI,IP,001,1,8278,14526,6999,6248,PERF
42127343000000,PI,IP,001,1,8416,14400,6863,5984,PERF
42127343010000,PI,IP,001,1,8184,14305,6817,6121,PERF
42127343020000,PI,IP,001,1,8398,13775,6469,5377,PERF
42127343030000,PI,IP,001,1,8103,13500,6015,5397,PERF
42127343040000,PI,IP,001,1,8143,13466,5586,5323,PERF
42127343050000,PI,IP,001,1,8288,13919,6164,5631,PERF
42127343060000,PI,IP,001,1,8262,13659,6192,5397,PERF
42127343070000,PI,IP,001,1,6849,11950,5737,5101,PERF
42127343080000,PI,IP,001,1,7220,15369,8526,8149,PERF
42127343090000,PI,IP,001,1,9028,11670,5203,2642,PERF
42127343100000,PI,IP,001,1,9061,11449,5154,2388,PERF
42127343110000,PI,IP,001,1,8768,11750,5151,2982,PERF
42127343120000,PI,IP,001,1,8335,13086,6269,4751,PERF
42127343130000,PI,IP,001,1,8902,11917,5165,3015,PERF
42127343140000,PI,IP,001,1,8140,13123,6434,4983,PERF
42127343150000,PI,IP,001,1,8552,13358,6013,4806,PERF
42127343160000,PI,IP,001,1,8533,13335,5992,4802,PERF
42127343170000,PI,IP,001,1,8448,13284,5974,4836,PERF
42127343180000,PI,IP,001,1,8335,13419,6089,5084,PERF
42127343190000,PI,IP,001,1,8319,13403,6076,5084,PERF
42127343200000,PI,IP,001,1,8426,13556,6079,5130,PERF
42127343210000,PI,IP,001,1,6558,13054,8022,6496,PERF
42127343220000,PI,IP,001,1,7064,14837,8084,7773,PERF
42127343230000,PI,IP,001,1,6350,12544,7176,6194,PERF
42127343240000,PI,IP,001,1,7878,13813,6416,5935,PERF
42127343250000,PI,IP,001,1,7945,13540,5400,5595,PERF
42127343260000,PI,IP,001,1,7110,13794,7465,6684,PERF
42127343270000,PI,IP,001,1,7023,14319,7439,7296,PERF
42127343280000,PI,IP,001,1,8745,13299,5953,4554,PERF
42127343290000,PI,IP,001,1,8752,13321,5972,4569,PERF
42127343300000,PI,IP,001,1,8559,13417,5981,4858,PERF
42127343310000,PI,IP,001,1,9182,14018,6213,4836,PERF
42127343340000,PI,IP,001,1,7047,11839,4909,4792,PERF
42127343350000,PI,IP,001,1,8558,15306,8106,6748,PERF
42127343370000,PI,IP,001,1,8616,15378,8106,6762,PERF
42127343380000,PI,IP,001,1,8760,14359,7507,5599,PERF
42127343390000,PI,IP,001,1,8669,14868,7491,6199,PERF
42127343400000,PI,IP,001,1,8528,14618,7506,6090,PERF
42127343410000,PI,IP,001,1,7520,13339,6086,5819,PERF
42127343420000,PI,IP,001,1,8549,13055,5206,4506,PERF
42127343430000,PI,IP,001,1,8092,12156,5023,4064,PERF
42127343440000,PI,IP,001,1,8160,12032,5013,3872,PERF
42127343450000,PI,IP,001,1,7641,12247,4952,4606,PERF
42127343460000,PI,IP,001,1,8476,13706,5751,5230,PERF
42127343480000,PI,IP,001,1,8327,12842,4916,4515,PERF
42127343490000,PI,IP,001,1,8375,13495,,5120,PERF
42127343500000,PI,IP,001,1,8495,14053,,5558,PERF
42127343530000,PI,IP,001,1,7635,12890,,5255,PERF
42127343540000,PI,IP,001,1,7703,12158,4894,4455,PERF
42127343550000,PI,IP,001,1,7572,12173,4910,4601,PERF
42127343560000,PI,IP,001,1,8287,11680,3685,3393,PERF
42127343570000,PI,IP,001,1,8361,12119,4264,3758,PERF
42127343580000,PI,IP,001,1,7710,13025,5741,5315,PERF
42127343590000,PI,IP,001,1,7636,12693,5689,5057,PERF
42127343610000,PI,IP,001,1,8247,12858,4748,4611,PERF
42127343630000,PI,IP,001,1,8388,14106,6795,5718,PERF
42127343640000,PI,IP,001,1,8496,14061,6902,5565,PERF
42127343650000,PI,IP,001,1,8480,14426,7014,5946,PERF
42127343660000,PI,IP,001,1,8316,14333,7226,6017,PERF
42127343670000,PI,IP,001,1,8298,14391,7330,6093,PERF
42127343680000,PI,IP,001,1,8215,14471,7465,6256,PERF
42127343690000,PI,IP,001,1,8593,13309,6015,4716,PERF
42127343700000,PI,IP,001,1,8473,13215,5996,4742,PERF
42127343710000,PI,IP,001,1,8450,13188,5991,4738,PERF
42127343740000,PI,IP,001,1,7840,13645,6000,5805,PERF
42127343750000,PI,IP,001,1,8149,12079,5034,3930,PERF
42127343760000,PI,IP,001,1,8001,12177,5207,4176,PERF
42127343770000,PI,IP,001,1,7957,12113,5212,4156,PERF
42127343780000,PI,IP,001,1,8000,12182,5099,4182,PERF
42127343790000,PI,IP,001,1,7177,12076,5001,4899,PERF
42127343830000,PI,PT,001,1,8650,13422,,4772,PERF
42127343840000,PI,IP,001,1,8358,13400,6003,5042,PERF
42127343850000,PI,IP,001,1,8756,13406,6043,4650,PERF
42127343860000,PI,PT,001,1,9098,13402,,4304,PERF
42127343870000,PI,IP,001,1,7122,11740,6027,4618,PERF
42127343880000,PI,IP,001,1,8460,14544,7347,6084,PERF
42127343890000,PI,IP,001,1,8514,14626,7329,6112,PERF
42127343900000,PI,IP,001,1,9070,14309,7326,5239,PERF
42127343950000,PI,IP,001,1,8142,12111,5089,3969,PERF
42127343970000,PI,IP,001,1,7719,12212,4996,4493,PERF
42127343980000,PI,IP,001,1,7749,12228,4992,4479,PERF
42127343990000,PI,IP,001,1,7596,12417,5028,4821,PERF
42127344000000,PI,IP,001,1,7719,15472,,7753,PERF
42127344010000,PI,IP,001,1,7665,15561,,7896,PERF
42127344020000,PI,IP,001,1,6952,11788,5868,4836,PERF
42127344030000,PI,IP,001,1,8127,11917,5072,3790,PERF
42127344050100,PI,IP,001,1,7781,12250,5059,4469,PERF
42127344070000,PI,IP,001,1,7047,7272,,225,PERF
42127344070000,PI,IP,001,2,7382,7607,,225,PERF
42127344070000,PI,IP,001,3,7717,7942,,225,PERF
42127344070000,PI,IP,001,4,8052,8277,,225,PERF
42127344070000,PI,IP,001,5,8387,8612,,225,PERF
42127344070000,PI,IP,001,6,8722,8947,,225,PERF
42127344070000,PI,IP,001,7,9057,9282,,225,PERF
42127344070000,PI,IP,001,8,9392,9617,,225,PERF
42127344070000,PI,IP,001,9,9727,9952,,225,PERF
42127344070000,PI,IP,001,10,10062,10287,,225,PERF
42127344070000,PI,IP,001,11,10397,10622,,225,PERF
42127344070000,PI,IP,001,12,10732,10957,,225,PERF
42127344070000,PI,IP,001,13,11067,11292,,225,PERF
42127344070000,PI,IP,001,14,11402,11624,,222,PERF
42127344080000,PI,PT,001,1,8431,13556,,5125,PERF
42127344100000,PI,PT,001,1,8276,13622,,5346,PERF
42127344110000,PI,IP,001,1,8318,12990,5230,4672,PERF
42127344120000,PI,IP,001,1,7579,12676,,5097,PERF
42127344130000,PI,IP,001,1,6745,12726,6121,5981,PERF
42127344200000,PI,IP,001,1,8272,14203,6826,5931,PERF
42127344220000,PI,IP,001,1,8111,14212,,6101,PERF
42127344230000,PI,IP,001,1,7013,11975,5501,4962,PERF
42127344240000,PI,IP,001,1,8310,13418,5496,5108,PERF
42127344250000,PI,IP,001,1,7870,12767,6757,4897,PERF
42127344260000,PI,IP,001,1,7829,12785,6764,4956,PERF
42127344270000,PI,IP,001,1,7746,13022,6169,5276,PERF
42127344280000,PI,IP,001,1,7723,13273,6158,5550,PERF
42127344290000,PI,IP,001,1,7703,12959,6112,5256,PERF
42127344300000,PI,IP,001,1,7698,13043,6095,5345,PERF
42127344320000,PI,IP,001,1,8578,15120,7925,6542,PERF
42127344330000,PI,IP,001,1,8559,15042,7926,6483,PERF
42127344340000,PI,IP,001,1,8694,15144,7938,6450,PERF
42127344360000,PI,IP,001,1,8470,15076,7933,6606,PERF
42127344370000,PI,IP,001,1,6914,14380,7598,7466,PERF
42127344380000,PI,IP,001,1,7073,11874,,4801,PERF
42127344390000,PI,IP,001,1,8740,15450,7997,6710,PERF
42127344400000,PI,IP,001,1,8776,15814,8025,7038,PERF
42127344410000,PI,IP,001,1,8717,15347,7811,6630,PERF
42127344420000,PI,IP,001,1,8464,14640,7764,6176,PERF
42127344430000,PI,IP,001,1,8527,15158,7806,6631,PERF
42127344440000,PI,IP,001,1,8710,14642,7764,5932,PERF
42127344460000,PI,IP,001,1,8434,14800,7717,6366,PERF
42127344480000,PI,IP,001,1,8749,15047,7799,6298,PERF
42127344520000,PI,PT,001,1,8434,10709,,2275,PERF
42127344530000,PI,IP,001,1,7704,12878,6371,5174,PERF
42127344550000,PI,IP,001,1,8040,13756,6116,5716,PERF
42127344560000,PI,IP,001,1,8466,13034,6071,4568,PERF
42127344570000,PI,IP,001,1,8190,12917,6005,4727,PERF
42127344580000,PI,IP,001,1,7943,12520,5971,4577,PERF
42127344590000,PI,IP,001,1,8073,12704,5994,4631,PERF
42127344600100,PI,IP,001,1,8020,12592,6058,4572,PERF
42127344610000,PI,IP,001,1,8190,14862,7080,6672,PERF
42127344620000,PI,IP,001,1,8200,15175,7532,6975,PERF
42127344630000,PI,IP,001,1,7545,11996,5199,4451,PERF
42127344640000,PI,IP,001,1,7460,12243,5999,4783,PERF
42127344650000,PI,IP,001,1,7554,12262,6020,4708,PERF
42127344660000,PI,PT,001,1,7369,12204,,4835,PERF
42127344670000,PI,IP,001,1,7772,14630,7144,6858,PERF
42127344690000,PI,IP,001,1,6688,11449,4986,4761,PERF
42127344700000,PI,IP,001,1,6726,12485,6082,5759,PERF
42127344710000,PI,IP,001,1,6801,11428,4913,4627,PERF
42127344720000,PI,IP,001,1,8550,14995,7441,6445,PERF
42127344730000,PI,PT,001,1,8545,14159,,5614,PERF
42127344740000,PI,PT,001,1,8327,14167,,5840,PERF
42127344750000,PI,IP,001,1,8266,14005,6856,5739,PERF
42127344760000,PI,PT,001,1,8156,13874,,5718,PERF
42127344770000,PI,IP,001,1,8400,13763,6537,5363,PERF
42127344780000,PI,IP,001,1,8910,14375,6613,5465,PERF
42127344790000,PI,IP,001,1,8695,13948,6568,5253,PERF
42127344800000,PI,IP,001,1,8579,13823,6533,5244,PERF
42127344810000,PI,IP,001,1,8556,13827,6543,5271,PERF
42127344820000,PI,IP,001,1,8713,14010,6564,5297,PERF
42127344830000,PI,IP,001,1,8738,14212,6614,5474,PERF
42127344850000,PI,IP,001,1,7146,11862,4961,4716,PERF
42127344860000,PI,IP,001,1,9410,15096,6849,5686,PERF
42127344870100,PI,IP,001,1,9068,14280,6547,5212,PERF
42127344880000,PI,IP,001,1,9032,14196,6273,5164,PERF
42127344890000,PI,PT,001,1,9081,13838,,4757,PERF
42127344900000,PI,IP,001,1,7220,11764,6000,4544,PERF
42127344910000,PI,IP,001,1,7063,11946,6000,4883,PERF
42127344920000,PI,IP,001,1,9013,13634,5860,4621,PERF
42127344930000,PI,IP,001,1,7116,11791,4876,4675,PERF
42127344940000,PI,IP,001,1,9131,13368,5569,4237,PERF
42127344950000,PI,IP,001,1,7800,8011,8972,211,PERF
42127344950000,PI,IP,001,2,8125,8332,8972,207,PERF
42127344950000,PI,IP,001,3,8450,8668,8972,218,PERF
42127344950000,PI,IP,001,4,8775,8985,8972,210,PERF
42127344950000,PI,IP,001,5,9100,9315,8972,215,PERF
42127344950000,PI,IP,001,6,9425,9640,8972,215,PERF
42127344950000,PI,IP,001,7,9750,9965,8972,215,PERF
42127344950000,PI,IP,001,8,10075,10292,8972,217,PERF
42127344950000,PI,IP,001,9,10395,10615,8972,220,PERF
42127344950000,PI,IP,001,10,10725,10945,8972,220,PERF
42127344950000,PI,IP,001,11,11050,11258,8972,208,PERF
42127344950000,PI,IP,001,12,11375,11585,8972,210,PERF
42127344950000,PI,IP,001,13,11700,11910,8972,210,PERF
42127344950000,PI,IP,001,14,12025,12235,8972,210,PERF
42127344950000,PI,IP,001,15,12350,12563,8972,213,PERF
42127344950000,PI,IP,001,16,12675,12883,8972,208,PERF
42127344950000,PI,IP,001,17,13000,13221,8972,221,PERF
42127344950000,PI,IP,001,18,13325,13530,8972,205,PERF
42127344950000,PI,IP,001,19,13650,13855,8972,205,PERF
42127344950000,PI,IP,001,20,13975,14183,8972,208,PERF
42127344950000,PI,IP,001,21,14300,14510,8972,210,PERF
42127344950000,PI,IP,001,22,14625,14840,8972,215,PERF
42127344950000,PI,IP,001,23,14950,15163,8972,213,PERF
42127344950000,PI,IP,001,24,15488,15530,8972,42,PERF
42127345020000,PI,IP,001,1,6791,12558,6033,5767,PERF
42127345030000,PI,IP,001,1,8408,12826,5362,4418,PERF
42127345040000,PI,IP,001,1,8513,12930,6186,4417,PERF
42127345050000,PI,IP,001,1,8817,13234,6701,4417,PERF
42127345070000,PI,IP,001,1,8930,13904,6348,4974,PERF
42127345080000,PI,IP,001,1,8523,13594,6319,5071,PERF
42127345090000,PI,IP,001,1,8434,13544,6289,5110,PERF
42127345100000,PI,IP,001,1,8469,13468,6169,4999,PERF
42127345110000,PI,IP,001,1,8815,13689,6333,4874,PERF
42127345120100,PI,IP,001,1,8926,14076,6394,5150,PERF
42127345130000,PI,IP,001,1,8122,8390,6182,268,PERF
42127345130000,PI,IP,001,2,8476,8744,6182,268,PERF
42127345130000,PI,IP,001,3,8832,9100,6182,268,PERF
42127345130000,PI,IP,001,4,9196,9464,6182,268,PERF
42127345130000,PI,IP,001,5,9552,9820,6182,268,PERF
42127345130000,PI,IP,001,6,9904,10174,6182,270,PERF
42127345130000,PI,IP,001,7,10260,10530,6182,270,PERF
42127345130000,PI,IP,001,8,10616,10884,6182,268,PERF
42127345130000,PI,IP,001,9,10974,11238,6182,264,PERF
42127345130000,PI,IP,001,10,11328,11594,6182,266,PERF
42127345130000,PI,IP,001,11,11686,11950,6182,264,PERF
42127345130000,PI,IP,001,12,12040,12306,6182,266,PERF
42127345130000,PI,IP,001,13,12396,12662,6182,266,PERF
42127345130000,PI,IP,001,14,12752,13018,6182,266,PERF
42127345130000,PI,IP,001,15,13108,13350,6182,242,PERF
42127345140000,PI,IP,001,1,8458,12875,5728,4417,PERF
42127345150000,PI,IP,001,1,8512,8513,5778,1,PERF
42127345150000,PI,IP,001,2,8599,8600,5778,1,PERF
42127345150000,PI,IP,001,3,8686,8687,5778,1,PERF
42127345150000,PI,IP,001,4,8773,8774,5778,1,PERF
42127345150000,PI,IP,001,5,8858,8859,5778,1,PERF
42127345150000,PI,IP,001,6,8945,8946,5778,1,PERF
42127345150000,PI,IP,001,7,9032,9033,5778,1,PERF
42127345150000,PI,IP,001,8,9119,9120,5778,1,PERF
42127345150000,PI,IP,001,9,9204,9205,5778,1,PERF
42127345150000,PI,IP,001,10,9291,9292,5778,1,PERF
42127345150000,PI,IP,001,11,9378,9379,5778,1,PERF
42127345150000,PI,IP,001,12,9465,9466,5778,1,PERF
42127345150000,PI,IP,001,13,9550,9551,5778,1,PERF
42127345150000,PI,IP,001,14,9637,9638,5778,1,PERF
42127345150000,PI,IP,001,15,9724,9725,5778,1,PERF
42127345150000,PI,IP,001,16,9811,9812,5778,1,PERF
42127345150000,PI,IP,001,17,9896,9897,5778,1,PERF
42127345150000,PI,IP,001,18,9983,9984,5778,1,PERF
42127345150000,PI,IP,001,19,10070,10071,5778,1,PERF
42127345150000,PI,IP,001,20,10157,10158,5778,1,PERF
42127345150000,PI,IP,001,21,10242,10243,5778,1,PERF
42127345150000,PI,IP,001,22,10329,10330,5778,1,PERF
42127345150000,PI,IP,001,23,10416,10417,5778,1,PERF
42127345150000,PI,IP,001,24,10503,10504,5778,1,PERF
42127345150000,PI,IP,001,25,10588,10589,5778,1,PERF
42127345150000,PI,IP,001,26,10675,10676,5778,1,PERF
42127345150000,PI,IP,001,27,10762,10763,5778,1,PERF
42127345150000,PI,IP,001,28,10849,10850,5778,1,PERF
42127345150000,PI,IP,001,29,10934,10935,5778,1,PERF
42127345150000,PI,IP,001,30,11021,11022,5778,1,PERF
42127345150000,PI,IP,001,31,11108,11109,5778,1,PERF
42127345150000,PI,IP,001,32,11195,11196,5778,1,PERF
42127345150000,PI,IP,001,33,11280,11281,5778,1,PERF
42127345150000,PI,IP,001,34,11367,11368,5778,1,PERF
42127345150000,PI,IP,001,35,11454,11455,5778,1,PERF
42127345150000,PI,IP,001,36,11541,11542,5778,1,PERF
42127345150000,PI,IP,001,37,11626,11627,5778,1,PERF
42127345150000,PI,IP,001,38,11713,11714,5778,1,PERF
42127345150000,PI,IP,001,39,11800,11801,5778,1,PERF
42127345150000,PI,IP,001,40,11887,11888,5778,1,PERF
42127345150000,PI,IP,001,41,11972,11973,5778,1,PERF
42127345150000,PI,IP,001,42,12059,12060,5778,1,PERF
42127345150000,PI,IP,001,43,12146,12147,5778,1,PERF
42127345150000,PI,IP,001,44,12233,12234,5778,1,PERF
42127345150000,PI,IP,001,45,12318,12319,5778,1,PERF
42127345150000,PI,IP,001,46,12405,12406,5778,1,PERF
42127345150000,PI,IP,001,47,12492,12493,5778,1,PERF
42127345150000,PI,IP,001,48,12579,12580,5778,1,PERF
42127345150000,PI,IP,001,49,12664,12665,5778,1,PERF
42127345150000,PI,IP,001,50,12751,12752,5778,1,PERF
42127345150000,PI,IP,001,51,12838,12839,5778,1,PERF
42127345150000,PI,IP,001,52,12925,12926,5778,1,PERF
42127345150000,PI,IP,001,53,13010,13011,5778,1,PERF
42127345150000,PI,IP,001,54,13097,13098,5778,1,PERF
42127345150000,PI,IP,001,55,13184,13185,5778,1,PERF
42127345150000,PI,IP,001,56,13271,13272,5778,1,PERF
42127345150000,PI,IP,001,57,13355,13357,5778,2,PERF
42127345150000,PI,IP,001,58,13435,13437,5778,2,PERF
42127345150000,PI,IP,001,59,13515,13517,5778,2,PERF
42127345150000,PI,IP,001,60,13595,13597,5778,2,PERF
42127345170000,PI,IP,001,1,8283,8285,6092,2,PERF
42127345170000,PI,IP,001,2,8371,8373,6092,2,PERF
42127345170000,PI,IP,001,3,8459,8461,6092,2,PERF
42127345170000,PI,IP,001,4,8547,8549,6092,2,PERF
42127345170000,PI,IP,001,5,8638,8640,6092,2,PERF
42127345170000,PI,IP,001,6,8726,8728,6092,2,PERF
42127345170000,PI,IP,001,7,8814,8816,6092,2,PERF
42127345170000,PI,IP,001,8,8902,8904,6092,2,PERF
42127345170000,PI,IP,001,9,8993,8995,6092,2,PERF
42127345170000,PI,IP,001,10,9081,9083,6092,2,PERF
42127345170000,PI,IP,001,11,9169,9171,6092,2,PERF
42127345170000,PI,IP,001,12,9257,9259,6092,2,PERF
42127345170000,PI,IP,001,13,9348,9350,6092,2,PERF
42127345170000,PI,IP,001,14,9436,9438,6092,2,PERF
42127345170000,PI,IP,001,15,9524,9526,6092,2,PERF
42127345170000,PI,IP,001,16,9612,9614,6092,2,PERF
42127345170000,PI,IP,001,17,9703,9705,6092,2,PERF
42127345170000,PI,IP,001,18,9791,9793,6092,2,PERF
42127345170000,PI,IP,001,19,9879,9881,6092,2,PERF
42127345170000,PI,IP,001,20,9967,9969,6092,2,PERF
42127345170000,PI,IP,001,21,10058,10060,6092,2,PERF
42127345170000,PI,IP,001,22,10146,10148,6092,2,PERF
42127345170000,PI,IP,001,23,10234,10236,6092,2,PERF
42127345170000,PI,IP,001,24,10322,10324,6092,2,PERF
42127345170000,PI,IP,001,25,10413,10415,6092,2,PERF
42127345170000,PI,IP,001,26,10501,10503,6092,2,PERF
42127345170000,PI,IP,001,27,10589,10591,6092,2,PERF
42127345170000,PI,IP,001,28,10677,10679,6092,2,PERF
42127345170000,PI,IP,001,29,10768,10770,6092,2,PERF
42127345170000,PI,IP,001,30,10856,10858,6092,2,PERF
42127345170000,PI,IP,001,31,10944,10946,6092,2,PERF
42127345170000,PI,IP,001,32,11032,11034,6092,2,PERF
42127345170000,PI,IP,001,33,11123,11125,6092,2,PERF
42127345170000,PI,IP,001,34,11211,11213,6092,2,PERF
42127345170000,PI,IP,001,35,11299,11301,6092,2,PERF
42127345170000,PI,IP,001,36,11387,11389,6092,2,PERF
42127345170000,PI,IP,001,37,11478,11480,6092,2,PERF
42127345170000,PI,IP,001,38,11566,11568,6092,2,PERF
42127345170000,PI,IP,001,39,11654,11656,6092,2,PERF
42127345170000,PI,IP,001,40,11742,11744,6092,2,PERF
42127345170000,PI,IP,001,41,11833,11835,6092,2,PERF
42127345170000,PI,IP,001,42,11921,11923,6092,2,PERF
42127345170000,PI,IP,001,43,12009,12011,6092,2,PERF
42127345170000,PI,IP,001,44,12097,12099,6092,2,PERF
42127345170000,PI,IP,001,45,12188,12190,6092,2,PERF
42127345170000,PI,IP,001,46,12276,12278,6092,2,PERF
42127345170000,PI,IP,001,47,12364,12366,6092,2,PERF
42127345170000,PI,IP,001,48,12452,12454,6092,2,PERF
42127345170000,PI,IP,001,49,12543,12545,6092,2,PERF
42127345170000,PI,IP,001,50,12631,12633,6092,2,PERF
42127345170000,PI,IP,001,51,12719,12721,6092,2,PERF
42127345170000,PI,IP,001,52,12807,12809,6092,2,PERF
42127345170000,PI,IP,001,53,12898,12900,6092,2,PERF
42127345170000,PI,IP,001,54,12986,12988,6092,2,PERF
42127345170000,PI,IP,001,55,13074,13076,6092,2,PERF
42127345170000,PI,IP,001,56,13162,13164,6092,2,PERF
42127345170000,PI,IP,001,57,13252,13254,6092,2,PERF
42127345170000,PI,IP,001,58,13334,13336,6092,2,PERF
42127345170000,PI,IP,001,59,13416,13418,6092,2,PERF
42127345170000,PI,IP,001,60,13498,13500,6092,2,PERF
42127345180000,PI,IP,001,1,8161,8163,6073,2,PERF
42127345180000,PI,IP,001,2,8250,8252,6073,2,PERF
42127345180000,PI,IP,001,3,8339,8341,6073,2,PERF
42127345180000,PI,IP,001,4,8428,8430,6073,2,PERF
42127345180000,PI,IP,001,5,8522,8524,6073,2,PERF
42127345180000,PI,IP,001,6,8611,8613,6073,2,PERF
42127345180000,PI,IP,001,7,8700,8702,6073,2,PERF
42127345180000,PI,IP,001,8,8789,8791,6073,2,PERF
42127345180000,PI,IP,001,9,8883,8885,6073,2,PERF
42127345180000,PI,IP,001,10,8972,8974,6073,2,PERF
42127345180000,PI,IP,001,11,9061,9063,6073,2,PERF
42127345180000,PI,IP,001,12,9150,9152,6073,2,PERF
42127345180000,PI,IP,001,13,9244,9246,6073,2,PERF
42127345180000,PI,IP,001,14,9333,9335,6073,2,PERF
42127345180000,PI,IP,001,15,9422,9424,6073,2,PERF
42127345180000,PI,IP,001,16,9511,9513,6073,2,PERF
42127345180000,PI,IP,001,17,9605,9607,6073,2,PERF
42127345180000,PI,IP,001,18,9694,9696,6073,2,PERF
42127345180000,PI,IP,001,19,9783,9785,6073,2,PERF
42127345180000,PI,IP,001,20,9872,9874,6073,2,PERF
42127345180000,PI,IP,001,21,9966,9968,6073,2,PERF
42127345180000,PI,IP,001,22,10055,10057,6073,2,PERF
42127345180000,PI,IP,001,23,10144,10146,6073,2,PERF
42127345180000,PI,IP,001,24,10233,10235,6073,2,PERF
42127345180000,PI,IP,001,25,10327,10329,6073,2,PERF
42127345180000,PI,IP,001,26,10416,10418,6073,2,PERF
42127345180000,PI,IP,001,27,10505,10507,6073,2,PERF
42127345180000,PI,IP,001,28,10594,10596,6073,2,PERF
42127345180000,PI,IP,001,29,10688,10690,6073,2,PERF
42127345180000,PI,IP,001,30,10777,10779,6073,2,PERF
42127345180000,PI,IP,001,31,10866,10868,6073,2,PERF
42127345180000,PI,IP,001,32,10955,10957,6073,2,PERF
42127345180000,PI,IP,001,33,11049,11051,6073,2,PERF
42127345180000,PI,IP,001,34,11138,11140,6073,2,PERF
42127345180000,PI,IP,001,35,11227,11229,6073,2,PERF
42127345180000,PI,IP,001,36,11316,11318,6073,2,PERF
42127345180000,PI,IP,001,37,11410,11412,6073,2,PERF
42127345180000,PI,IP,001,38,11499,11501,6073,2,PERF
42127345180000,PI,IP,001,39,11588,11590,6073,2,PERF
42127345180000,PI,IP,001,40,11677,11679,6073,2,PERF
42127345180000,PI,IP,001,41,11771,11773,6073,2,PERF
42127345180000,PI,IP,001,42,11860,11862,6073,2,PERF
42127345180000,PI,IP,001,43,11949,11951,6073,2,PERF
42127345180000,PI,IP,001,44,12038,12040,6073,2,PERF
42127345180000,PI,IP,001,45,12132,12134,6073,2,PERF
42127345180000,PI,IP,001,46,12221,12223,6073,2,PERF
42127345180000,PI,IP,001,47,12310,12312,6073,2,PERF
42127345180000,PI,IP,001,48,12399,12401,6073,2,PERF
42127345180000,PI,IP,001,49,12493,12495,6073,2,PERF
42127345180000,PI,IP,001,50,12582,12584,6073,2,PERF
42127345180000,PI,IP,001,51,12671,12673,6073,2,PERF
42127345180000,PI,IP,001,52,12760,12762,6073,2,PERF
42127345180000,PI,IP,001,53,12854,12856,6073,2,PERF
42127345180000,PI,IP,001,54,12943,12945,6073,2,PERF
42127345180000,PI,IP,001,55,13032,13034,6073,2,PERF
42127345180000,PI,IP,001,56,13121,13123,6073,2,PERF
42127345180000,PI,IP,001,57,13215,13217,6073,2,PERF
42127345180000,PI,IP,001,58,13299,13301,6073,2,PERF
42127345180000,PI,IP,001,59,13383,13385,6073,2,PERF
42127345180000,PI,IP,001,60,13467,13469,6073,2,PERF
42127345190000,PI,IP,001,1,8189,8191,6084,2,PERF
42127345190000,PI,IP,001,2,8278,8280,6084,2,PERF
42127345190000,PI,IP,001,3,8367,8369,6084,2,PERF
42127345190000,PI,IP,001,4,8456,8458,6084,2,PERF
42127345190000,PI,IP,001,5,8551,8553,6084,2,PERF
42127345190000,PI,IP,001,6,8640,8642,6084,2,PERF
42127345190000,PI,IP,001,7,8729,8731,6084,2,PERF
42127345190000,PI,IP,001,8,8818,8820,6084,2,PERF
42127345190000,PI,IP,001,9,8913,8915,6084,2,PERF
42127345190000,PI,IP,001,10,9002,9004,6084,2,PERF
42127345190000,PI,IP,001,11,9091,9093,6084,2,PERF
42127345190000,PI,IP,001,12,9180,9182,6084,2,PERF
42127345190000,PI,IP,001,13,9275,9277,6084,2,PERF
42127345190000,PI,IP,001,14,9364,9366,6084,2,PERF
42127345190000,PI,IP,001,15,9453,9455,6084,2,PERF
42127345190000,PI,IP,001,16,9542,9544,6084,2,PERF
42127345190000,PI,IP,001,17,9637,9639,6084,2,PERF
42127345190000,PI,IP,001,18,9726,9728,6084,2,PERF
42127345190000,PI,IP,001,19,9815,9817,6084,2,PERF
42127345190000,PI,IP,001,20,9904,9906,6084,2,PERF
42127345190000,PI,IP,001,21,9999,10001,6084,2,PERF
42127345190000,PI,IP,001,22,10088,10090,6084,2,PERF
42127345190000,PI,IP,001,23,10177,10179,6084,2,PERF
42127345190000,PI,IP,001,24,10266,10268,6084,2,PERF
42127345190000,PI,IP,001,25,10361,10363,6084,2,PERF
42127345190000,PI,IP,001,26,10450,10452,6084,2,PERF
42127345190000,PI,IP,001,27,10539,10541,6084,2,PERF
42127345190000,PI,IP,001,28,10628,10630,6084,2,PERF
42127345190000,PI,IP,001,29,10723,10725,6084,2,PERF
42127345190000,PI,IP,001,30,10812,10814,6084,2,PERF
42127345190000,PI,IP,001,31,10901,10903,6084,2,PERF
42127345190000,PI,IP,001,32,10990,10992,6084,2,PERF
42127345190000,PI,IP,001,33,11085,11087,6084,2,PERF
42127345190000,PI,IP,001,34,11174,11176,6084,2,PERF
42127345190000,PI,IP,001,35,11263,11265,6084,2,PERF
42127345190000,PI,IP,001,36,11352,11354,6084,2,PERF
42127345190000,PI,IP,001,37,11447,11449,6084,2,PERF
42127345190000,PI,IP,001,38,11536,11538,6084,2,PERF
42127345190000,PI,IP,001,39,11625,11627,6084,2,PERF
42127345190000,PI,IP,001,40,11714,11716,6084,2,PERF
42127345190000,PI,IP,001,41,11809,11811,6084,2,PERF
42127345190000,PI,IP,001,42,11898,11900,6084,2,PERF
42127345190000,PI,IP,001,43,11987,11989,6084,2,PERF
42127345190000,PI,IP,001,44,12076,12078,6084,2,PERF
42127345190000,PI,IP,001,45,12171,12173,6084,2,PERF
42127345190000,PI,IP,001,46,12260,12262,6084,2,PERF
42127345190000,PI,IP,001,47,12349,12351,6084,2,PERF
42127345190000,PI,IP,001,48,12438,12440,6084,2,PERF
42127345190000,PI,IP,001,49,12533,12535,6084,2,PERF
42127345190000,PI,IP,001,50,12622,12624,6084,2,PERF
42127345190000,PI,IP,001,51,12711,12713,6084,2,PERF
42127345190000,PI,IP,001,52,12800,12802,6084,2,PERF
42127345190000,PI,IP,001,53,12895,12897,6084,2,PERF
42127345190000,PI,IP,001,54,12984,12986,6084,2,PERF
42127345190000,PI,IP,001,55,13073,13075,6084,2,PERF
42127345190000,PI,IP,001,56,13162,13164,6084,2,PERF
42127345190000,PI,IP,001,57,13256,13258,6084,2,PERF
42127345190000,PI,IP,001,58,13340,13342,6084,2,PERF
42127345190000,PI,IP,001,59,13424,13426,6084,2,PERF
42127345190000,PI,IP,001,60,13508,13510,6084,2,PERF
42127345200000,PI,IP,001,1,6891,14400,7805,7509,PERF
42127345210000,PI,IP,001,1,7897,8102,8720,205,PERF
42127345210000,PI,IP,001,2,8212,8413,8720,201,PERF
42127345210000,PI,IP,001,3,8527,8732,8720,205,PERF
42127345210000,PI,IP,001,4,8842,9047,8720,205,PERF
42127345210000,PI,IP,001,5,9157,9362,8720,205,PERF
42127345210000,PI,IP,001,6,9472,9677,8720,205,PERF
42127345210000,PI,IP,001,7,9787,9992,8720,205,PERF
42127345210000,PI,IP,001,8,10097,10306,8720,209,PERF
42127345210000,PI,IP,001,9,10417,10622,8720,205,PERF
42127345210000,PI,IP,001,10,10732,10912,8720,180,PERF
42127345210000,PI,IP,001,11,11012,11222,8720,210,PERF
42127345210000,PI,IP,001,12,11362,11567,8720,205,PERF
42127345210000,PI,IP,001,13,11677,11882,8720,205,PERF
42127345210000,PI,IP,001,14,11992,12197,8720,205,PERF
42127345210000,PI,IP,001,15,12312,12512,8720,200,PERF
42127345210000,PI,IP,001,16,12622,12827,8720,205,PERF
42127345210000,PI,IP,001,17,12937,13131,8720,194,PERF
42127345210000,PI,IP,001,18,13252,13461,8720,209,PERF
42127345210000,PI,IP,001,19,13567,13772,8720,205,PERF
42127345210000,PI,IP,001,20,13882,14087,8720,205,PERF
42127345210000,PI,IP,001,21,14197,14402,8720,205,PERF
42127345210000,PI,IP,001,22,14506,14714,8720,208,PERF
42127345210000,PI,IP,001,23,14827,15032,8720,205,PERF
42127345210000,PI,IP,001,24,15145,15358,8720,213,PERF
42127345220000,PI,IP,001,1,8538,14101,6639,5563,PERF
42127345230000,PI,IP,001,1,8553,13938,6576,5385,PERF
42127345240000,PI,IP,001,1,8390,13909,7938,5519,PERF
42127345250000,PI,IP,001,1,6773,14439,7830,7666,PERF
42127345270000,PI,IP,001,1,6483,11163,4945,4680,PERF
42127345290000,PI,IP,001,1,6942,11278,5064,4336,PERF
42127345430000,PI,IP,001,1,6862,14438,9831,7576,PERF
42127345450000,PI,IP,001,1,6901,14132,7582,7231,PERF
42127345460000,PI,IP,001,1,6880,13555,6957,6675,PERF
42127345470000,PI,IP,001,1,7578,12256,5087,4678,PERF
42127345480000,PI,IP,001,1,7622,12309,5151,4687,PERF
42127345570000,PI,IP,001,1,7631,12384,5139,4753,PERF
42127345590000,PI,IP,001,1,7076,11748,4870,4672,PERF
42127345600000,PI,IP,001,1,8518,13869,6530,5351,PERF
42127345610000,PI,IP,001,1,7055,13385,6661,6330,PERF
42127345620000,PI,IP,001,1,7725,13501,6280,5776,PERF
42127345690000,PI,IP,001,1,8501,11354,4933,2853,PERF
42127345700000,PI,IP,001,1,8175,8441,5654,266,PERF
42127345700000,PI,IP,001,2,8505,8766,5654,261,PERF
42127345700000,PI,IP,001,3,8830,9091,5654,261,PERF
42127345700000,PI,IP,001,4,9155,9416,5654,261,PERF
42127345700000,PI,IP,001,5,9480,9741,5654,261,PERF
42127345700000,PI,IP,001,6,9805,10064,5654,259,PERF
42127345700000,PI,IP,001,7,10126,10372,5654,246,PERF
42127345700000,PI,IP,001,8,10436,10681,5654,245,PERF
42127345700000,PI,IP,001,9,10745,10993,5654,248,PERF
42127345700000,PI,IP,001,10,11057,11294,5654,237,PERF
42127345700000,PI,IP,001,11,11358,11602,5654,244,PERF
42127345700000,PI,IP,001,12,11661,11903,5654,242,PERF
42127345700000,PI,IP,001,13,11961,12207,5654,246,PERF
42127345700000,PI,IP,001,14,12266,12515,5654,249,PERF
42127345700000,PI,IP,001,15,12579,12820,5654,241,PERF
42127345700000,PI,IP,001,16,12879,13126,5654,247,PERF
42127345700000,PI,IP,001,17,13192,13391,5654,199,PERF
42127345780000,PI,IP,001,1,8474,14330,7105,5856,PERF
42127345790000,PI,IP,001,1,8241,12485,5541,4244,PERF
42127345800000,PI,IP,001,1,8088,12298,5520,4210,PERF
42127345810000,PI,IP,001,1,8079,12315,5501,4236,PERF
42127345820000,PI,IP,001,1,8267,12373,5458,4106,PERF
42127345830100,PI,IP,001,1,8186,12393,5545,4207,PERF
42127345840000,PI,IP,001,1,7666,12839,,5173,PERF
42127345870000,PI,IP,001,1,8260,8602,5978,342,PERF
42127345870000,PI,IP,001,2,8673,8944,5978,271,PERF
42127345870000,PI,IP,001,3,9016,9281,5978,265,PERF
42127345870000,PI,IP,001,4,9356,9612,5978,256,PERF
42127345870000,PI,IP,001,5,9686,9947,5978,261,PERF
42127345870000,PI,IP,001,6,10016,10274,5978,258,PERF
42127345870000,PI,IP,001,7,10345,10606,5978,261,PERF
42127345870000,PI,IP,001,8,10675,10936,5978,261,PERF
42127345870000,PI,IP,001,9,11000,11253,5978,253,PERF
42127345870000,PI,IP,001,10,11317,11563,5978,246,PERF
42127345870000,PI,IP,001,11,11628,11876,5978,248,PERF
42127345870000,PI,IP,001,12,11935,12179,5978,244,PERF
42127345870000,PI,IP,001,13,12236,12477,5978,241,PERF
42127345870000,PI,IP,001,14,12536,12778,5978,242,PERF
42127345870000,PI,IP,001,15,12842,13079,5978,237,PERF
42127345870000,PI,IP,001,16,13183,13376,5978,193,PERF
42127345870000,PI,IP,001,17,13435,13663,5978,228,PERF
42127345880000,PI,IP,001,1,8168,8469,5601,301,PERF
42127345880000,PI,IP,001,2,8483,8741,5601,258,PERF
42127345880000,PI,IP,001,3,8817,9054,5601,237,PERF
42127345880000,PI,IP,001,4,9130,9386,5601,256,PERF
42127345880000,PI,IP,001,5,9460,9719,5601,259,PERF
42127345880000,PI,IP,001,6,9790,10051,5601,261,PERF
42127345880000,PI,IP,001,7,10120,10375,5601,255,PERF
42127345880000,PI,IP,001,8,10455,10713,5601,258,PERF
42127345880000,PI,IP,001,9,10787,11038,5601,251,PERF
42127345880000,PI,IP,001,10,11112,11353,5601,241,PERF
42127345880000,PI,IP,001,11,11423,11664,5601,241,PERF
42127345880000,PI,IP,001,12,11728,11967,5601,239,PERF
42127345880000,PI,IP,001,13,12026,12263,5601,237,PERF
42127345880000,PI,IP,001,14,12322,12559,5601,237,PERF
42127345880000,PI,IP,001,15,12618,12855,5601,237,PERF
42127345880000,PI,IP,001,16,12914,13155,5601,241,PERF
42127345880000,PI,IP,001,17,13214,13451,5601,237,PERF
42127345910000,PI,IP,001,1,8147,14112,6697,5965,PERF
42127345930000,PI,IP,001,1,8157,15653,7703,7496,PERF
42127345950000,PI,IP,001,1,7533,14076,6876,6543,PERF
42127345970000,PI,IP,001,1,7751,14967,7599,7216,PERF
42127345980000,PI,IP,001,1,7880,14555,7194,6675,PERF
42127346000000,PI,IP,001,1,7394,13066,5852,5672,PERF
42127346010000,PI,IP,001,1,7487,12255,5135,4768,PERF
42127346030000,PI,IP,001,1,8131,8256,6095,125,PERF
42127346030000,PI,IP,001,2,8379,13030,6095,4651,PERF
42127346080000,PI,IP,001,1,7363,12047,5097,4684,PERF
42127346090000,PI,IP,001,1,7512,12551,5817,5039,PERF
42127346100000,PI,PT,001,1,8058,12473,,4415,PERF
42127346110000,PI,IP,001,1,8660,13441,6015,4781,PERF
42127346120000,PI,IP,001,1,8489,13165,5994,4676,PERF
42127346130000,PI,IP,001,1,8358,13059,5983,4701,PERF
42127346160000,PI,IP,001,1,8475,13277,6030,4802,PERF
42127346250000,PI,IP,001,1,7788,14481,7124,6693,PERF
42127346260000,PI,IP,001,1,6891,12241,6801,5350,PERF
42127346270000,PI,IP,001,1,6760,14871,,8111,PERF
42127346280000,PI,IP,001,1,7292,14456,7266,7164,PERF
42127346290000,PI,IP,001,1,7205,12352,6254,5147,PERF
42127346300000,PI,IP,001,1,7901,12399,5018,4498,PERF
42127346310000,PI,IP,001,1,7428,14392,7943,6964,PERF
42127346330000,PI,IP,001,1,6594,10898,4606,4304,PERF
42127346340000,PI,IP,001,1,8016,12499,5239,4483,PERF
42127346360000,PI,IP,001,1,8011,12518,5306,4507,PERF
42127346380000,PI,IP,001,1,6528,10877,4610,4349,PERF
42127346390000,PI,IP,001,1,7379,14642,7571,7263,PERF
42127346410000,PI,IP,001,1,7675,12327,4978,4652,PERF
42127346420000,PI,IP,001,1,7686,11343,3900,3657,PERF
42127346430000,PI,IP,001,1,7697,12313,5092,4616,PERF
42127346450000,PI,IP,001,1,6812,14570,7922,7758,PERF
42127346470000,PI,IP,001,1,7372,14759,7601,7387,PERF
42127346490000,PI,IP,001,1,8289,13190,5839,4901,PERF
42127346500000,PI,IP,001,1,8300,13165,5828,4865,PERF
42127346510000,PI,IP,001,1,8315,13288,5842,4973,PERF
42127346520000,PI,IP,001,1,7318,14540,8269,7222,PERF
42127346530000,PI,IP,001,1,7449,14608,7567,7159,PERF
42127346560000,PI,IP,001,1,7558,13867,7233,6309,PERF
42127346570000,PI,IP,001,1,7158,12288,5384,5130,PERF
42127346600000,PI,IP,001,1,7343,13262,6313,5919,PERF
42127346610000,PI,IP,001,1,8180,8452,5850,272,PERF
42127346610000,PI,IP,001,2,8554,8822,5850,268,PERF
42127346610000,PI,IP,001,3,8928,9206,5850,278,PERF
42127346610000,PI,IP,001,4,9302,9580,5850,278,PERF
42127346610000,PI,IP,001,5,9677,9954,5850,277,PERF
42127346610000,PI,IP,001,6,10046,10328,5850,282,PERF
42127346610000,PI,IP,001,7,10424,10698,5850,274,PERF
42127346610000,PI,IP,001,8,10798,11076,5850,278,PERF
42127346610000,PI,IP,001,9,11172,11450,5850,278,PERF
42127346610000,PI,IP,001,10,11540,11824,5850,284,PERF
42127346610000,PI,IP,001,11,11918,12198,5850,280,PERF
42127346610000,PI,IP,001,12,12294,12572,5850,278,PERF
42127346610000,PI,IP,001,13,12668,12946,5850,278,PERF
42127346610000,PI,IP,001,14,13042,13320,5850,278,PERF
42127346610000,PI,IP,001,15,13416,13658,5850,242,PERF
42127346620000,PI,IP,001,1,7532,7756,7808,224,PERF
42127346620000,PI,IP,001,2,7856,8063,7808,207,PERF
42127346620000,PI,IP,001,3,8172,8388,7808,216,PERF
42127346620000,PI,IP,001,4,8488,8704,7808,216,PERF
42127346620000,PI,IP,001,5,8800,9023,7808,223,PERF
42127346620000,PI,IP,001,6,9128,9336,7808,208,PERF
42127346620000,PI,IP,001,7,9436,9652,7808,216,PERF
42127346620000,PI,IP,001,8,9752,9968,7808,216,PERF
42127346620000,PI,IP,001,9,10068,10284,7808,216,PERF
42127346620000,PI,IP,001,10,10394,10600,7808,206,PERF
42127346620000,PI,IP,001,11,10700,10907,7808,207,PERF
42127346620000,PI,IP,001,12,11016,11232,7808,216,PERF
42127346620000,PI,IP,001,13,11332,11548,7808,216,PERF
42127346620000,PI,IP,001,14,11648,11864,7808,216,PERF
42127346620000,PI,IP,001,15,11968,12180,7808,212,PERF
42127346620000,PI,IP,001,16,12275,12496,7808,221,PERF
42127346620000,PI,IP,001,17,12596,12805,7808,209,PERF
42127346620000,PI,IP,001,18,12912,13123,7808,211,PERF
42127346620000,PI,IP,001,19,13228,13439,7808,211,PERF
42127346620000,PI,IP,001,20,13544,13760,7808,216,PERF
42127346620000,PI,IP,001,21,13865,14076,7808,211,PERF
42127346620000,PI,IP,001,22,14176,14392,7808,216,PERF
42127346620000,PI,IP,001,23,14492,14703,7808,211,PERF
42127346620000,PI,IP,001,24,14821,15030,7808,209,PERF
42127346670000,PI,IP,001,1,8240,13066,5889,4826,PERF
42127346690000,PI,PT,001,1,8240,12941,,4701,PERF
42127346700000,PI,IP,001,1,8033,13139,6016,5106,PERF
42127346710000,PI,IP,001,1,8553,8554,5962,1,PERF
42127346710000,PI,IP,001,2,8641,8642,5962,1,PERF
42127346710000,PI,IP,001,3,8729,8730,5962,1,PERF
42127346710000,PI,IP,001,4,8817,8818,5962,1,PERF
42127346710000,PI,IP,001,5,8902,8903,5962,1,PERF
42127346710000,PI,IP,001,6,8990,8991,5962,1,PERF
42127346710000,PI,IP,001,7,9078,9079,5962,1,PERF
42127346710000,PI,IP,001,8,9166,9167,5962,1,PERF
42127346710000,PI,IP,001,9,9251,9252,5962,1,PERF
42127346710000,PI,IP,001,10,9339,9340,5962,1,PERF
42127346710000,PI,IP,001,11,9427,9428,5962,1,PERF
42127346710000,PI,IP,001,12,9515,9516,5962,1,PERF
42127346710000,PI,IP,001,13,9600,9601,5962,1,PERF
42127346710000,PI,IP,001,14,9688,9689,5962,1,PERF
42127346710000,PI,IP,001,15,9776,9777,5962,1,PERF
42127346710000,PI,IP,001,16,9864,9865,5962,1,PERF
42127346710000,PI,IP,001,17,9949,9950,5962,1,PERF
42127346710000,PI,IP,001,18,10037,10038,5962,1,PERF
42127346710000,PI,IP,001,19,10125,10126,5962,1,PERF
42127346710000,PI,IP,001,20,10213,10214,5962,1,PERF
42127346710000,PI,IP,001,21,10298,10299,5962,1,PERF
42127346710000,PI,IP,001,22,10386,10387,5962,1,PERF
42127346710000,PI,IP,001,23,10474,10475,5962,1,PERF
42127346710000,PI,IP,001,24,10562,10563,5962,1,PERF
42127346710000,PI,IP,001,25,10647,10648,5962,1,PERF
42127346710000,PI,IP,001,26,10735,10736,5962,1,PERF
42127346710000,PI,IP,001,27,10823,10824,5962,1,PERF
42127346710000,PI,IP,001,28,10911,10912,5962,1,PERF
42127346710000,PI,IP,001,29,10996,10997,5962,1,PERF
42127346710000,PI,IP,001,30,11084,11085,5962,1,PERF
42127346710000,PI,IP,001,31,11172,11173,5962,1,PERF
42127346710000,PI,IP,001,32,11260,11261,5962,1,PERF
42127346710000,PI,IP,001,33,11345,11346,5962,1,PERF
42127346710000,PI,IP,001,34,11433,11434,5962,1,PERF
42127346710000,PI,IP,001,35,11521,11522,5962,1,PERF
42127346710000,PI,IP,001,36,11609,11610,5962,1,PERF
42127346710000,PI,IP,001,37,11694,11695,5962,1,PERF
42127346710000,PI,IP,001,38,11782,11783,5962,1,PERF
42127346710000,PI,IP,001,39,11870,11871,5962,1,PERF
42127346710000,PI,IP,001,40,11958,11959,5962,1,PERF
42127346710000,PI,IP,001,41,12043,12044,5962,1,PERF
42127346710000,PI,IP,001,42,12131,12132,5962,1,PERF
42127346710000,PI,IP,001,43,12219,12220,5962,1,PERF
42127346710000,PI,IP,001,44,12307,12308,5962,1,PERF
42127346710000,PI,IP,001,45,12392,12393,5962,1,PERF
42127346710000,PI,IP,001,46,12480,12481,5962,1,PERF
42127346710000,PI,IP,001,47,12568,12569,5962,1,PERF
42127346710000,PI,IP,001,48,12656,12657,5962,1,PERF
42127346710000,PI,IP,001,49,12741,12742,5962,1,PERF
42127346710000,PI,IP,001,50,12829,12830,5962,1,PERF
42127346710000,PI,IP,001,51,12917,12918,5962,1,PERF
42127346710000,PI,IP,001,52,13005,13006,5962,1,PERF
42127346710000,PI,IP,001,53,13090,13091,5962,1,PERF
42127346710000,PI,IP,001,54,13178,13179,5962,1,PERF
42127346710000,PI,IP,001,55,13266,13267,5962,1,PERF
42127346710000,PI,IP,001,56,13438,13440,5962,2,PERF
42127346710000,PI,IP,001,57,13518,13520,5962,2,PERF
42127346710000,PI,IP,001,58,13534,13535,5962,1,PERF
42127346710000,PI,IP,001,59,13598,13600,5962,2,PERF
42127346710000,PI,IP,001,60,13678,13680,5962,2,PERF
42127346730000,PI,IP,001,1,8193,16866,9571,8673,PERF
42127346740000,PI,IP,001,1,8160,16496,8723,8336,PERF
42127346750000,PI,IP,001,1,7352,12364,6251,5012,PERF
42127346760000,PI,IP,001,1,7807,12190,6248,4383,PERF
42127346770000,PI,IP,001,1,7483,12422,6247,4939,PERF
42127346780000,PI,PT,001,1,8486,13677,,5191,PERF
42127346800000,PI,IP,001,1,8626,12872,5689,4246,PERF
42127346820000,PI,IP,001,1,8540,13314,6063,4774,PERF
42127346830000,PI,IP,001,1,7563,13487,6389,5924,PERF
42127346840000,PI,IP,001,1,8355,12454,6028,4099,PERF
42127346850000,PI,IP,001,1,8311,12452,6022,4141,PERF
42127346860000,PI,IP,001,1,8379,13066,6036,4687,PERF
42127346870000,PI,IP,001,1,8548,13325,6070,4777,PERF
42127346880000,PI,IP,001,1,7123,14054,7670,6931,PERF
42127346890000,PI,IP,001,1,8732,13647,6138,4915,PERF
42127346900000,PI,IP,001,1,8588,13406,6112,4818,PERF
42127346910000,PI,IP,001,1,7649,12200,5002,4551,PERF
42127346920000,PI,IP,001,1,7255,12356,5916,5101,PERF
42127346930000,PI,IP,001,1,8369,13153,6081,4784,PERF
42127346940000,PI,IP,001,1,8345,13026,5997,4681,PERF
42127346950000,PI,IP,001,1,8615,13183,6098,4568,PERF
42127346960000,PI,IP,001,1,8494,13333,6121,4839,PERF
42127346970000,PI,IP,001,1,9224,13557,6204,4333,PERF
42127346980000,PI,IP,001,1,7000,11419,4968,4419,PERF
42127347000000,PI,IP,001,1,7962,8209,,247,PERF
42127347000000,PI,IP,001,2,8309,8556,,247,PERF
42127347000000,PI,IP,001,3,8656,8903,,247,PERF
42127347000000,PI,IP,001,4,9003,9250,,247,PERF
42127347000000,PI,IP,001,5,9350,9597,,247,PERF
42127347000000,PI,IP,001,6,9697,9944,,247,PERF
42127347000000,PI,IP,001,7,10044,10291,,247,PERF
42127347000000,PI,IP,001,8,10391,10638,,247,PERF
42127347000000,PI,IP,001,9,10738,10985,,247,PERF
42127347000000,PI,IP,001,10,11085,11332,,247,PERF
42127347000000,PI,IP,001,11,11432,11679,,247,PERF
42127347000000,PI,IP,001,12,11779,12026,,247,PERF
42127347000000,PI,IP,001,13,12126,12373,,247,PERF
42127347000000,PI,IP,001,14,12473,12720,,247,PERF
42127347000000,PI,IP,001,15,12820,13067,,247,PERF
42127347000000,PI,IP,001,16,13211,13420,,209,PERF
42127347010000,PI,IP,001,1,7351,12069,5487,4718,PERF
42127347020000,PI,IP,001,1,7488,12252,4972,4764,PERF
42127347060000,PI,IP,001,1,8262,14064,6402,5802,PERF
42127347070000,PI,IP,001,1,8317,14129,6483,5812,PERF
42127347090000,PI,IP,001,1,8226,13955,6482,5729,PERF
42127347110000,PI,IP,001,1,7309,12190,5499,4881,PERF
42127347120000,PI,IP,001,1,7417,12953,6410,5536,PERF
42127347170000,PI,IP,001,1,8609,13232,5671,4623,PERF
42127347180000,PI,IP,001,1,8450,12663,5465,4213,PERF
42127347190000,PI,IP,001,1,8403,12716,5541,4313,PERF
42127347200000,PI,IP,001,1,8602,12881,5598,4279,PERF
42127347210000,PI,IP,001,1,7355,12395,5845,5040,PERF
42127347220000,PI,IP,001,1,8508,12808,5586,4300,PERF
42127347250000,PI,IP,001,1,8668,13040,5622,4372,PERF
42127347260000,PI,IP,001,1,8445,12712,5415,4267,PERF
42127347270000,PI,IP,001,1,8249,12551,5388,4302,PERF
42127347280000,PI,IP,001,1,8517,12577,5372,4060,PERF
42127347300000,PI,IP,001,1,7549,13269,6025,5720,PERF
42127347340000,PI,IP,001,1,6323,12389,6178,6066,PERF
42127347360000,PI,IP,001,1,8301,14085,6551,5784,PERF
42127347390000,PI,IP,001,1,6922,13984,7467,7062,PERF
42127347420000,PI,IP,001,1,7258,11623,4615,4365,PERF
42127347430000,PI,IP,001,1,6480,12282,5904,5802,PERF
42127347460000,PI,IP,001,1,7252,11711,5283,4459,PERF
42127347540000,PI,IP,001,1,8518,13945,6527,5427,PERF
42127347550000,PI,IP,001,1,8160,13736,6436,5576,PERF
42127347560000,PI,IP,001,1,8209,13744,6440,5535,PERF
42127347570000,PI,IP,001,1,8548,13497,6154,4949,PERF
42127347580000,PI,IP,001,1,8622,13769,6174,5147,PERF
42127347590000,PI,IP,001,1,7260,14520,8088,7260,PERF
42127347600000,PI,IP,001,1,7198,13048,5939,5850,PERF
42127347720000,PI,IP,001,1,6759,11799,5506,5040,PERF
42127347770000,PI,IP,001,1,8350,13617,6512,5267,PERF
42127347790000,PI,IP,001,1,7670,12589,5592,4919,PERF
42127347810000,PI,IP,001,1,6828,13133,6668,6305,PERF
42127347820000,PI,IP,001,1,6654,13591,7253,6937,PERF
42127347840000,PI,IP,001,1,6748,13535,7360,6787,PERF
42127347850000,PI,IP,001,1,6740,12923,6379,6183,PERF
42127347980000,PI,PT,001,1,9292,14119,,4827,PERF
42127348010000,PI,IP,001,1,7454,12530,,5076,PERF
42127348070000,PI,IP,001,1,9410,14662,7230,5252,PERF
42127348090000,PI,IP,001,1,6652,11299,,4647,PERF
42127348110000,PI,IP,001,1,8958,8959,5248,1,PERF
42127348110000,PI,IP,001,2,8988,8989,5248,1,PERF
42127348110000,PI,IP,001,3,9018,9019,5248,1,PERF
42127348110000,PI,IP,001,4,9048,9049,5248,1,PERF
42127348110000,PI,IP,001,5,9078,9079,5248,1,PERF
42127348110000,PI,IP,001,6,9108,9109,5248,1,PERF
42127348110000,PI,IP,001,7,9138,9139,5248,1,PERF
42127348110000,PI,IP,001,8,9168,9169,5248,1,PERF
42127348110000,PI,IP,001,9,9198,9199,5248,1,PERF
42127348110000,PI,IP,001,10,9228,9229,5248,1,PERF
42127348110000,PI,IP,001,11,9258,9259,5248,1,PERF
42127348110000,PI,IP,001,12,9288,9289,5248,1,PERF
42127348110000,PI,IP,001,13,9318,9319,5248,1,PERF
42127348110000,PI,IP,001,14,9348,9349,5248,1,PERF
42127348110000,PI,IP,001,15,9378,9379,5248,1,PERF
42127348110000,PI,IP,001,16,9408,9409,5248,1,PERF
42127348110000,PI,IP,001,17,9438,9439,5248,1,PERF
42127348110000,PI,IP,001,18,9468,9469,5248,1,PERF
42127348110000,PI,IP,001,19,9498,9499,5248,1,PERF
42127348110000,PI,IP,001,20,9528,9529,5248,1,PERF
42127348110000,PI,IP,001,21,9558,9559,5248,1,PERF
42127348110000,PI,IP,001,22,9588,9589,5248,1,PERF
42127348110000,PI,IP,001,23,9618,9619,5248,1,PERF
42127348110000,PI,IP,001,24,9648,9649,5248,1,PERF
42127348110000,PI,IP,001,25,9678,9679,5248,1,PERF
42127348110000,PI,IP,001,26,9708,9709,5248,1,PERF
42127348110000,PI,IP,001,27,9738,9739,5248,1,PERF
42127348110000,PI,IP,001,28,9768,9769,5248,1,PERF
42127348110000,PI,IP,001,29,9798,9799,5248,1,PERF
42127348110000,PI,IP,001,30,9828,9829,5248,1,PERF
42127348110000,PI,IP,001,31,9896,9897,5248,1,PERF
42127348110000,PI,IP,001,32,9926,9927,5248,1,PERF
42127348110000,PI,IP,001,33,9956,9957,5248,1,PERF
42127348110000,PI,IP,001,34,9986,9987,5248,1,PERF
42127348110000,PI,IP,001,35,10016,10017,5248,1,PERF
42127348110000,PI,IP,001,36,10046,10047,5248,1,PERF
42127348110000,PI,IP,001,37,10076,10077,5248,1,PERF
42127348110000,PI,IP,001,38,10106,10107,5248,1,PERF
42127348110000,PI,IP,001,39,10136,10137,5248,1,PERF
42127348110000,PI,IP,001,40,10166,10167,5248,1,PERF
42127348110000,PI,IP,001,41,10234,10235,5248,1,PERF
42127348110000,PI,IP,001,42,10264,10265,5248,1,PERF
42127348110000,PI,IP,001,43,10294,10295,5248,1,PERF
42127348110000,PI,IP,001,44,10324,10325,5248,1,PERF
42127348110000,PI,IP,001,45,10354,10355,5248,1,PERF
42127348110000,PI,IP,001,46,10384,10385,5248,1,PERF
42127348110000,PI,IP,001,47,10414,10415,5248,1,PERF
42127348110000,PI,IP,001,48,10444,10445,5248,1,PERF
42127348110000,PI,IP,001,49,10474,10475,5248,1,PERF
42127348110000,PI,IP,001,50,10504,10505,5248,1,PERF
42127348110000,PI,IP,001,51,10572,10573,5248,1,PERF
42127348110000,PI,IP,001,52,10602,10603,5248,1,PERF
42127348110000,PI,IP,001,53,10632,10633,5248,1,PERF
42127348110000,PI,IP,001,54,10662,10663,5248,1,PERF
42127348110000,PI,IP,001,55,10692,10693,5248,1,PERF
42127348110000,PI,IP,001,56,10722,10723,5248,1,PERF
42127348110000,PI,IP,001,57,10752,10753,5248,1,PERF
42127348110000,PI,IP,001,58,10782,10783,5248,1,PERF
42127348110000,PI,IP,001,59,10812,10813,5248,1,PERF
42127348110000,PI,IP,001,60,10842,10843,5248,1,PERF
42127348110000,PI,IP,001,61,10910,10911,5248,1,PERF
42127348110000,PI,IP,001,62,10940,10941,5248,1,PERF
42127348110000,PI,IP,001,63,10970,10971,5248,1,PERF
42127348110000,PI,IP,001,64,11000,11001,5248,1,PERF
42127348110000,PI,IP,001,65,11030,11031,5248,1,PERF
42127348110000,PI,IP,001,66,11060,11061,5248,1,PERF
42127348110000,PI,IP,001,67,11090,11091,5248,1,PERF
42127348110000,PI,IP,001,68,11120,11121,5248,1,PERF
42127348110000,PI,IP,001,69,11150,11151,5248,1,PERF
42127348110000,PI,IP,001,70,11180,11181,5248,1,PERF
42127348110000,PI,IP,001,71,11248,11249,5248,1,PERF
42127348110000,PI,IP,001,72,11278,11279,5248,1,PERF
42127348110000,PI,IP,001,73,11308,11309,5248,1,PERF
42127348110000,PI,IP,001,74,11338,11339,5248,1,PERF
42127348110000,PI,IP,001,75,11368,11369,5248,1,PERF
42127348110000,PI,IP,001,76,11398,11399,5248,1,PERF
42127348110000,PI,IP,001,77,11428,11429,5248,1,PERF
42127348110000,PI,IP,001,78,11458,11459,5248,1,PERF
42127348110000,PI,IP,001,79,11488,11489,5248,1,PERF
42127348110000,PI,IP,001,80,11518,11519,5248,1,PERF
42127348110000,PI,IP,001,81,11586,11587,5248,1,PERF
42127348110000,PI,IP,001,82,11616,11617,5248,1,PERF
42127348110000,PI,IP,001,83,11646,11647,5248,1,PERF
42127348110000,PI,IP,001,84,11706,11707,5248,1,PERF
42127348110000,PI,IP,001,85,11736,11737,5248,1,PERF
42127348110000,PI,IP,001,86,11766,11767,5248,1,PERF
42127348110000,PI,IP,001,87,11796,11797,5248,1,PERF
42127348110000,PI,IP,001,88,11826,11827,5248,1,PERF
42127348110000,PI,IP,001,89,11856,11857,5248,1,PERF
42127348110000,PI,IP,001,90,11924,11925,5248,1,PERF
42127348110000,PI,IP,001,91,11954,11955,5248,1,PERF
42127348110000,PI,IP,001,92,11984,11985,5248,1,PERF
42127348110000,PI,IP,001,93,12014,12015,5248,1,PERF
42127348110000,PI,IP,001,94,12044,12045,5248,1,PERF
42127348110000,PI,IP,001,95,12074,12075,5248,1,PERF
42127348110000,PI,IP,001,96,12104,12105,5248,1,PERF
42127348110000,PI,IP,001,97,12134,12135,5248,1,PERF
42127348110000,PI,IP,001,98,12164,12165,5248,1,PERF
42127348110000,PI,IP,001,99,12194,12195,5248,1,PERF
42127348110000,PI,IP,001,100,12254,12255,5248,1,PERF
42127348110000,PI,IP,001,101,12290,12291,5248,1,PERF
42127348110000,PI,IP,001,102,12327,12328,5248,1,PERF
42127348110000,PI,IP,001,103,12361,12362,5248,1,PERF
42127348140000,PI,IP,001,1,7504,14376,7241,6872,PERF
42127348270000,PI,IP,001,1,7574,14507,7299,6933,PERF
42127348290000,PI,IP,001,1,6617,11005,,4388,PERF
42127348300000,PI,IP,001,1,6992,12313,5498,5321,PERF
42127348310000,PI,PT,001,1,8622,9098,,476,PERF
42127348310000,PI,PT,001,2,9157,13299,,4142,PERF
42127348330000,PI,PT,001,1,8305,12888,,4583,PERF
42127348350000,PI,IP,001,1,7831,14437,7088,6606,PERF
42127348380000,PI,IP,001,1,6718,11092,,4374,PERF
42127348400000,PI,IP,001,1,7544,7757,8635,213,PERF
42127348400000,PI,IP,001,2,7865,8086,8635,221,PERF
42127348400000,PI,IP,001,3,8186,8399,8635,213,PERF
42127348400000,PI,IP,001,4,8507,8733,8635,226,PERF
42127348400000,PI,IP,001,5,8825,9049,8635,224,PERF
42127348400000,PI,IP,001,6,9149,9370,8635,221,PERF
42127348400000,PI,IP,001,7,9470,9691,8635,221,PERF
42127348400000,PI,IP,001,8,9791,10012,8635,221,PERF
42127348400000,PI,IP,001,9,10111,10333,8635,222,PERF
42127348400000,PI,IP,001,10,10433,10657,8635,224,PERF
42127348400000,PI,IP,001,11,10754,10977,8635,223,PERF
42127348400000,PI,IP,001,12,11080,11296,8635,216,PERF
42127348400000,PI,IP,001,13,11400,11617,8635,217,PERF
42127348400000,PI,IP,001,14,11720,11938,8635,218,PERF
42127348400000,PI,IP,001,15,12038,12259,8635,221,PERF
42127348400000,PI,IP,001,16,12359,12580,8635,221,PERF
42127348400000,PI,IP,001,17,12680,12901,8635,221,PERF
42127348400000,PI,IP,001,18,13001,13222,8635,221,PERF
42127348400000,PI,IP,001,19,13322,13542,8635,220,PERF
42127348400000,PI,IP,001,20,13643,13864,8635,221,PERF
42127348400000,PI,IP,001,21,13964,14188,8635,224,PERF
42127348400000,PI,IP,001,22,14285,14501,8635,216,PERF
42127348400000,PI,IP,001,23,14606,14824,8635,218,PERF
42127348400000,PI,IP,001,24,14945,15154,8635,209,PERF
42127348420000,PI,IP,001,1,6883,13238,6683,6355,PERF
42127348460100,PI,IP,001,1,8029,11117,3622,3088,PERF
42127348470000,PI,PT,001,1,8039,12521,,4482,PERF
42127348480100,PI,PT,001,1,8059,12765,,4706,PERF
42127348490000,PI,PT,001,1,8024,12499,,4475,PERF
42127348570000,PI,IP,001,1,7838,14654,6964,6816,PERF
42127348580000,PI,IP,001,1,7601,12240,4969,4639,PERF
42127348590000,PI,IP,001,1,6632,11219,4833,4587,PERF
42127348600000,PI,IP,001,1,7696,13718,6407,6022,PERF
42127348610000,PI,IP,001,1,7184,11934,4960,4750,PERF
42127348670000,PI,IP,001,1,6741,11671,6513,4930,PERF
42127348680000,PI,IP,001,1,6726,12387,7180,5661,PERF
42127348780000,PI,IP,001,1,7723,13298,,5575,PERF
42127348790000,PI,IP,001,1,7449,12341,5565,4892,PERF
42127348800000,PI,IP,001,1,7684,13665,6495,5981,PERF
42127348870000,PI,IP,001,1,7650,14550,7470,6900,PERF
42127348920000,PI,IP,001,1,6783,14514,8800,7731,PERF
42127348950000,PI,IP,001,1,6864,13050,6462,6186,PERF
42127349000000,PI,IP,001,1,6816,14166,8360,7350,PERF
42127349010000,PI,IP,001,1,7067,11595,5036,4528,PERF
42127349020100,PI,IP,001,1,7506,12540,5821,5034,PERF
42127349070000,PI,IP,001,1,7122,11780,4926,4658,PERF
42127349090000,PI,IP,001,1,7379,12635,5796,5256,PERF
42127349100000,PI,IP,001,1,9263,14337,6595,5074,PERF
42127349110000,PI,PT,001,1,8878,14041,,5163,PERF
42127349120000,PI,IP,001,1,7173,15301,8367,8128,PERF
42127349150000,PI,IP,001,1,8769,13920,6298,5151,PERF
42127349350000,PI,IP,001,1,6794,11227,4704,4433,PERF
42127349380000,PI,PT,001,1,7794,13117,,5323,PERF
42127349410000,PI,PT,001,1,7842,13127,,5285,PERF
42127349430000,PI,PT,001,1,8734,13814,,5080,PERF
42127349440000,PI,PT,001,1,9145,13916,,4771,PERF
42127349450000,PI,PT,001,1,9416,14087,,4671,PERF
42127349460000,PI,PT,001,1,8117,12614,,4497,PERF
42127349470000,PI,PT,001,1,7732,12559,,4827,PERF
42127349480000,PI,PT,001,1,7619,12444,,4825,PERF
42127349490000,PI,PT,001,1,7752,12454,,4702,PERF
42127349520000,PI,IP,001,1,6533,13328,7198,6795,PERF
42127349550000,PI,IP,001,1,6381,13657,7738,7276,PERF
42127349590000,PI,PT,001,1,8468,12468,,4000,PERF
42127349600000,PI,PT,001,1,7803,12336,,4533,PERF
42127349660000,PI,IP,001,1,7030,12225,5902,5195,PERF
42127349680000,PI,IP,001,1,7780,12597,5094,4817,PERF
42127349690000,PI,PT,001,1,8060,12670,,4610,PERF
42127349740000,PI,IP,001,1,7894,12139,5311,4245,PERF
42127349850000,PI,IP,001,1,7141,11687,5236,4546,PERF
42127349870100,PI,IP,001,1,7059,11600,5215,4541,PERF
42127349880000,PI,IP,001,1,7168,11778,5262,4610,PERF
42127349900000,PI,IP,001,1,6561,13255,7622,6694,PERF
42127349920000,PI,IP,001,1,6878,13279,7495,6401,PERF
42127349960000,PI,IP,001,1,6822,11919,,5097,PERF
42127350060000,PI,IP,001,1,6903,11646,4896,4743,PERF
42127350070000,PI,IP,001,1,6507,13518,7234,7011,PERF
42127350100000,PI,IP,001,1,7030,11684,5161,4654,PERF
42127350360000,PI,IP,001,1,7729,7940,11410,211,PERF
42127350360000,PI,IP,001,2,8040,8254,11410,214,PERF
42127350360000,PI,IP,001,3,8346,8568,11410,222,PERF
42127350360000,PI,IP,001,4,8668,8882,11410,214,PERF
42127350360000,PI,IP,001,5,8982,9196,11410,214,PERF
42127350360000,PI,IP,001,6,9288,9510,11410,222,PERF
42127350360000,PI,IP,001,7,9604,9824,11410,220,PERF
42127350360000,PI,IP,001,8,9924,10138,11410,214,PERF
42127350360000,PI,IP,001,9,10238,10452,11410,214,PERF
42127350360000,PI,IP,001,10,10552,10766,11410,214,PERF
42127350360000,PI,IP,001,11,10866,11080,11410,214,PERF
42127350360000,PI,IP,001,12,11174,11394,11410,220,PERF
42127350360000,PI,IP,001,13,11494,11699,11410,205,PERF
42127350360000,PI,IP,001,14,11808,12022,11410,214,PERF
42127350360000,PI,IP,001,15,12122,12336,11410,214,PERF
42127350360000,PI,IP,001,16,12433,12650,11410,217,PERF
42127350360000,PI,IP,001,17,12750,12964,11410,214,PERF
42127350360000,PI,IP,001,18,13064,13278,11410,214,PERF
42127350360000,PI,IP,001,19,13370,13597,11410,227,PERF
42127350360000,PI,IP,001,20,13692,13900,11410,208,PERF
42127350360000,PI,IP,001,21,14006,14220,11410,214,PERF
42127350360000,PI,IP,001,22,14324,14534,11410,210,PERF
42127350360000,PI,IP,001,23,14634,14848,11410,214,PERF
42127350360000,PI,IP,001,24,14948,15162,11410,214,PERF
42127350360000,PI,IP,001,25,15247,15476,11410,229,PERF
42127350360000,PI,IP,001,26,15576,15785,11410,209,PERF
42127350360000,PI,IP,001,27,15890,16104,11410,214,PERF
42127350360000,PI,IP,001,28,16204,16418,11410,214,PERF
42127350360000,PI,IP,001,29,16508,16735,11410,227,PERF
42127350360000,PI,IP,001,30,16832,17043,11410,211,PERF
42127350360000,PI,IP,001,31,17146,17357,11410,211,PERF
42127350360000,PI,IP,001,32,17461,17570,11410,109,PERF
42127350360000,PI,IP,001,33,17653,17759,11410,106,PERF
42127350400000,PI,IP,001,1,7102,12126,5696,5024,PERF
23153001990000,PI,IP,001,1,4832,4839,,7,PERF
23153001990000,PI,IP,001,2,4856,4884,,28,PERF
23153001990000,PI,IP,001,3,4905,4921,,16,PERF
23153001990000,PI,PT,001,1,4832,4839,,7,PERF
23153001990000,PI,PT,001,2,4856,4884,,28,PERF
23153001990000,PI,PT,001,3,4905,4917,,12,PERF
23153001990000,PI,PT,002,4,4832,4838,,6,PERF
23153001990000,PI,PT,002,5,4860,4882,,22,PERF
23153001990000,PI,PT,002,6,4906,4921,,15,PERF
23153001990000,PI,PT,003,7,4832,4882,,50,PERF
23153001990000,PI,PT,003,8,4906,4921,,15,PERF
42163333890000,PI,IP,001,1,7742,7750,,8,PERF
42163333890000,PI,IP,001,2,7790,7829,,39,PERF
42163334030100,PI,IP,001,1,7794,7797,3506,3,PERF
42163334030100,PI,IP,001,2,7872,7875,3506,3,PERF
42163334030100,PI,IP,001,3,7954,7957,3506,3,PERF
42163334030100,PI,IP,001,4,8038,8041,3506,3,PERF
42163334030100,PI,IP,001,5,8110,8113,3506,3,PERF
42163334030100,PI,IP,001,6,8194,8197,3506,3,PERF
42163334030100,PI,IP,001,7,8282,8285,3506,3,PERF
42163334030100,PI,IP,001,8,8360,8363,3506,3,PERF
42163334030100,PI,IP,001,9,8438,8441,3506,3,PERF
42163334030100,PI,IP,001,10,8526,8529,3506,3,PERF
42163334030100,PI,IP,001,11,8604,8607,3506,3,PERF
42163334030100,PI,IP,001,12,8680,8683,3506,3,PERF
42163334030100,PI,IP,001,13,8780,8783,3506,3,PERF
42163334030100,PI,IP,001,14,8848,8851,3506,3,PERF
42163334030100,PI,IP,001,15,8926,8929,3506,3,PERF
42163334030100,PI,IP,001,16,9014,9017,3506,3,PERF
42163334030100,PI,IP,001,17,9092,9095,3506,3,PERF
42163334030100,PI,IP,001,18,9162,9165,3506,3,PERF
42163334030100,PI,IP,001,19,9268,9271,3506,3,PERF
42163334030100,PI,IP,001,20,9336,9339,3506,3,PERF
42163334030100,PI,IP,001,21,9414,9417,3506,3,PERF
42163334030100,PI,IP,001,22,9502,9505,3506,3,PERF
42163334030100,PI,IP,001,23,9580,9583,3506,3,PERF
42163334030100,PI,IP,001,24,9658,9661,3506,3,PERF
42163334030100,PI,IP,001,25,9746,9749,3506,3,PERF
42163334030100,PI,IP,001,26,9824,9827,3506,3,PERF
42163334030100,PI,IP,001,27,9902,9905,3506,3,PERF
42163334030100,PI,IP,001,28,9990,9993,3506,3,PERF
42163334030100,PI,IP,001,29,10068,10071,3506,3,PERF
42163334030100,PI,IP,001,30,10140,10143,3506,3,PERF
42163334030100,PI,IP,001,31,10234,10237,3506,3,PERF
42163334030100,PI,IP,001,32,10312,10315,3506,3,PERF
42163334030100,PI,IP,001,33,10390,10393,3506,3,PERF
42163334030100,PI,IP,001,34,10478,10481,3506,3,PERF
42163334030100,PI,IP,001,35,10560,10563,3506,3,PERF
42163334030100,PI,IP,001,36,10634,10637,3506,3,PERF
42163334030100,PI,IP,001,37,10722,10725,3506,3,PERF
42163334030100,PI,IP,001,38,10800,10803,3506,3,PERF
42163334030100,PI,IP,001,39,10878,10881,3506,3,PERF
42163334030100,PI,IP,001,40,10952,10956,3506,4,PERF
42163334030100,PI,IP,001,41,11031,11035,3506,4,PERF
42163334130000,PI,IP,001,1,7724,7950,5111,226,PERF
42163334130000,PI,IP,001,2,8039,8265,5111,226,PERF
42163334130000,PI,IP,001,3,8354,8580,5111,226,PERF
42163334130000,PI,IP,001,4,8669,8895,5111,226,PERF
42163334130000,PI,IP,001,5,8984,9210,5111,226,PERF
42163334130000,PI,IP,001,6,9299,9525,5111,226,PERF
42163334130000,PI,IP,001,7,9614,9840,5111,226,PERF
42163334130000,PI,IP,001,8,9929,10155,5111,226,PERF
42163334130000,PI,IP,001,9,10244,10470,5111,226,PERF
42163334130000,PI,IP,001,10,10559,10785,5111,226,PERF
42163334130000,PI,IP,001,11,10874,11100,5111,226,PERF
42163334130000,PI,IP,001,12,11189,11415,5111,226,PERF
42163334130000,PI,IP,001,13,11504,11730,5111,226,PERF
42163334130000,PI,IP,001,14,11819,12045,5111,226,PERF
42163334130000,PI,IP,001,15,12134,12360,5111,226,PERF
42163334150000,PI,IP,001,1,8638,8641,6652,3,PERF
42163334150000,PI,IP,001,2,8732,8735,6652,3,PERF
42163334150000,PI,IP,001,3,8837,8840,6652,3,PERF
42163334150000,PI,IP,001,4,8942,8945,6652,3,PERF
42163334150000,PI,IP,001,5,9040,9043,6652,3,PERF
42163334150000,PI,IP,001,6,9138,9141,6652,3,PERF
42163334150000,PI,IP,001,7,9240,9243,6652,3,PERF
42163334150000,PI,IP,001,8,9341,9344,6652,3,PERF
42163334150000,PI,IP,001,9,9439,9442,6652,3,PERF
42163334150000,PI,IP,001,10,9544,9547,6652,3,PERF
42163334150000,PI,IP,001,11,9642,9645,6652,3,PERF
42163334150000,PI,IP,001,12,9740,9743,6652,3,PERF
42163334150000,PI,IP,001,13,9850,9853,6652,3,PERF
42163334150000,PI,IP,001,14,9943,9946,6652,3,PERF
42163334150000,PI,IP,001,15,10041,10044,6652,3,PERF
42163334150000,PI,IP,001,16,10146,10149,6652,3,PERF
42163334150000,PI,IP,001,17,10244,10247,6652,3,PERF
42163334150000,PI,IP,001,18,10338,10341,6652,3,PERF
42163334150000,PI,IP,001,19,10447,10450,6652,3,PERF
42163334150000,PI,IP,001,20,10545,10548,6652,3,PERF
42163334150000,PI,IP,001,21,10643,10646,6652,3,PERF
42163334150000,PI,IP,001,22,10748,10751,6652,3,PERF
42163334150000,PI,IP,001,23,10848,10851,6652,3,PERF
42163334150000,PI,IP,001,24,10944,10947,6652,3,PERF
42163334150000,PI,IP,001,25,11046,11049,6652,3,PERF
42163334150000,PI,IP,001,26,11147,11150,6652,3,PERF
42163334150000,PI,IP,001,27,11245,11248,6652,3,PERF
42163334150000,PI,IP,001,28,11350,11353,6652,3,PERF
42163334150000,PI,IP,001,29,11448,11451,6652,3,PERF
42163334150000,PI,IP,001,30,11546,11549,6652,3,PERF
42163334150000,PI,IP,001,31,11653,11656,6652,3,PERF
42163334150000,PI,IP,001,32,11749,11752,6652,3,PERF
42163334150000,PI,IP,001,33,11847,11850,6652,3,PERF
42163334150000,PI,IP,001,34,11952,11955,6652,3,PERF
42163334150000,PI,IP,001,35,12050,12053,6652,3,PERF
42163334150000,PI,IP,001,36,12148,12151,6652,3,PERF
42163334150000,PI,IP,001,37,12253,12256,6652,3,PERF
42163334150000,PI,IP,001,38,12351,12354,6652,3,PERF
42163334150000,PI,IP,001,39,12449,12452,6652,3,PERF
42163334150000,PI,IP,001,40,12554,12557,6652,3,PERF
42163334150000,PI,IP,001,41,12652,12655,6652,3,PERF
42163334150000,PI,IP,001,42,12750,12753,6652,3,PERF
42163334150000,PI,IP,001,43,12855,12858,6652,3,PERF
42163334150000,PI,IP,001,44,12953,12956,6652,3,PERF
42163334150000,PI,IP,001,45,13051,13054,6652,3,PERF
42163334150000,PI,IP,001,46,13150,13153,6652,3,PERF
42163334150000,PI,IP,001,47,13254,13257,6652,3,PERF
42163334150000,PI,IP,001,48,13352,13355,6652,3,PERF
42163334150000,PI,IP,001,49,13457,13460,6652,3,PERF
42163334150000,PI,IP,001,50,13553,13556,6652,3,PERF
42163334150000,PI,IP,001,51,13655,13658,6652,3,PERF
42163334150000,PI,IP,001,52,13758,13761,6652,3,PERF
42163334150000,PI,IP,001,53,13856,13859,6652,3,PERF
42163334150000,PI,IP,001,54,13954,13957,6652,3,PERF
42163334150000,PI,IP,001,55,14059,14062,6652,3,PERF
42163334150000,PI,IP,001,56,14157,14160,6652,3,PERF
42163334150000,PI,IP,001,57,14255,14258,6652,3,PERF
42163334150000,PI,IP,001,58,14360,14364,6652,4,PERF
42163334150000,PI,IP,001,59,14459,14463,6652,4,PERF
42163334150000,PI,IP,001,60,14558,14562,6652,4,PERF
42163334160000,PI,IP,001,1,7346,7562,4615,216,PERF
42163334160000,PI,IP,001,2,7641,7857,4615,216,PERF
42163334160000,PI,IP,001,3,7936,8152,4615,216,PERF
42163334160000,PI,IP,001,4,8231,8447,4615,216,PERF
42163334160000,PI,IP,001,5,8526,8742,4615,216,PERF
42163334160000,PI,IP,001,6,8821,9037,4615,216,PERF
42163334160000,PI,IP,001,7,9116,9332,4615,216,PERF
42163334160000,PI,IP,001,8,9411,9627,4615,216,PERF
42163334160000,PI,IP,001,9,9706,9922,4615,216,PERF
42163334160000,PI,IP,001,10,10001,10217,4615,216,PERF
42163334160000,PI,IP,001,11,10296,10512,4615,216,PERF
42163334160000,PI,IP,001,12,10591,10806,4615,215,PERF
42163334160000,PI,IP,001,13,10886,11102,4615,216,PERF
42163334160000,PI,IP,001,14,11181,11397,4615,216,PERF
42163334190000,PI,IP,001,1,8574,8577,5608,3,PERF
42163334190000,PI,IP,001,2,8672,8675,5608,3,PERF
42163334190000,PI,IP,001,3,8770,8773,5608,3,PERF
42163334190000,PI,IP,001,4,8878,8881,5608,3,PERF
42163334190000,PI,IP,001,5,8973,8976,5608,3,PERF
42163334190000,PI,IP,001,6,9074,9077,5608,3,PERF
42163334190000,PI,IP,001,7,9176,9179,5608,3,PERF
42163334190000,PI,IP,001,8,9277,9280,5608,3,PERF
42163334190000,PI,IP,001,9,9372,9375,5608,3,PERF
42163334190000,PI,IP,001,10,9480,9483,5608,3,PERF
42163334190000,PI,IP,001,11,9575,9578,5608,3,PERF
42163334190000,PI,IP,001,12,9673,9676,5608,3,PERF
42163334190000,PI,IP,001,13,9778,9781,5608,3,PERF
42163334190000,PI,IP,001,14,9876,9879,5608,3,PERF
42163334190000,PI,IP,001,15,9974,9977,5608,3,PERF
42163334190000,PI,IP,001,16,10079,10082,5608,3,PERF
42163334190000,PI,IP,001,17,10177,10180,5608,3,PERF
42163334190000,PI,IP,001,18,10273,10276,5608,3,PERF
42163334190000,PI,IP,001,19,10380,10383,5608,3,PERF
42163334190000,PI,IP,001,20,10476,10479,5608,3,PERF
42163334190000,PI,IP,001,21,10576,10579,5608,3,PERF
42163334190000,PI,IP,001,22,10681,10684,5608,3,PERF
42163334190000,PI,IP,001,23,10779,10782,5608,3,PERF
42163334190000,PI,IP,001,24,10877,10880,5608,3,PERF
42163334190000,PI,IP,001,25,10982,10985,5608,3,PERF
42163334190000,PI,IP,001,26,11080,11083,5608,3,PERF
42163334190000,PI,IP,001,27,11178,11181,5608,3,PERF
42163334190000,PI,IP,001,28,11283,11286,5608,3,PERF
42163334190000,PI,IP,001,29,11381,11384,5608,3,PERF
42163334190000,PI,IP,001,30,11479,11482,5608,3,PERF
42163334190000,PI,IP,001,31,11584,11587,5608,3,PERF
42163334190000,PI,IP,001,32,11682,11685,5608,3,PERF
42163334190000,PI,IP,001,33,11780,11783,5608,3,PERF
42163334190000,PI,IP,001,34,11885,11888,5608,3,PERF
42163334190000,PI,IP,001,35,11983,11986,5608,3,PERF
42163334190000,PI,IP,001,36,12081,12084,5608,3,PERF
42163334190000,PI,IP,001,37,12186,12189,5608,3,PERF
42163334190000,PI,IP,001,38,12264,12267,5608,3,PERF
42163334190000,PI,IP,001,39,12340,12343,5608,3,PERF
42163334190000,PI,IP,001,40,12421,12424,5608,3,PERF
42163334190000,PI,IP,001,41,12426,12429,5608,3,PERF
42163334190000,PI,IP,001,42,12487,12490,5608,3,PERF
42163334190000,PI,IP,001,43,12585,12588,5608,3,PERF
42163334190000,PI,IP,001,44,12683,12686,5608,3,PERF
42163334190000,PI,IP,001,45,12788,12792,5608,4,PERF
42163334190000,PI,IP,001,46,12887,12891,5608,4,PERF
42163334190000,PI,IP,001,47,12979,12983,5608,4,PERF
42163334250000,PI,IP,001,1,7785,8065,8058,280,PERF
42163334250000,PI,IP,001,2,8155,8436,8058,281,PERF
42163334250000,PI,IP,001,3,8525,8806,8058,281,PERF
42163334250000,PI,IP,001,4,8895,9176,8058,281,PERF
42163334250000,PI,IP,001,5,9265,9546,8058,281,PERF
42163334250000,PI,IP,001,6,9635,9916,8058,281,PERF
42163334250000,PI,IP,001,7,10005,10286,8058,281,PERF
42163334250000,PI,IP,001,8,10375,10656,8058,281,PERF
42163334250000,PI,IP,001,9,10745,11026,8058,281,PERF
42163334250000,PI,IP,001,10,11115,11396,8058,281,PERF
42163334250000,PI,IP,001,11,11485,11766,8058,281,PERF
42163334250000,PI,IP,001,12,11855,12136,8058,281,PERF
42163334250000,PI,IP,001,13,12225,12506,8058,281,PERF
42163334250000,PI,IP,001,14,12595,12876,8058,281,PERF
42163334250000,PI,IP,001,15,12965,13246,8058,281,PERF
42163334250000,PI,IP,001,16,13335,13616,8058,281,PERF
42163334250000,PI,IP,001,17,13705,13986,8058,281,PERF
42163334250000,PI,IP,001,18,14075,14356,8058,281,PERF
42163334270000,PI,IP,001,1,6965,7170,4737,205,PERF
42163334270000,PI,IP,001,2,7242,7440,4737,198,PERF
42163334270000,PI,IP,001,3,7503,7710,4737,207,PERF
42163334270000,PI,IP,001,4,7782,7980,4737,198,PERF
42163334270000,PI,IP,001,5,8041,8250,4737,209,PERF
42163334270000,PI,IP,001,6,8322,8520,4737,198,PERF
42163334270000,PI,IP,001,7,8592,8826,4737,234,PERF
42163334270000,PI,IP,001,8,8862,9060,4737,198,PERF
42163334270000,PI,IP,001,9,9132,9326,4737,194,PERF
42163334270000,PI,IP,001,10,9402,9636,4737,234,PERF
42163334270000,PI,IP,001,11,9672,9960,4737,288,PERF
42163334270000,PI,IP,001,12,9942,10172,4737,230,PERF
42163334270000,PI,IP,001,13,10212,10446,4737,234,PERF
42163334270000,PI,IP,001,14,10482,10680,4737,198,PERF
42163334310000,PI,IP,001,1,8284,8454,6127,170,PERF
42163334310000,PI,IP,001,2,8508,8678,6127,170,PERF
42163334310000,PI,IP,001,3,8732,8902,6127,170,PERF
42163334310000,PI,IP,001,4,8956,9126,6127,170,PERF
42163334310000,PI,IP,001,5,9180,9350,6127,170,PERF
42163334310000,PI,IP,001,6,9404,9574,6127,170,PERF
42163334310000,PI,IP,001,7,9628,9798,6127,170,PERF
42163334310000,PI,IP,001,8,9852,10022,6127,170,PERF
42163334310000,PI,IP,001,9,10076,10246,6127,170,PERF
42163334310000,PI,IP,001,10,10300,10470,6127,170,PERF
42163334310000,PI,IP,001,11,10524,10694,6127,170,PERF
42163334310000,PI,IP,001,12,10748,10918,6127,170,PERF
42163334310000,PI,IP,001,13,10972,11142,6127,170,PERF
42163334310000,PI,IP,001,14,11220,11465,6127,245,PERF
42163334310000,PI,IP,001,15,11544,11789,6127,245,PERF
42163334310000,PI,IP,001,16,11868,12038,6127,170,PERF
42163334310000,PI,IP,001,17,12092,12262,6127,170,PERF
42163334310000,PI,IP,001,18,12316,12486,6127,170,PERF
42163334310000,PI,IP,001,19,12540,12710,6127,170,PERF
42163334310000,PI,IP,001,20,12764,12934,6127,170,PERF
42163334310000,PI,IP,001,21,12988,13158,6127,170,PERF
42163334310000,PI,IP,001,22,13212,13326,6127,114,PERF
42163334330101,PI,IP,001,1,6240,6342,,102,PERF
42163334340000,PI,IP,001,1,9097,12610,,3513,PERF
42163334370000,PI,IP,001,1,8574,8577,7475,3,PERF
42163334370000,PI,IP,001,2,8671,8674,7475,3,PERF
42163334370000,PI,IP,001,3,8768,8771,7475,3,PERF
42163334370000,PI,IP,001,4,8865,8868,7475,3,PERF
42163334370000,PI,IP,001,5,8962,8965,7475,3,PERF
42163334370000,PI,IP,001,6,9059,9062,7475,3,PERF
42163334370000,PI,IP,001,7,9156,9159,7475,3,PERF
42163334370000,PI,IP,001,8,9253,9256,7475,3,PERF
42163334370000,PI,IP,001,9,9350,9353,7475,3,PERF
42163334370000,PI,IP,001,10,9447,9450,7475,3,PERF
42163334370000,PI,IP,001,11,9540,9543,7475,3,PERF
42163334370000,PI,IP,001,12,9641,9644,7475,3,PERF
42163334370000,PI,IP,001,13,9798,9801,7475,3,PERF
42163334370000,PI,IP,001,14,9874,9877,7475,3,PERF
42163334370000,PI,IP,001,15,9899,9902,7475,3,PERF
42163334370000,PI,IP,001,16,9955,9958,7475,3,PERF
42163334370000,PI,IP,001,17,10183,10186,7475,3,PERF
42163334370000,PI,IP,001,18,10261,10264,7475,3,PERF
42163334370000,PI,IP,001,19,10289,10292,7475,3,PERF
42163334370000,PI,IP,001,20,10342,10345,7475,3,PERF
42163334370000,PI,IP,001,21,10570,10573,7475,3,PERF
42163334370000,PI,IP,001,22,10650,10653,7475,3,PERF
42163334370000,PI,IP,001,23,10676,10679,7475,3,PERF
42163334370000,PI,IP,001,24,10732,10735,7475,3,PERF
42163334370000,PI,IP,001,25,10957,10960,7475,3,PERF
42163334370000,PI,IP,001,26,11035,11038,7475,3,PERF
42163334370000,PI,IP,001,27,11063,11068,7475,5,PERF
42163334370000,PI,IP,001,28,11116,11119,7475,3,PERF
42163334370000,PI,IP,001,29,11344,11347,7475,3,PERF
42163334370000,PI,IP,001,30,11422,11425,7475,3,PERF
42163334370000,PI,IP,001,31,11450,11453,7475,3,PERF
42163334370000,PI,IP,001,32,11503,11506,7475,3,PERF
42163334370000,PI,IP,001,33,11678,11681,7475,3,PERF
42163334370000,PI,IP,001,34,11775,11778,7475,3,PERF
42163334370000,PI,IP,001,35,11872,11875,7475,3,PERF
42163334370000,PI,IP,001,36,11969,11972,7475,3,PERF
42163334370000,PI,IP,001,37,12066,12069,7475,3,PERF
42163334370000,PI,IP,001,38,12163,12166,7475,3,PERF
42163334370000,PI,IP,001,39,12260,12263,7475,3,PERF
42163334370000,PI,IP,001,40,12353,12356,7475,3,PERF
42163334370000,PI,IP,001,41,12454,12457,7475,3,PERF
42163334370000,PI,IP,001,42,12551,12554,7475,3,PERF
42163334370000,PI,IP,001,43,12650,12653,7475,3,PERF
42163334370000,PI,IP,001,44,12745,12748,7475,3,PERF
42163334370000,PI,IP,001,45,12840,12843,7475,3,PERF
42163334370000,PI,IP,001,46,12939,12942,7475,3,PERF
42163334370000,PI,IP,001,47,13036,13039,7475,3,PERF
42163334370000,PI,IP,001,48,13133,13136,7475,3,PERF
42163334370000,PI,IP,001,49,13230,13233,7475,3,PERF
42163334370000,PI,IP,001,50,13327,13330,7475,3,PERF
42163334370000,PI,IP,001,51,13428,13431,7475,3,PERF
42163334370000,PI,IP,001,52,13521,13524,7475,3,PERF
42163334370000,PI,IP,001,53,13618,13621,7475,3,PERF
42163334370000,PI,IP,001,54,13715,13718,7475,3,PERF
42163334370000,PI,IP,001,55,13812,13815,7475,3,PERF
42163334370000,PI,IP,001,56,13909,13912,7475,3,PERF
42163334370000,PI,IP,001,57,14006,14009,7475,3,PERF
42163334370000,PI,IP,001,58,14103,14106,7475,3,PERF
42163334370000,PI,IP,001,59,14197,14200,7475,3,PERF
42163334370000,PI,IP,001,60,14297,14300,7475,3,PERF
42163334370000,PI,IP,001,61,14394,14397,7475,3,PERF
42163334370000,PI,IP,001,62,14488,14491,7475,3,PERF
42163334370000,PI,IP,001,63,14588,14591,7475,3,PERF
42163334370000,PI,IP,001,64,14685,14688,7475,3,PERF
42163334370000,PI,IP,001,65,14782,14785,7475,3,PERF
42163334370000,PI,IP,001,66,14879,14882,7475,3,PERF
42163334370000,PI,IP,001,67,14976,14979,7475,3,PERF
42163334370000,PI,IP,001,68,15073,15076,7475,3,PERF
42163334370000,PI,IP,001,69,15170,15173,7475,3,PERF
42163334370000,PI,IP,001,70,15267,15270,7475,3,PERF
42163334370000,PI,IP,001,71,15364,15367,7475,3,PERF
42163334370000,PI,IP,001,72,15461,15464,7475,3,PERF
42163334380200,PI,IP,001,1,8246,8248,4662,2,PERF
42163334380200,PI,IP,001,2,8342,8344,4662,2,PERF
42163334380200,PI,IP,001,3,8439,8441,4662,2,PERF
42163334380200,PI,IP,001,4,8535,8537,4662,2,PERF
42163334380200,PI,IP,001,5,8631,8633,4662,2,PERF
42163334380200,PI,IP,001,6,8728,8730,4662,2,PERF
42163334380200,PI,IP,001,7,8824,8826,4662,2,PERF
42163334380200,PI,IP,001,8,8920,8922,4662,2,PERF
42163334380200,PI,IP,001,9,9016,9018,4662,2,PERF
42163334380200,PI,IP,001,10,9113,9115,4662,2,PERF
42163334380200,PI,IP,001,11,9209,9211,4662,2,PERF
42163334380200,PI,IP,001,12,9305,9307,4662,2,PERF
42163334380200,PI,IP,001,13,9402,9404,4662,2,PERF
42163334380200,PI,IP,001,14,9498,9500,4662,2,PERF
42163334380200,PI,IP,001,15,9594,9596,4662,2,PERF
42163334380200,PI,IP,001,16,9690,9692,4662,2,PERF
42163334380200,PI,IP,001,17,9787,9789,4662,2,PERF
42163334380200,PI,IP,001,18,9883,9885,4662,2,PERF
42163334380200,PI,IP,001,19,9979,9981,4662,2,PERF
42163334380200,PI,IP,001,20,10076,10078,4662,2,PERF
42163334380200,PI,IP,001,21,10172,10174,4662,2,PERF
42163334380200,PI,IP,001,22,10268,10270,4662,2,PERF
42163334380200,PI,IP,001,23,10364,10366,4662,2,PERF
42163334380200,PI,IP,001,24,10461,10463,4662,2,PERF
42163334380200,PI,IP,001,25,10557,10559,4662,2,PERF
42163334380200,PI,IP,001,26,10653,10655,4662,2,PERF
42163334380200,PI,IP,001,27,10750,10752,4662,2,PERF
42163334380200,PI,IP,001,28,10846,10848,4662,2,PERF
42163334380200,PI,IP,001,29,10942,10944,4662,2,PERF
42163334380200,PI,IP,001,30,11038,11040,4662,2,PERF
42163334380200,PI,IP,001,31,11135,11137,4662,2,PERF
42163334380200,PI,IP,001,32,11231,11233,4662,2,PERF
42163334380200,PI,IP,001,33,11327,11329,4662,2,PERF
42163334380200,PI,IP,001,34,11424,11426,4662,2,PERF
42163334380200,PI,IP,001,35,11520,11522,4662,2,PERF
42163334380200,PI,IP,001,36,11616,11618,4662,2,PERF
42163334380200,PI,IP,001,37,11712,11714,4662,2,PERF
42163334380200,PI,IP,001,38,11809,11811,4662,2,PERF
42163334380200,PI,IP,001,39,11905,11907,4662,2,PERF
42163334380200,PI,IP,001,40,12040,12042,4662,2,PERF
42163334380200,PI,IP,001,41,12120,12122,4662,2,PERF
42163334380200,PI,IP,001,42,12214,12216,4662,2,PERF
42163334380200,PI,IP,001,43,12249,12251,4662,2,PERF
42163334380200,PI,IP,001,44,12345,12347,4662,2,PERF
42163334380200,PI,IP,001,45,12442,12444,4662,2,PERF
42163334390000,PI,IP,001,1,8503,15153,7299,6650,PERF
42163334400000,PI,IP,001,1,8428,15034,7043,6606,PERF
42163334420000,PI,IP,001,1,8020,11845,5234,3825,PERF
42163334450000,PI,IP,001,1,6958,11752,5228,4794,OPENHOLE
42163334460000,PI,IP,001,1,14144,14144,6745,0,PERF
42163334460000,PI,IP,001,2,14194,14194,6745,0,PERF
42163334460000,PI,IP,001,3,14244,14244,6745,0,PERF
42163334460000,PI,IP,001,4,14294,14294,6745,0,PERF
42163334460000,PI,IP,001,5,14344,14344,6745,0,PERF
42163334460000,PI,IP,001,6,14394,14394,6745,0,PERF
42163334460000,PI,IP,001,7,14444,14444,6745,0,PERF
42163334460000,PI,IP,001,8,14494,14494,6745,0,PERF
42163334460000,PI,IP,001,9,14544,14544,6745,0,PERF
42163334530000,PI,IP,001,1,8103,13105,5645,5002,PERF
42163334560000,PI,IP,001,1,8354,8356,5965,2,PERF
42163334560000,PI,IP,001,2,8663,8665,5965,2,PERF
42163334560000,PI,IP,001,3,8932,8934,5965,2,PERF
42163334560000,PI,IP,001,4,9201,9203,5965,2,PERF
42163334560000,PI,IP,001,5,9549,9551,5965,2,PERF
42163334560000,PI,IP,001,6,9857,9859,5965,2,PERF
42163334560000,PI,IP,001,7,10205,10207,5965,2,PERF
42163334560000,PI,IP,001,8,10511,10513,5965,2,PERF
42163334560000,PI,IP,001,9,10817,10819,5965,2,PERF
42163334560000,PI,IP,001,10,11126,11128,5965,2,PERF
42163334560000,PI,IP,001,11,11393,11395,5965,2,PERF
42163334560000,PI,IP,001,12,11702,11704,5965,2,PERF
42163334560000,PI,IP,001,13,12011,12013,5965,2,PERF
42163334560000,PI,IP,001,14,12320,12322,5965,2,PERF
42163334560000,PI,IP,001,15,12631,12633,5965,2,PERF
42163334560000,PI,IP,001,16,13019,13021,5965,2,PERF
42163334560000,PI,IP,001,17,13243,13245,5965,2,PERF
42163334580000,PI,IP,001,1,8402,12819,5050,4417,PERF
42163334610000,PI,IP,001,1,8075,13403,5946,5328,PERF
42163334620000,PI,IP,001,1,8156,13626,6168,5470,PERF
42163334710000,PI,IP,001,1,7822,12442,5182,4620,PERF
42163334750000,PI,IP,001,1,7955,11533,4478,3578,PERF
42163334760000,PI,IP,001,1,7985,12635,5527,4650,PERF
42163334770000,PI,IP,001,1,12946,12946,5638,0,PERF
42163334780000,PI,IP,001,1,8585,8595,8420,10,PERF
42163334780000,PI,IP,001,2,8881,8891,8420,10,PERF
42163334780000,PI,IP,001,3,9177,9187,8420,10,PERF
42163334780000,PI,IP,001,4,9473,9483,8420,10,PERF
42163334780000,PI,IP,001,5,9769,9779,8420,10,PERF
42163334780000,PI,IP,001,6,10065,10075,8420,10,PERF
42163334780000,PI,IP,001,7,10361,10371,8420,10,PERF
42163334780000,PI,IP,001,8,10657,10667,8420,10,PERF
42163334780000,PI,IP,001,9,10953,10963,8420,10,PERF
42163334780000,PI,IP,001,10,11249,11259,8420,10,PERF
42163334780000,PI,IP,001,11,11535,11545,8420,10,PERF
42163334780000,PI,IP,001,12,12225,12235,8420,10,PERF
42163334780000,PI,IP,001,13,12760,12770,8420,10,PERF
42163334780000,PI,IP,001,14,13060,13070,8420,10,PERF
42163334780000,PI,IP,001,15,13360,13370,8420,10,PERF
42163334780000,PI,IP,001,16,13895,13905,8420,10,PERF
42163334780000,PI,IP,001,17,14175,14185,8420,10,PERF
42163334780000,PI,IP,001,18,14455,14465,8420,10,PERF
42163334780000,PI,IP,001,19,14735,14745,8420,10,PERF
42163334780000,PI,IP,001,20,15020,15022,8420,2,PERF
42163334780000,PI,IP,001,21,15301,15303,8420,2,PERF
42163334780000,PI,IP,001,22,15602,15604,8420,2,PERF
42163334780000,PI,IP,001,23,15915,15917,8420,2,PERF
42163334780000,PI,IP,001,24,16197,16199,8420,2,PERF
42163334790000,PI,IP,001,1,7921,11798,4470,3877,PERF
42163334820000,PI,IP,001,1,8636,8646,6012,10,PERF
42163334820000,PI,IP,001,2,8936,8946,6012,10,PERF
42163334820000,PI,IP,001,3,9474,9484,6012,10,PERF
42163334820000,PI,IP,001,4,10134,10144,6012,10,PERF
42163334820000,PI,IP,001,5,10390,10400,6012,10,PERF
42163334820000,PI,IP,001,6,10635,10645,6012,10,PERF
42163334820000,PI,IP,001,7,10880,10890,6012,10,PERF
42163334820000,PI,IP,001,8,11137,11147,6012,10,PERF
42163334820000,PI,IP,001,9,11395,11405,6012,10,PERF
42163334820000,PI,IP,001,10,11652,11662,6012,10,PERF
42163334820000,PI,IP,001,11,11895,11905,6012,10,PERF
42163334820000,PI,IP,001,12,12142,12152,6012,10,PERF
42163334820000,PI,IP,001,13,12399,12409,6012,10,PERF
42163334820000,PI,IP,001,14,12652,12662,6012,10,PERF
42163334820000,PI,IP,001,15,12901,12911,6012,10,PERF
42163334820000,PI,IP,001,16,13145,13155,6012,10,PERF
42163334820000,PI,IP,001,17,13427,14128,6012,701,PERF
42163334840000,PI,IP,001,1,7989,12287,5404,4298,PERF
42163334860000,PI,IP,001,1,7867,12313,5171,4446,PERF
42163334880000,PI,IP,001,1,7873,11669,4402,3796,PERF
42163334910000,PI,IP,001,1,7989,11256,4145,3267,PERF
42163334930000,PI,IP,001,1,7350,7503,5305,153,PERF
42163334930000,PI,IP,001,2,7650,7803,5305,153,PERF
42163334930000,PI,IP,001,3,7950,8103,5305,153,PERF
42163334930000,PI,IP,001,4,8250,8403,5305,153,PERF
42163334930000,PI,IP,001,5,8550,8703,5305,153,PERF
42163334930000,PI,IP,001,6,8850,9003,5305,153,PERF
42163334930000,PI,IP,001,7,9150,9303,5305,153,PERF
42163334930000,PI,IP,001,8,9450,9603,5305,153,PERF
42163334930000,PI,IP,001,9,9750,9903,5305,153,PERF
42163334930000,PI,IP,001,10,10050,10203,5305,153,PERF
42163334930000,PI,IP,001,11,10350,10503,5305,153,PERF
42163334930000,PI,IP,001,12,10650,10803,5305,153,PERF
42163334930000,PI,IP,001,13,10950,11103,5305,153,PERF
42163334930000,PI,IP,001,14,11250,11403,5305,153,PERF
42163334930000,PI,IP,001,15,11550,11723,5305,173,PERF
42163334930000,PI,IP,001,16,11850,12003,5305,153,PERF
42163334950000,PI,IP,001,1,6695,11202,5430,4507,PERF
42163334990000,PI,IP,001,1,8370,11881,4767,3511,PERF
42163335000000,PI,IP,001,1,7774,12684,5579,4910,PERF
42163335010000,PI,IP,001,1,8071,14425,7341,6354,PERF
42163335090000,PI,IP,001,1,7900,13453,6272,5553,PERF
42163335100000,PI,IP,001,1,8097,13048,5467,4951,PERF
42163335120000,PI,IP,001,1,8265,12409,5127,4144,PERF
42163335170000,PI,IP,001,1,7799,12312,5626,4513,PERF
42163335190000,PI,IP,001,1,7830,8041,5457,211,PERF
42163335190000,PI,IP,001,2,8140,8351,5457,211,PERF
42163335190000,PI,IP,001,3,8450,8661,5457,211,PERF
42163335190000,PI,IP,001,4,8760,8971,5457,211,PERF
42163335190000,PI,IP,001,5,9070,9281,5457,211,PERF
42163335190000,PI,IP,001,6,9380,9591,5457,211,PERF
42163335190000,PI,IP,001,7,9690,9901,5457,211,PERF
42163335190000,PI,IP,001,8,10000,10211,5457,211,PERF
42163335190000,PI,IP,001,9,10310,10521,5457,211,PERF
42163335190000,PI,IP,001,10,10620,10831,5457,211,PERF
42163335190000,PI,IP,001,11,10930,11141,5457,211,PERF
42163335190000,PI,IP,001,12,11240,11451,5457,211,PERF
42163335190000,PI,IP,001,13,11550,11761,5457,211,PERF
42163335190000,PI,IP,001,14,11860,12071,5457,211,PERF
42163335190000,PI,IP,001,15,12170,12381,5457,211,PERF
42163335190000,PI,IP,001,16,12480,12691,5457,211,PERF
42163335190000,PI,IP,001,17,12790,13001,5457,211,PERF
42177317890200,PI,IP,001,1,9326,11740,3380,2414,PERF
42177319790200,PI,IP,001,1,10740,10753,3204,13,PERF
42177319790200,PI,IP,001,2,10899,10903,3204,4,PERF
42177319790200,PI,IP,001,3,11099,11103,3204,4,PERF
42177319790200,PI,IP,001,4,11299,11303,3204,4,PERF
42177319790200,PI,IP,001,5,11499,11503,3204,4,PERF
42177319790200,PI,IP,001,6,11599,11603,3204,4,PERF
42177319790200,PI,IP,001,7,11699,11699,3204,0,PERF
42177319790200,PI,IP,001,8,11774,11774,3204,0,PERF
42177319790200,PI,IP,001,9,11849,11849,3204,0,PERF
42177320710100,PI,IP,001,1,11815,16272,4898,4457,PERF
42177320780000,PI,IP,001,1,11597,11603,4453,6,PERF
42177320780000,PI,IP,001,2,11750,11756,4453,6,PERF
42177320780000,PI,IP,001,3,11896,11902,4453,6,PERF
42177320780000,PI,IP,001,4,12047,12053,4453,6,PERF
42177320780000,PI,IP,001,5,12194,12200,4453,6,PERF
42177320780000,PI,IP,001,6,12347,12353,4453,6,PERF
42177320780000,PI,IP,001,7,12650,12656,4453,6,PERF
42177320780000,PI,IP,001,8,12797,12803,4453,6,PERF
42177320780000,PI,IP,001,9,12947,12953,4453,6,PERF
42177320780000,PI,IP,001,10,13097,13103,4453,6,PERF
42177320780000,PI,IP,001,11,13247,13253,4453,6,PERF
42177320780000,PI,IP,001,12,13394,13400,4453,6,PERF
42177320780000,PI,IP,001,13,13552,13558,4453,6,PERF
42177320780000,PI,IP,001,14,13697,13703,4453,6,PERF
42177320780000,PI,IP,001,15,13847,13853,4453,6,PERF
42177320780000,PI,IP,001,16,13997,14003,4453,6,PERF
42177320780000,PI,IP,001,17,14120,14126,4453,6,PERF
42177320780000,PI,IP,001,18,14430,14436,4453,6,PERF
42177320780000,PI,IP,001,19,14597,14603,4453,6,PERF
42177320780000,PI,IP,001,20,14760,14776,4453,16,PERF
42177320780000,PI,IP,001,21,15330,15336,4453,6,PERF
42177320780000,PI,IP,001,22,15366,15369,4453,3,PERF
42177320790000,PI,IP,001,1,11676,11682,3235,6,PERF
42177320790000,PI,IP,001,2,11826,11832,3235,6,PERF
42177320790000,PI,IP,001,3,11976,11982,3235,6,PERF
42177320790000,PI,IP,001,4,12126,12132,3235,6,PERF
42177320790000,PI,IP,001,5,12282,12288,3235,6,PERF
42177320790000,PI,IP,001,6,12426,12432,3235,6,PERF
42177320790000,PI,IP,001,7,12570,12576,3235,6,PERF
42177320790000,PI,IP,001,8,12726,12732,3235,6,PERF
42177320790000,PI,IP,001,9,12876,12882,3235,6,PERF
42177320790000,PI,IP,001,10,13026,13032,3235,6,PERF
42177320790000,PI,IP,001,11,13177,13183,3235,6,PERF
42177320790000,PI,IP,001,12,13326,13332,3235,6,PERF
42177320790000,PI,IP,001,13,13476,13482,3235,6,PERF
42177320790000,PI,IP,001,14,13631,13637,3235,6,PERF
42177320790000,PI,IP,001,15,13753,13759,3235,6,PERF
42177320830000,PI,IP,001,1,11450,11456,3458,6,PERF
42177320830000,PI,IP,001,2,11708,11714,3458,6,PERF
42177320830000,PI,IP,001,3,11768,11774,3458,6,PERF
42177320830000,PI,IP,001,4,12068,12074,3458,6,PERF
42177320830000,PI,IP,001,5,12350,12356,3458,6,PERF
42177320830000,PI,IP,001,6,12668,12674,3458,6,PERF
42177320830000,PI,IP,001,7,12950,12956,3458,6,PERF
42177320830000,PI,IP,001,8,13250,13256,3458,6,PERF
42177320830000,PI,IP,001,9,13568,13574,3458,6,PERF
42177320830000,PI,IP,001,10,13864,13874,3458,10,PERF
42177320830000,PI,IP,001,11,14157,14163,3458,6,PERF
42177320850000,PI,IP,001,1,11507,11510,5702,3,PERF
42177320850000,PI,IP,001,2,11602,11605,5702,3,PERF
42177320850000,PI,IP,001,3,11697,11703,5702,6,PERF
42177320850000,PI,IP,001,4,11794,11797,5702,3,PERF
42177320850000,PI,IP,001,5,11894,11897,5702,3,PERF
42177320850000,PI,IP,001,6,11986,11992,5702,6,PERF
42177320850000,PI,IP,001,7,12085,12088,5702,3,PERF
42177320850000,PI,IP,001,8,12180,12183,5702,3,PERF
42177320850000,PI,IP,001,9,12275,12281,5702,6,PERF
42177320850000,PI,IP,001,10,12374,12377,5702,3,PERF
42177320850000,PI,IP,001,11,12469,12472,5702,3,PERF
42177320850000,PI,IP,001,12,12564,12570,5702,6,PERF
42177320850000,PI,IP,001,13,12663,12666,5702,3,PERF
42177320850000,PI,IP,001,14,12758,12761,5702,3,PERF
42177320850000,PI,IP,001,15,12853,12859,5702,6,PERF
42177320850000,PI,IP,001,16,12947,12950,5702,3,PERF
42177320850000,PI,IP,001,17,13056,13059,5702,3,PERF
42177320850000,PI,IP,001,18,13152,13158,5702,6,PERF
42177320850000,PI,IP,001,19,13241,13244,5702,3,PERF
42177320850000,PI,IP,001,20,13336,13339,5702,3,PERF
42177320850000,PI,IP,001,21,13431,13437,5702,6,PERF
42177320850000,PI,IP,001,22,13530,13536,5702,6,PERF
42177320850000,PI,IP,001,23,13625,13628,5702,3,PERF
42177320850000,PI,IP,001,24,13720,13726,5702,6,PERF
42177320850000,PI,IP,001,25,13819,13822,5702,3,PERF
42177320850000,PI,IP,001,26,13914,13917,5702,3,PERF
42177320850000,PI,IP,001,27,14009,14015,5702,6,PERF
42177320850000,PI,IP,001,28,14108,14111,5702,3,PERF
42177320850000,PI,IP,001,29,14200,14203,5702,3,PERF
42177320850000,PI,IP,001,30,14300,14306,5702,6,PERF
42177320850000,PI,IP,001,31,14397,14400,5702,3,PERF
42177320850000,PI,IP,001,32,14492,14495,5702,3,PERF
42177320850000,PI,IP,001,33,14587,14593,5702,6,PERF
42177320850000,PI,IP,001,34,14686,14689,5702,3,PERF
42177320850000,PI,IP,001,35,14781,14784,5702,3,PERF
42177320850000,PI,IP,001,36,14876,14882,5702,6,PERF
42177320850000,PI,IP,001,37,14975,14978,5702,3,PERF
42177320850000,PI,IP,001,38,15070,15073,5702,3,PERF
42177320850000,PI,IP,001,39,15165,15171,5702,6,PERF
42177320850000,PI,IP,001,40,15258,15261,5702,3,PERF
42177320850000,PI,IP,001,41,15354,15357,5702,3,PERF
42177320850000,PI,IP,001,42,15454,15460,5702,6,PERF
42177320850000,PI,IP,001,43,15550,15553,5702,3,PERF
42177320850000,PI,IP,001,44,15648,15651,5702,3,PERF
42177320850000,PI,IP,001,45,15743,15749,5702,6,PERF
42177320850000,PI,IP,001,46,15892,15895,5702,3,PERF
42177320850000,PI,IP,001,47,15987,15990,5702,3,PERF
42177320850000,PI,IP,001,48,16082,16088,5702,6,PERF
42177320850000,PI,IP,001,49,16236,16239,5702,3,PERF
42177320850000,PI,IP,001,50,16336,16339,5702,3,PERF
42177320850000,PI,IP,001,51,16420,16423,5702,3,PERF
42177320850000,PI,IP,001,52,16436,16442,5702,6,PERF
42177320850000,PI,IP,001,53,16452,16455,5702,3,PERF
42177320850000,PI,IP,001,54,16519,16522,5702,3,PERF
42177320850000,PI,IP,001,55,16552,16555,5702,3,PERF
42177320850000,PI,IP,001,56,16618,16624,5702,6,PERF
42177320850000,PI,IP,001,57,16652,16658,5702,6,PERF
42177320900000,PI,IP,001,1,11900,11902,3856,2,PERF
42177320900000,PI,IP,001,2,11963,11965,3856,2,PERF
42177320900000,PI,IP,001,3,12026,12028,3856,2,PERF
42177320900000,PI,IP,001,4,12084,12086,3856,2,PERF
42177320900000,PI,IP,001,5,12152,12155,3856,3,PERF
42177320900000,PI,IP,001,6,12215,12217,3856,2,PERF
42177320900000,PI,IP,001,7,12278,12280,3856,2,PERF
42177320900000,PI,IP,001,8,12341,12343,3856,2,PERF
42177320900000,PI,IP,001,9,12404,12406,3856,2,PERF
42177320900000,PI,IP,001,10,12467,12470,3856,3,PERF
42177320900000,PI,IP,001,11,12532,12534,3856,2,PERF
42177320900000,PI,IP,001,12,12593,12595,3856,2,PERF
42177320900000,PI,IP,001,13,12652,12654,3856,2,PERF
42177320900000,PI,IP,001,14,12719,12721,3856,2,PERF
42177320900000,PI,IP,001,15,12782,12786,3856,4,PERF
42177320900000,PI,IP,001,16,12845,12847,3856,2,PERF
42177320900000,PI,IP,001,17,12908,12910,3856,2,PERF
42177320900000,PI,IP,001,18,12971,12973,3856,2,PERF
42177320900000,PI,IP,001,19,13034,13036,3856,2,PERF
42177320900000,PI,IP,001,20,13100,13104,3856,4,PERF
42177320900000,PI,IP,001,21,13160,13162,3856,2,PERF
42177320900000,PI,IP,001,22,13220,13222,3856,2,PERF
42177320900000,PI,IP,001,23,13286,13288,3856,2,PERF
42177320900000,PI,IP,001,24,13409,13413,3856,4,PERF
42177320900000,PI,IP,001,25,13449,13451,3856,2,PERF
42177320900000,PI,IP,001,26,13475,13477,3856,2,PERF
42177320900000,PI,IP,001,27,13538,13540,3856,2,PERF
42177320900000,PI,IP,001,28,13601,13603,3856,2,PERF
42177320900000,PI,IP,001,29,13666,13668,3856,2,PERF
42177320900000,PI,IP,001,30,13727,13731,3856,4,PERF
42177320900000,PI,IP,001,31,13788,13790,3856,2,PERF
42177320900000,PI,IP,001,32,13853,13855,3856,2,PERF
42177320900000,PI,IP,001,33,13916,13918,3856,2,PERF
42177320900000,PI,IP,001,34,13978,13981,3856,3,PERF
42177320900000,PI,IP,001,35,14042,14044,3856,2,PERF
42177320900000,PI,IP,001,36,14105,14107,3856,2,PERF
42177320900000,PI,IP,001,37,14168,14170,3856,2,PERF
42177320900000,PI,IP,001,38,14226,14228,3856,2,PERF
42177320900000,PI,IP,001,39,14294,14296,3856,2,PERF
42177320900000,PI,IP,001,40,14357,14361,3856,4,PERF
42177320900000,PI,IP,001,41,14490,14492,3856,2,PERF
42177320900000,PI,IP,001,42,14592,14594,3856,2,PERF
42177320900000,PI,IP,001,43,14694,14698,3856,4,PERF
42177320920000,PI,IP,001,1,11558,11560,4202,2,PERF
42177320920000,PI,IP,001,2,11654,11656,4202,2,PERF
42177320920000,PI,IP,001,3,11746,11750,4202,4,PERF
42177320920000,PI,IP,001,4,11850,11852,4202,2,PERF
42177320920000,PI,IP,001,5,11959,11961,4202,2,PERF
42177320920000,PI,IP,001,6,12056,12060,4202,4,PERF
42177320920000,PI,IP,001,7,12175,12177,4202,2,PERF
42177320920000,PI,IP,001,8,12256,12258,4202,2,PERF
42177320920000,PI,IP,001,9,12338,12342,4202,4,PERF
42177320920000,PI,IP,001,10,12451,12453,4202,2,PERF
42177320920000,PI,IP,001,11,12545,12547,4202,2,PERF
42177320920000,PI,IP,001,12,12633,12637,4202,4,PERF
42177320920000,PI,IP,001,13,12739,12741,4202,2,PERF
42177320920000,PI,IP,001,14,12858,12860,4202,2,PERF
42177320920000,PI,IP,001,15,12970,12974,4202,4,PERF
42177320920000,PI,IP,001,16,13078,13080,4202,2,PERF
42177320920000,PI,IP,001,17,13172,13174,4202,2,PERF
42177320920000,PI,IP,001,18,13274,13278,4202,4,PERF
42177320920000,PI,IP,001,19,13371,13373,4202,2,PERF
42177320920000,PI,IP,001,20,13466,13468,4202,2,PERF
42177320920000,PI,IP,001,21,13565,13569,4202,4,PERF
42177320920000,PI,IP,001,22,13662,13664,4202,2,PERF
42177320920000,PI,IP,001,23,13767,13769,4202,2,PERF
42177320920000,PI,IP,001,24,13862,13866,4202,4,PERF
42177320920000,PI,IP,001,25,13973,13975,4202,2,PERF
42177320920000,PI,IP,001,26,14075,14077,4202,2,PERF
42177320920000,PI,IP,001,27,14177,14181,4202,4,PERF
42177320920000,PI,IP,001,28,14278,14280,4202,2,PERF
42177320920000,PI,IP,001,29,14334,14346,4202,12,PERF
42177320920000,PI,IP,001,30,14410,14414,4202,4,PERF
42177320920000,PI,IP,001,31,14613,14615,4202,2,PERF
42177320920000,PI,IP,001,32,14680,14682,4202,2,PERF
42177320920000,PI,IP,001,33,14747,14751,4202,4,PERF
42177320920000,PI,IP,001,34,14950,14952,4202,2,PERF
42177320920000,PI,IP,001,35,15035,15037,4202,2,PERF
42177320920000,PI,IP,001,36,15120,15124,4202,4,PERF
42177320930000,PI,IP,001,1,11713,11716,4837,3,PERF
42177320930000,PI,IP,001,2,11809,11812,4837,3,PERF
42177320930000,PI,IP,001,3,11904,11910,4837,6,PERF
42177320930000,PI,IP,001,4,12001,12004,4837,3,PERF
42177320930000,PI,IP,001,5,12096,12099,4837,3,PERF
42177320930000,PI,IP,001,6,12191,12197,4837,6,PERF
42177320930000,PI,IP,001,7,12290,12293,4837,3,PERF
42177320930000,PI,IP,001,8,12385,12388,4837,3,PERF
42177320930000,PI,IP,001,9,12480,12486,4837,6,PERF
42177320930000,PI,IP,001,10,12579,12582,4837,3,PERF
42177320930000,PI,IP,001,11,12674,12677,4837,3,PERF
42177320930000,PI,IP,001,12,12765,12771,4837,6,PERF
42177320930000,PI,IP,001,13,12868,12871,4837,3,PERF
42177320930000,PI,IP,001,14,12963,12966,4837,3,PERF
42177320930000,PI,IP,001,15,13058,13064,4837,6,PERF
42177320930000,PI,IP,001,16,13157,13160,4837,3,PERF
42177320930000,PI,IP,001,17,13252,13255,4837,3,PERF
42177320930000,PI,IP,001,18,13347,13353,4837,6,PERF
42177320930000,PI,IP,001,19,13446,13449,4837,3,PERF
42177320930000,PI,IP,001,20,13541,13544,4837,3,PERF
42177320930000,PI,IP,001,21,13636,13642,4837,6,PERF
42177320930000,PI,IP,001,22,13735,13738,4837,3,PERF
42177320930000,PI,IP,001,23,13830,13883,4837,53,PERF
42177320930000,PI,IP,001,24,13925,13931,4837,6,PERF
42177320930000,PI,IP,001,25,14313,14316,4837,3,PERF
42177320930000,PI,IP,001,26,14408,14411,4837,3,PERF
42177320930000,PI,IP,001,27,14503,14509,4837,6,PERF
42177320930000,PI,IP,001,28,14595,14598,4837,3,PERF
42177320930000,PI,IP,001,29,14670,14673,4837,3,PERF
42177320930000,PI,IP,001,30,14745,14751,4837,6,PERF
42177320940000,PI,IP,001,1,11506,15780,4573,4274,PERF
42177320950000,PI,IP,001,1,10988,10991,5746,3,PERF
42177320950000,PI,IP,001,2,11087,11090,5746,3,PERF
42177320950000,PI,IP,001,3,11186,11192,5746,6,PERF
42177320950000,PI,IP,001,4,11286,11289,5746,3,PERF
42177320950000,PI,IP,001,5,11385,11388,5746,3,PERF
42177320950000,PI,IP,001,6,11486,11492,5746,6,PERF
42177320950000,PI,IP,001,7,11584,11587,5746,3,PERF
42177320950000,PI,IP,001,8,11683,11686,5746,3,PERF
42177320950000,PI,IP,001,9,11782,11788,5746,6,PERF
42177320950000,PI,IP,001,10,11882,11885,5746,3,PERF
42177320950000,PI,IP,001,11,11981,11984,5746,3,PERF
42177320950000,PI,IP,001,12,12074,12080,5746,6,PERF
42177320950000,PI,IP,001,13,12180,12183,5746,3,PERF
42177320950000,PI,IP,001,14,12279,12282,5746,3,PERF
42177320950000,PI,IP,001,15,12372,12378,5746,6,PERF
42177320950000,PI,IP,001,16,12478,12481,5746,3,PERF
42177320950000,PI,IP,001,17,12577,12580,5746,3,PERF
42177320950000,PI,IP,001,18,12674,12680,5746,6,PERF
42177320950000,PI,IP,001,19,12781,12784,5746,3,PERF
42177320950000,PI,IP,001,20,12875,12878,5746,3,PERF
42177320950000,PI,IP,001,21,12974,12980,5746,6,PERF
42177320950000,PI,IP,001,22,13074,13077,5746,3,PERF
42177320950000,PI,IP,001,23,13173,13176,5746,3,PERF
42177320950000,PI,IP,001,24,13272,13278,5746,6,PERF
42177320950000,PI,IP,001,25,13372,13375,5746,3,PERF
42177320950000,PI,IP,001,26,13466,13469,5746,3,PERF
42177320950000,PI,IP,001,27,13472,13576,5746,104,PERF
42177320950000,PI,IP,001,28,13670,13673,5746,3,PERF
42177320950000,PI,IP,001,29,13769,13772,5746,3,PERF
42177320950000,PI,IP,001,30,13868,13874,5746,6,PERF
42177320950000,PI,IP,001,31,13968,13971,5746,3,PERF
42177320950000,PI,IP,001,32,14067,14070,5746,3,PERF
42177320950000,PI,IP,001,33,14164,14170,5746,6,PERF
42177320950000,PI,IP,001,34,14261,14264,5746,3,PERF
42177320950000,PI,IP,001,35,14365,14368,5746,3,PERF
42177320950000,PI,IP,001,36,14464,14470,5746,6,PERF
42177320950000,PI,IP,001,37,14564,14567,5746,3,PERF
42177320950000,PI,IP,001,38,14663,14666,5746,3,PERF
42177320950000,PI,IP,001,39,14762,14768,5746,6,PERF
42177320950000,PI,IP,001,40,14862,14865,5746,3,PERF
42177320950000,PI,IP,001,41,14964,14967,5746,3,PERF
42177320950000,PI,IP,001,42,15060,15066,5746,6,PERF
42177320950000,PI,IP,001,43,15160,15163,5746,3,PERF
42177320950000,PI,IP,001,44,15259,15262,5746,3,PERF
42177320950000,PI,IP,001,45,15358,15364,5746,6,PERF
42177320950000,PI,IP,001,46,15458,15461,5746,3,PERF
42177320950000,PI,IP,001,47,15552,15555,5746,3,PERF
42177320950000,PI,IP,001,48,15656,15662,5746,6,PERF
42177320950000,PI,IP,001,49,15756,15759,5746,3,PERF
42177320950000,PI,IP,001,50,15855,15858,5746,3,PERF
42177320950000,PI,IP,001,51,15954,15960,5746,6,PERF
42177320950000,PI,IP,001,52,16052,16055,5746,3,PERF
42177320950000,PI,IP,001,53,16158,16161,5746,3,PERF
42177320950000,PI,IP,001,54,16252,16258,5746,6,PERF
42177320950000,PI,IP,001,55,16320,16323,5746,3,PERF
42177320950000,PI,IP,001,56,16420,16423,5746,3,PERF
42177320950000,PI,IP,001,57,16520,16526,5746,6,PERF
42177320960000,PI,IP,001,1,11330,11331,4316,1,PERF
42177320960000,PI,IP,001,2,11400,11401,4316,1,PERF
42177320960000,PI,IP,001,3,11470,11471,4316,1,PERF
42177320960000,PI,IP,001,4,11540,11541,4316,1,PERF
42177320960000,PI,IP,001,5,11615,11618,4316,3,PERF
42177320960000,PI,IP,001,6,11702,11705,4316,3,PERF
42177320960000,PI,IP,001,7,11794,11800,4316,6,PERF
42177320960000,PI,IP,001,8,11888,11891,4316,3,PERF
42177320960000,PI,IP,001,9,11980,11983,4316,3,PERF
42177320960000,PI,IP,001,10,12065,12071,4316,6,PERF
42177320960000,PI,IP,001,11,12166,12169,4316,3,PERF
42177320960000,PI,IP,001,12,12258,12261,4316,3,PERF
42177320960000,PI,IP,001,13,12355,12361,4316,6,PERF
42177320960000,PI,IP,001,14,12444,12447,4316,3,PERF
42177320960000,PI,IP,001,15,12536,12539,4316,3,PERF
42177320960000,PI,IP,001,16,12628,12634,4316,6,PERF
42177320960000,PI,IP,001,17,12722,12725,4316,3,PERF
42177320960000,PI,IP,001,18,12810,12813,4316,3,PERF
42177320960000,PI,IP,001,19,12906,12912,4316,6,PERF
42177320960000,PI,IP,001,20,13211,13214,4316,3,PERF
42177320960000,PI,IP,001,21,13298,13301,4316,3,PERF
42177320960000,PI,IP,001,22,13386,13392,4316,6,PERF
42177320960000,PI,IP,001,23,13483,13486,4316,3,PERF
42177320960000,PI,IP,001,24,13575,13578,4316,3,PERF
42177320960000,PI,IP,001,25,13698,13704,4316,6,PERF
42177320960000,PI,IP,001,26,13760,13763,4316,3,PERF
42177320960000,PI,IP,001,27,13852,13855,4316,3,PERF
42177320960000,PI,IP,001,28,13944,13950,4316,6,PERF
42177320960000,PI,IP,001,29,14037,14040,4316,3,PERF
42177320960000,PI,IP,001,30,14129,14132,4316,3,PERF
42177320960000,PI,IP,001,31,14221,14227,4316,6,PERF
42177320960000,PI,IP,001,32,14406,14409,4316,3,PERF
42177320960000,PI,IP,001,33,14498,14504,4316,6,PERF
42177320960000,PI,IP,001,34,14575,14577,4316,2,PERF
42177320960000,PI,IP,001,35,14675,14677,4316,2,PERF
42177320960000,PI,IP,001,36,14763,14769,4316,6,PERF
42177320970000,PI,IP,001,1,10230,13403,3908,3173,PERF
42177320980000,PI,IP,001,1,10000,14620,5327,4620,PERF
42177320990000,PI,IP,001,1,11400,16324,5856,4924,PERF
42177321000000,PI,IP,001,1,12100,16445,5111,4345,PERF
42177321010000,PI,IP,002,1,10460,13621,4360,3161,PERF
42177321010000,PI,PT,001,1,10460,10460,4360,0,PERF
42177321010000,PI,PT,001,2,10550,10550,4360,0,PERF
42177321010000,PI,PT,001,3,10630,10630,4360,0,PERF
42177321010000,PI,PT,001,4,10705,10705,4360,0,PERF
42177321010000,PI,PT,001,5,10780,10780,4360,0,PERF
42177321010000,PI,PT,001,6,10835,10835,4360,0,PERF
42177321010000,PI,PT,001,7,10915,10915,4360,0,PERF
42177321010000,PI,PT,001,8,10975,10975,4360,0,PERF
42177321010000,PI,PT,001,9,11022,11022,4360,0,PERF
42177321010000,PI,PT,001,10,11100,11100,4360,0,PERF
42177321010000,PI,PT,001,11,11605,11607,4360,2,PERF
42177321010000,PI,PT,001,12,11675,11677,4360,2,PERF
42177321010000,PI,PT,001,13,11738,11740,4360,2,PERF
42177321010000,PI,PT,001,14,11815,11817,4360,2,PERF
42177321010000,PI,PT,001,15,11875,11875,4360,0,PERF
42177321010000,PI,PT,001,16,11923,11923,4360,0,PERF
42177321010000,PI,PT,001,17,11975,11975,4360,0,PERF
42177321010000,PI,PT,001,18,12045,12045,4360,0,PERF
42177321010000,PI,PT,001,19,12125,12125,4360,0,PERF
42177321010000,PI,PT,001,20,12195,12195,4360,0,PERF
42177321010000,PI,PT,001,21,12240,12240,4360,0,PERF
42177321010000,PI,PT,001,22,12295,12295,4360,0,PERF
42177321010000,PI,PT,001,23,12355,12485,4360,130,PERF
42177321010000,PI,PT,001,24,12570,12570,4360,0,PERF
42177321010000,PI,PT,001,25,12635,12635,4360,0,PERF
42177321010000,PI,PT,001,26,12698,12698,4360,0,PERF
42177321010000,PI,PT,001,27,12770,12770,4360,0,PERF
42177321010000,PI,PT,001,28,12890,12892,4360,2,PERF
42177321010000,PI,PT,001,29,12980,12982,4360,2,PERF
42177321010000,PI,PT,001,30,13030,13032,4360,2,PERF
42177321010000,PI,PT,001,31,13190,13192,4360,2,PERF
42177321010000,PI,PT,001,32,13235,13237,4360,2,PERF
42177321010000,PI,PT,001,33,13263,13265,4360,2,PERF
42177321010000,PI,PT,001,34,13268,13270,4360,2,PERF
42177321010000,PI,PT,001,35,13439,13441,4360,2,PERF
42177321010000,PI,PT,001,36,13499,13501,4360,2,PERF
42177321010000,PI,PT,001,37,13567,13571,4360,4,PERF
42177321010000,PI,PT,001,38,13619,13621,4360,2,PERF
42177321020000,PI,IP,001,1,10957,10960,4340,3,PERF
42177321020000,PI,IP,001,2,11052,11055,4340,3,PERF
42177321020000,PI,IP,001,3,11147,11153,4340,6,PERF
42177321020000,PI,IP,001,4,11243,11246,4340,3,PERF
42177321020000,PI,IP,001,5,11338,11341,4340,3,PERF
42177321020000,PI,IP,001,6,11428,11434,4340,6,PERF
42177321020000,PI,IP,001,7,11535,11538,4340,3,PERF
42177321020000,PI,IP,001,8,11628,11631,4340,3,PERF
42177321020000,PI,IP,001,9,11719,11725,4340,6,PERF
42177321020000,PI,IP,001,10,11815,11818,4340,3,PERF
42177321020000,PI,IP,001,11,11910,11913,4340,3,PERF
42177321020000,PI,IP,001,12,12005,12011,4340,6,PERF
42177321020000,PI,IP,001,13,12101,12104,4340,3,PERF
42177321020000,PI,IP,001,14,12196,12199,4340,3,PERF
42177321020000,PI,IP,001,15,12291,12297,4340,6,PERF
42177321020000,PI,IP,001,16,12387,12390,4340,3,PERF
42177321020000,PI,IP,001,17,12482,12485,4340,3,PERF
42177321020000,PI,IP,001,18,12577,12583,4340,6,PERF
42177321020000,PI,IP,001,19,12670,12673,4340,3,PERF
42177321020000,PI,IP,001,20,12777,12780,4340,3,PERF
42177321020000,PI,IP,001,21,12870,12876,4340,6,PERF
42177321020000,PI,IP,001,22,12959,12962,4340,3,PERF
42177321020000,PI,IP,001,23,13054,13057,4340,3,PERF
42177321020000,PI,IP,001,24,13149,13155,4340,6,PERF
42177321020000,PI,IP,001,25,13245,13248,4340,3,PERF
42177321020000,PI,IP,001,26,13345,13348,4340,3,PERF
42177321020000,PI,IP,001,27,13445,13451,4340,6,PERF
42177321020000,PI,IP,001,28,13622,13625,4340,3,PERF
42177321020000,PI,IP,001,29,13726,13729,4340,3,PERF
42177321020000,PI,IP,001,30,13824,13830,4340,6,PERF
42177321020000,PI,IP,001,31,14040,14043,4340,3,PERF
42177321020000,PI,IP,001,32,14200,14203,4340,3,PERF
42177321020000,PI,IP,001,33,14360,14366,4340,6,PERF
42177321020000,PI,IP,001,34,14498,14501,4340,3,PERF
42177321020000,PI,IP,001,35,14598,14601,4340,3,PERF
42177321020000,PI,IP,001,36,14698,14704,4340,6,PERF
42177321030000,PI,IP,001,1,11904,11907,4976,3,PERF
42177321030000,PI,IP,001,2,12003,12006,4976,3,PERF
42177321030000,PI,IP,001,3,12096,12102,4976,6,PERF
42177321030000,PI,IP,001,4,12198,12201,4976,3,PERF
42177321030000,PI,IP,001,5,12295,12298,4976,3,PERF
42177321030000,PI,IP,001,6,12392,12398,4976,6,PERF
42177321030000,PI,IP,001,7,12487,12490,4976,3,PERF
42177321030000,PI,IP,001,8,12587,12590,4976,3,PERF
42177321030000,PI,IP,001,9,12678,12684,4976,6,PERF
42177321030000,PI,IP,001,10,12782,12785,4976,3,PERF
42177321030000,PI,IP,001,11,12878,12878,4976,0,PERF
42177321030000,PI,IP,001,12,12976,12982,4976,6,PERF
42177321030000,PI,IP,001,13,13069,13072,4976,3,PERF
42177321030000,PI,IP,001,14,13171,13174,4976,3,PERF
42177321030000,PI,IP,001,15,13260,13266,4976,6,PERF
42177321030000,PI,IP,001,16,13366,13369,4976,3,PERF
42177321030000,PI,IP,001,17,13457,13460,4976,3,PERF
42177321030000,PI,IP,001,18,13560,13566,4976,6,PERF
42177321030000,PI,IP,001,19,13663,13666,4976,3,PERF
42177321030000,PI,IP,001,20,13749,13752,4976,3,PERF
42177321030000,PI,IP,001,21,13852,13858,4976,6,PERF
42177321030000,PI,IP,001,22,13950,13953,4976,3,PERF
42177321030000,PI,IP,001,23,14050,14053,4976,3,PERF
42177321030000,PI,IP,001,24,14137,14143,4976,6,PERF
42177321040000,PI,IP,001,1,11934,11936,4527,2,PERF
42177321040000,PI,IP,001,2,12030,12032,4527,2,PERF
42177321040000,PI,IP,001,3,12120,12124,4527,4,PERF
42177321040000,PI,IP,001,4,12224,12226,4527,2,PERF
42177321040000,PI,IP,001,5,12320,12322,4527,2,PERF
42177321040000,PI,IP,001,6,12416,12420,4527,4,PERF
42177321040000,PI,IP,001,7,12514,12516,4527,2,PERF
42177321040000,PI,IP,001,8,12610,12612,4527,2,PERF
42177321040000,PI,IP,001,9,12700,12704,4527,4,PERF
42177321040000,PI,IP,001,10,12804,12806,4527,2,PERF
42177321040000,PI,IP,001,11,12900,12902,4527,2,PERF
42177321040000,PI,IP,001,12,12996,13000,4527,4,PERF
42177321040000,PI,IP,001,13,13094,13096,4527,2,PERF
42177321040000,PI,IP,001,14,13190,13192,4527,2,PERF
42177321040000,PI,IP,001,15,13286,13290,4527,4,PERF
42177321040000,PI,IP,001,16,13388,13390,4527,2,PERF
42177321040000,PI,IP,001,17,13480,13482,4527,2,PERF
42177321040000,PI,IP,001,18,13576,13580,4527,4,PERF
42177321040000,PI,IP,001,19,13674,13676,4527,2,PERF
42177321040000,PI,IP,001,20,13770,13772,4527,2,PERF
42177321040000,PI,IP,001,21,13674,13676,4527,2,REPERF
42177321040000,PI,IP,001,22,13964,13966,4527,2,PERF
42177321040000,PI,IP,001,23,14064,14066,4527,2,PERF
42177321040000,PI,IP,001,24,14156,14160,4527,4,PERF
42177321040000,PI,IP,001,25,14254,14256,4527,2,PERF
42177321040000,PI,IP,001,26,14350,14352,4527,2,PERF
42177321040000,PI,IP,001,27,14446,14450,4527,4,PERF
42177321040000,PI,IP,001,28,14544,14546,4527,2,PERF
42177321040000,PI,IP,001,29,14640,14642,4527,2,PERF
42177321040000,PI,IP,001,30,14736,14740,4527,4,PERF
42177321040000,PI,IP,001,31,14837,14839,4527,2,PERF
42177321040000,PI,IP,001,32,15124,15126,4527,2,PERF
42177321040000,PI,IP,001,33,15224,15226,4527,2,PERF
42177321040000,PI,IP,001,34,15324,15328,4527,4,PERF
42177321040000,PI,IP,001,35,15324,15328,4527,4,REPERF
42177321040000,PI,IP,001,36,15224,15226,4527,2,REPERF
42177321050000,PI,IP,001,1,10870,17504,6866,6634,PERF
42177321060000,PI,IP,001,1,11420,11423,3440,3,PERF
42177321060000,PI,IP,001,2,11534,11537,3440,3,PERF
42177321060000,PI,IP,001,3,11657,11663,3440,6,PERF
42177321060000,PI,IP,001,4,11793,11796,3440,3,PERF
42177321060000,PI,IP,001,5,11916,11919,3440,3,PERF
42177321060000,PI,IP,001,6,12039,12045,3440,6,PERF
42177321060000,PI,IP,001,7,12175,12178,3440,3,PERF
42177321060000,PI,IP,001,8,12298,12301,3440,3,PERF
42177321060000,PI,IP,001,9,12418,12424,3440,6,PERF
42177321060000,PI,IP,001,10,12444,12447,3440,3,PERF
42177321060000,PI,IP,001,11,12554,12557,3440,3,PERF
42177321060000,PI,IP,001,12,12792,12795,3440,3,PERF
42177321060000,PI,IP,001,13,12902,12905,3440,3,PERF
42177321060000,PI,IP,001,14,13012,13018,3440,6,PERF
42177321060000,PI,IP,001,15,13160,13163,3440,3,PERF
42177321060000,PI,IP,001,16,13265,13268,3440,3,PERF
42177321060000,PI,IP,001,17,13360,13366,3440,6,PERF
42177321060000,PI,IP,001,18,13660,13666,3440,6,PERF
42177321060000,PI,IP,001,19,13777,13780,3440,3,PERF
42177321060000,PI,IP,001,20,13871,13877,3440,6,PERF
42177321060000,PI,IP,001,21,13942,13945,3440,3,PERF
42177321060000,PI,IP,001,22,14042,14045,3440,3,PERF
42177321060000,PI,IP,001,23,14142,14148,3440,6,PERF
42177321070000,PI,IP,001,1,11767,15047,4852,3280,PERF
42177321080000,PI,IP,001,1,10678,15403,4884,4725,OPENHOLE
42177321090000,PI,IP,001,1,10897,15359,4620,4462,PERF
42177321100000,PI,IP,001,1,11400,14306,3839,2906,PERF
42177321110000,PI,IP,001,1,11204,15118,4195,3914,PERF
42177321130000,PI,IP,001,1,11530,14870,4175,3340,PERF
42177321150000,PI,IP,001,1,11352,16301,5639,4949,PERF
42177321160000,PI,IP,001,1,11800,16603,5551,4803,PERF
42177321170000,PI,IP,001,1,11513,15979,5498,4466,PERF
42177321180000,PI,IP,001,1,11501,15399,5356,3898,PERF
42177321190000,PI,IP,001,1,10750,14492,4204,3742,PERF
42177321210000,PI,IP,001,1,11002,15557,5163,4555,PERF
42177321220000,PI,IP,001,1,10145,11750,,1605,PERF
42177321230000,PI,IP,001,1,10954,15660,5370,4706,PERF
42177321240000,PI,IP,001,1,10850,15197,5025,4347,PERF
42177321250000,PI,IP,001,1,10200,13974,5338,3774,PERF
42177321260000,PI,IP,001,1,11560,14264,4019,2704,PERF
42177321270000,PI,IP,001,1,11866,12709,4474,843,PERF
42177321270000,PI,IP,001,2,12150,12363,4474,213,PERF
42177321270000,PI,IP,001,3,12434,12647,4474,213,PERF
42177321270000,PI,IP,001,4,12718,12931,4474,213,PERF
42177321270000,PI,IP,001,5,13002,13215,4474,213,PERF
42177321270000,PI,IP,001,6,13286,13499,4474,213,PERF
42177321270000,PI,IP,001,7,13570,13783,4474,213,PERF
42177321270000,PI,IP,001,8,13854,14067,4474,213,PERF
42177321270000,PI,IP,001,9,14138,14351,4474,213,PERF
42177321270000,PI,IP,001,10,14422,14635,4474,213,PERF
42177321270000,PI,IP,001,11,14706,14919,4474,213,PERF
42177321270000,PI,IP,001,12,14990,15203,4474,213,PERF
42177321270000,PI,IP,001,13,15274,15487,4474,213,PERF
42177321270000,PI,IP,001,14,15561,15681,4474,120,PERF
42177321280000,PI,IP,001,1,11579,15329,4566,3750,PERF
42177321290000,PI,IP,001,1,11749,16281,5207,4532,PERF
42177321300000,PI,IP,001,1,11822,12086,5404,264,PERF
42177321300000,PI,IP,001,2,15738,15742,5404,4,PERF
42177321320000,PI,IP,001,1,9320,13594,5156,4274,PERF
42177321330000,PI,IP,001,1,10018,10194,5539,176,PERF
42177321330000,PI,IP,001,2,10274,10552,5539,278,PERF
42177321330000,PI,IP,001,3,10708,10952,5539,244,PERF
42177321330000,PI,IP,001,4,11096,11334,5539,238,PERF
42177321330000,PI,IP,001,5,11434,11614,5539,180,PERF
42177321330000,PI,IP,001,6,11720,11968,5539,248,PERF
42177321330000,PI,IP,001,7,12032,12218,5539,186,PERF
42177321330000,PI,IP,001,8,12298,12520,5539,222,PERF
42177321330000,PI,IP,001,9,12590,12782,5539,192,PERF
42177321330000,PI,IP,001,10,12856,13042,5539,186,PERF
42177321330000,PI,IP,001,11,13114,13362,5539,248,PERF
42177321330000,PI,IP,001,12,13518,13690,5539,172,PERF
42177321330000,PI,IP,001,13,13786,13992,5539,206,PERF
42177321330000,PI,IP,001,14,14072,14408,5539,336,PERF
42177321330000,PI,IP,001,15,14484,14702,5539,218,PERF
42177321330000,PI,IP,001,16,14768,14974,5539,206,PERF
42177321340000,PI,IP,001,1,10879,15608,5354,4729,PERF
42177321350000,PI,IP,001,1,11650,15220,4723,3570,PERF
42177321360000,PI,IP,001,1,11919,16255,4113,4336,PERF
42177321390000,PI,IP,001,1,10698,15258,4981,4560,PERF
42177321400000,PI,IP,001,1,10799,14886,4635,4087,PERF
42177321410000,PI,IP,001,1,11801,13225,3800,1424,PERF
42177321420000,PI,IP,001,1,11840,15050,4182,3210,PERF
42177321430000,PI,IP,001,1,11751,17175,6382,5424,PERF
42177321440000,PI,IP,001,1,13072,15806,4740,2734,PERF
42177321450000,PI,IP,001,1,9966,10156,5418,190,PERF
42177321450000,PI,IP,001,2,10240,10492,5418,252,PERF
42177321450000,PI,IP,001,3,10558,10736,5418,178,PERF
42177321450000,PI,IP,001,4,10868,11164,5418,296,PERF
42177321450000,PI,IP,001,5,11262,11492,5418,230,PERF
42177321450000,PI,IP,001,6,11820,12118,5418,298,PERF
42177321450000,PI,IP,001,7,12512,12736,5418,224,PERF
42177321450000,PI,IP,001,8,12912,13212,5418,300,PERF
42177321450000,PI,IP,001,9,13332,13624,5418,292,PERF
42177321450000,PI,IP,001,10,13804,14134,5418,330,PERF
42177321460000,PI,IP,001,1,10364,10364,5309,0,PERF
42177321460000,PI,IP,001,2,10442,10442,5309,0,PERF
42177321460000,PI,IP,001,3,10520,10520,5309,0,PERF
42177321460000,PI,IP,001,4,10598,10598,5309,0,PERF
42177321460000,PI,IP,001,5,10676,10676,5309,0,PERF
42177321460000,PI,IP,001,6,10753,10753,5309,0,PERF
42177321460000,PI,IP,001,7,10831,10831,5309,0,PERF
42177321460000,PI,IP,001,8,10909,10909,5309,0,PERF
42177321460000,PI,IP,001,9,10987,10987,5309,0,PERF
42177321460000,PI,IP,001,10,11065,11065,5309,0,PERF
42177321460000,PI,IP,001,11,11143,11143,5309,0,PERF
42177321460000,PI,IP,001,12,11221,11221,5309,0,PERF
42177321460000,PI,IP,001,13,11299,11299,5309,0,PERF
42177321460000,PI,IP,001,14,11377,11377,5309,0,PERF
42177321460000,PI,IP,001,15,11455,11455,5309,0,PERF
42177321460000,PI,IP,001,16,11532,11532,5309,0,PERF
42177321460000,PI,IP,001,17,11610,11610,5309,0,PERF
42177321460000,PI,IP,001,18,11688,11688,5309,0,PERF
42177321460000,PI,IP,001,19,11766,11766,5309,0,PERF
42177321460000,PI,IP,001,20,11844,11844,5309,0,PERF
42177321460000,PI,IP,001,21,11922,11922,5309,0,PERF
42177321460000,PI,IP,001,22,12000,12000,5309,0,PERF
42177321460000,PI,IP,001,23,12078,12078,5309,0,PERF
42177321460000,PI,IP,001,24,12156,12156,5309,0,PERF
42177321460000,PI,IP,001,25,12233,12233,5309,0,PERF
42177321460000,PI,IP,001,26,12311,12311,5309,0,PERF
42177321460000,PI,IP,001,27,12389,12389,5309,0,PERF
42177321460000,PI,IP,001,28,12467,12467,5309,0,PERF
42177321460000,PI,IP,001,29,12545,12545,5309,0,PERF
42177321460000,PI,IP,001,30,12623,12623,5309,0,PERF
42177321460000,PI,IP,001,31,12701,12701,5309,0,PERF
42177321460000,PI,IP,001,32,12779,12779,5309,0,PERF
42177321460000,PI,IP,001,33,12857,12857,5309,0,PERF
42177321460000,PI,IP,001,34,12935,12935,5309,0,PERF
42177321460000,PI,IP,001,35,13012,13012,5309,0,PERF
42177321460000,PI,IP,001,36,13090,13090,5309,0,PERF
42177321460000,PI,IP,001,37,13168,13168,5309,0,PERF
42177321460000,PI,IP,001,38,13246,13246,5309,0,PERF
42177321460000,PI,IP,001,39,13324,13324,5309,0,PERF
42177321460000,PI,IP,001,40,13402,13402,5309,0,PERF
42177321460000,PI,IP,001,41,13676,13676,5309,0,PERF
42177321460000,PI,IP,001,42,13911,13911,5309,0,PERF
42177321460000,PI,IP,001,43,14144,14144,5309,0,PERF
42177321460000,PI,IP,001,44,14378,14378,5309,0,PERF
42177321460000,PI,IP,001,45,14613,14613,5309,0,PERF
42177321460000,PI,IP,001,46,14845,14845,5309,0,PERF
42177321470000,PI,IP,001,1,10265,14783,5265,4518,PERF
42177321480000,PI,IP,001,1,12325,16304,5520,3979,PERF
42177321490000,PI,IP,001,1,10135,15515,6024,5380,PERF
42177321500100,PI,IP,001,1,10714,15190,5181,4476,PERF
42177321510100,PI,IP,001,1,10938,15290,5157,4352,PERF
42177321520000,PI,IP,001,1,11585,16906,5707,5321,PERF
42177321530000,PI,IP,001,1,9130,9132,4332,2,PERF
42177321530000,PI,IP,001,2,9200,9202,4332,2,PERF
42177321530000,PI,IP,001,3,9270,9272,4332,2,PERF
42177321530000,PI,IP,001,4,9320,9322,4332,2,PERF
42177321530000,PI,IP,001,5,9410,9412,4332,2,PERF
42177321530000,PI,IP,001,6,9490,9492,4332,2,PERF
42177321530000,PI,IP,001,7,9550,9552,4332,2,PERF
42177321530000,PI,IP,001,8,9610,9612,4332,2,PERF
42177321530000,PI,IP,001,9,9720,9722,4332,2,PERF
42177321530000,PI,IP,001,10,9800,9802,4332,2,PERF
42177321530000,PI,IP,001,11,9860,9862,4332,2,PERF
42177321530000,PI,IP,001,12,9932,9934,4332,2,PERF
42177321530000,PI,IP,001,13,10020,10022,4332,2,PERF
42177321530000,PI,IP,001,14,10100,10102,4332,2,PERF
42177321530000,PI,IP,001,15,10170,10172,4332,2,PERF
42177321530000,PI,IP,001,16,10236,10238,4332,2,PERF
42177321530000,PI,IP,001,17,10310,10312,4332,2,PERF
42177321530000,PI,IP,001,18,10370,10372,4332,2,PERF
42177321530000,PI,IP,001,19,10430,10432,4332,2,PERF
42177321530000,PI,IP,001,20,10490,10492,4332,2,PERF
42177321530000,PI,IP,001,21,10600,10602,4332,2,PERF
42177321530000,PI,IP,001,22,10660,10662,4332,2,PERF
42177321530000,PI,IP,001,23,10724,10726,4332,2,PERF
42177321530000,PI,IP,001,24,10784,10786,4332,2,PERF
42177321530000,PI,IP,001,25,10840,10842,4332,2,PERF
42177321530000,PI,IP,001,26,10910,10912,4332,2,PERF
42177321530000,PI,IP,001,27,10976,10978,4332,2,PERF
42177321530000,PI,IP,001,28,11028,11030,4332,2,PERF
42177321530000,PI,IP,001,29,11110,11112,4332,2,PERF
42177321530000,PI,IP,001,30,11180,11182,4332,2,PERF
42177321530000,PI,IP,001,31,11224,11226,4332,2,PERF
42177321530000,PI,IP,001,32,11320,11322,4332,2,PERF
42177321530000,PI,IP,001,33,11400,11402,4332,2,PERF
42177321530000,PI,IP,001,34,11460,11462,4332,2,PERF
42177321530000,PI,IP,001,35,11530,11532,4332,2,PERF
42177321530000,PI,IP,001,36,11600,11602,4332,2,PERF
42177321530000,PI,IP,001,37,11620,11622,4332,2,PERF
42177321530000,PI,IP,001,38,11720,11722,4332,2,PERF
42177321530000,PI,IP,001,39,11780,11782,4332,2,PERF
42177321530000,PI,IP,001,40,11840,11842,4332,2,PERF
42177321530000,PI,IP,001,41,11934,11936,4332,2,PERF
42177321530000,PI,IP,001,42,12010,12012,4332,2,PERF
42177321530000,PI,IP,001,43,12120,12122,4332,2,PERF
42177321530000,PI,IP,001,44,12190,12192,4332,2,PERF
42177321530000,PI,IP,001,45,12282,12284,4332,2,PERF
42177321530000,PI,IP,001,46,12354,12356,4332,2,PERF
42177321530000,PI,IP,001,47,12426,12428,4332,2,PERF
42177321530000,PI,IP,001,48,12504,12506,4332,2,PERF
42177321540000,PI,IP,001,1,11094,11262,3840,168,PERF
42177321540000,PI,IP,001,2,11324,11570,3840,246,PERF
42177321540000,PI,IP,001,3,11652,11830,3840,178,PERF
42177321540000,PI,IP,001,4,11892,12122,3840,230,PERF
42177321540000,PI,IP,001,5,12190,12390,3840,200,PERF
42177321540000,PI,IP,001,6,12452,12644,3840,192,PERF
42177321540000,PI,IP,001,7,12722,13916,3840,1194,PERF
42177321540000,PI,IP,001,8,12982,13265,3840,283,PERF
42177321540000,PI,IP,001,9,13342,13520,3840,178,PERF
42177321540000,PI,IP,001,10,13592,13760,3840,168,PERF
42177321540000,PI,IP,001,11,13832,14000,3840,168,PERF
42177321560000,PI,IP,001,1,11364,15419,4909,4055,PERF
42177321570000,PI,IP,001,1,9839,15494,6329,5655,PERF
42177321580000,PI,IP,001,1,9703,15478,6512,5775,PERF
42177321590000,PI,IP,001,1,12551,16497,5486,3946,PERF
42177321600000,PI,IP,001,1,11515,16221,5042,4706,PERF
42177321610000,PI,IP,001,1,8080,8305,5691,225,PERF
42177321610000,PI,IP,001,2,8377,8600,5691,223,PERF
42177321610000,PI,IP,001,3,8672,8895,5691,223,PERF
42177321610000,PI,IP,001,4,8967,9190,5691,223,PERF
42177321610000,PI,IP,001,5,9266,9487,5691,221,PERF
42177321610000,PI,IP,001,6,9553,9782,5691,229,PERF
42177321610000,PI,IP,001,7,9855,10080,5691,225,PERF
42177321610000,PI,IP,001,8,10145,10370,5691,225,PERF
42177321610000,PI,IP,001,9,10442,10667,5691,225,PERF
42177321610000,PI,IP,001,10,10960,10985,5691,25,PERF
42177321610000,PI,IP,001,11,11030,11257,5691,227,PERF
42177321610000,PI,IP,001,12,11377,11550,5691,173,PERF
42177321610000,PI,IP,001,13,11620,11847,5691,227,PERF
42177321610000,PI,IP,001,14,11915,12142,5691,227,PERF
42177321610000,PI,IP,001,15,12210,12437,5691,227,PERF
42177321610000,PI,IP,001,16,12505,12730,5691,225,PERF
42177321610000,PI,IP,001,17,12800,13027,5691,227,PERF
42177321640000,PI,IP,001,1,7243,7410,6013,167,PERF
42177321640000,PI,IP,001,2,7463,7630,6013,167,PERF
42177321640000,PI,IP,001,3,7683,7850,6013,167,PERF
42177321640000,PI,IP,001,4,7903,8070,6013,167,PERF
42177321640000,PI,IP,001,5,8123,8290,6013,167,PERF
42177321640000,PI,IP,001,6,8343,8510,6013,167,PERF
42177321640000,PI,IP,001,7,8563,8565,6013,2,PERF
42177321640000,PI,IP,001,8,8783,8950,6013,167,PERF
42177321640000,PI,IP,001,9,9003,9170,6013,167,PERF
42177321640000,PI,IP,001,10,9223,9390,6013,167,PERF
42177321640000,PI,IP,001,11,9443,9610,6013,167,PERF
42177321640000,PI,IP,001,12,9663,9830,6013,167,PERF
42177321640000,PI,IP,001,13,9881,10065,6013,184,PERF
42177321640000,PI,IP,001,14,10118,10300,6013,182,PERF
42177321640000,PI,IP,001,15,10353,10535,6013,182,PERF
42177321640000,PI,IP,001,16,10588,10800,6013,212,PERF
42177321640000,PI,IP,001,17,10853,11063,6013,210,PERF
42177321640000,PI,IP,001,18,11126,11293,6013,167,PERF
42177321640000,PI,IP,001,19,11346,11513,6013,167,PERF
42177321640000,PI,IP,001,20,11566,11733,6013,167,PERF
42177321640000,PI,IP,001,21,11786,11954,6013,168,PERF
42177321640000,PI,IP,001,22,12006,12173,6013,167,PERF
42177321640000,PI,IP,001,23,12226,12393,6013,167,PERF
42177321650100,PI,IP,001,1,11106,14908,4724,3802,PERF
42177321660000,PI,IP,001,1,11795,16174,6042,4379,PERF
42177321670000,PI,IP,001,1,7142,7293,7619,151,PERF
42177321670000,PI,IP,001,2,7440,7666,7619,226,PERF
42177321670000,PI,IP,001,3,7738,7964,7619,226,PERF
42177321670000,PI,IP,001,4,8036,8187,7619,151,PERF
42177321670000,PI,IP,001,5,8334,8560,7619,226,PERF
42177321670000,PI,IP,001,6,8632,8862,7619,230,PERF
42177321670000,PI,IP,001,7,8924,9154,7619,230,PERF
42177321670000,PI,IP,001,8,9228,9454,7619,226,PERF
42177321670000,PI,IP,001,9,9526,9677,7619,151,PERF
42177321670000,PI,IP,001,10,9824,10050,7619,226,PERF
42177321670000,PI,IP,001,11,10122,10348,7619,226,PERF
42177321670000,PI,IP,001,12,10420,10646,7619,226,PERF
42177321670000,PI,IP,001,13,10718,10944,7619,226,PERF
42177321670000,PI,IP,001,14,11016,11244,7619,228,PERF
42177321670000,PI,IP,001,15,11311,11540,7619,229,PERF
42177321670000,PI,IP,001,16,11612,11838,7619,226,PERF
42177321670000,PI,IP,001,17,11910,12136,7619,226,PERF
42177321670000,PI,IP,001,18,12208,12434,7619,226,PERF
42177321670000,PI,IP,001,19,12506,12732,7619,226,PERF
42177321670000,PI,IP,001,20,12804,13030,7619,226,PERF
42177321670000,PI,IP,001,21,13102,13253,7619,151,PERF
42177321670000,PI,IP,001,22,13400,13626,7619,226,PERF
42177321670000,PI,IP,001,23,13700,13924,7619,224,PERF
42177321690000,PI,IP,001,1,7172,7378,3860,206,PERF
42177321690000,PI,IP,001,2,7444,7650,3860,206,PERF
42177321690000,PI,IP,001,3,7716,7920,3860,204,PERF
42177321690000,PI,IP,001,4,7988,8194,3860,206,PERF
42177321690000,PI,IP,001,5,8258,8466,3860,208,PERF
42177321690000,PI,IP,001,6,8532,8738,3860,206,PERF
42177321690000,PI,IP,001,7,8804,9010,3860,206,PERF
42177321690000,PI,IP,001,8,9076,9279,3860,203,PERF
42177321690000,PI,IP,001,9,9348,9550,3860,202,PERF
42177321690000,PI,IP,001,10,9620,9826,3860,206,PERF
42177321690000,PI,IP,001,11,9892,10098,3860,206,PERF
42177321690000,PI,IP,001,12,10143,10347,3860,204,PERF
42177321710000,PI,IP,001,1,11652,16543,6212,4891,PERF
42177321720000,PI,IP,001,1,11704,15401,4705,3697,PERF
42177321740000,PI,IP,001,1,10804,15583,5023,4779,PERF
42177321750000,PI,IP,001,1,9644,15415,6230,5771,PERF
42177321760000,PI,IP,001,1,11850,16703,5547,4853,PERF
42177321770000,PI,IP,001,1,7305,7552,5354,247,PERF
42177321770000,PI,IP,001,2,7610,7847,5354,237,PERF
42177321770000,PI,IP,001,3,7890,8054,5354,164,PERF
42177321770000,PI,IP,001,4,8100,8297,5354,197,PERF
42177321770000,PI,IP,001,5,8345,8542,5354,197,PERF
42177321770000,PI,IP,001,6,8610,8812,5354,202,PERF
42177321770000,PI,IP,001,7,8860,9092,5354,232,PERF
42177321770000,PI,IP,001,8,9165,9437,5354,272,PERF
42177321770000,PI,IP,001,9,9485,9699,5354,214,PERF
42177321770000,PI,IP,001,10,9800,10082,5354,282,PERF
42177321770000,PI,IP,001,11,10140,10362,5354,222,PERF
42177321770000,PI,IP,001,12,10460,10727,5354,267,PERF
42177321770000,PI,IP,001,13,10775,10947,5354,172,PERF
42177321770000,PI,IP,001,14,10998,11162,5354,164,PERF
42177321770000,PI,IP,001,15,11261,11386,5354,125,PERF
42177321770000,PI,IP,001,16,11435,11597,5354,162,PERF
42177321770000,PI,IP,001,17,11648,11812,5354,164,PERF
42177321780000,PI,IP,001,1,10596,14698,4584,4102,PERF
42177321790000,PI,IP,001,1,10755,14753,4899,3998,PERF
42177321800000,PI,IP,001,1,6510,6697,5339,187,PERF
42177321800000,PI,IP,001,2,6760,6952,5339,192,PERF
42177321800000,PI,IP,001,3,7025,7217,5339,192,PERF
42177321800000,PI,IP,001,4,7275,7467,5339,192,PERF
42177321800000,PI,IP,001,5,7520,7717,5339,197,PERF
42177321800000,PI,IP,001,6,7770,7987,5339,217,PERF
42177321800000,PI,IP,001,7,8050,8232,5339,182,PERF
42177321800000,PI,IP,001,8,8290,8492,5339,202,PERF
42177321800000,PI,IP,001,9,8550,8782,5339,232,PERF
42177321800000,PI,IP,001,10,8840,9042,5339,202,PERF
42177321800000,PI,IP,001,11,9100,9282,5339,182,PERF
42177321800000,PI,IP,001,12,9350,9542,5339,192,PERF
42177321800000,PI,IP,001,13,9605,9812,5339,207,PERF
42177321800000,PI,IP,001,14,9900,10182,5339,282,PERF
42177321800000,PI,IP,001,15,10270,10512,5339,242,PERF
42177321800000,PI,IP,001,16,10600,10821,5339,221,PERF
42177321820000,PI,IP,001,1,11392,17104,6573,5712,PERF
42177321830100,PI,IP,001,1,11066,16600,6006,5534,PERF
42177321850000,PI,IP,001,1,6889,7071,5647,182,PERF
42177321850000,PI,IP,001,2,7127,7309,5647,182,PERF
42177321850000,PI,IP,001,3,7369,7562,5647,193,PERF
42177321850000,PI,IP,001,4,7609,7791,5647,182,PERF
42177321850000,PI,IP,001,5,7849,8031,5647,182,PERF
42177321850000,PI,IP,001,6,8089,8271,5647,182,PERF
42177321850000,PI,IP,001,7,8329,8511,5647,182,PERF
42177321850000,PI,IP,001,8,8569,8751,5647,182,PERF
42177321850000,PI,IP,001,9,8809,8991,5647,182,PERF
42177321850000,PI,IP,001,10,9049,9231,5647,182,PERF
42177321850000,PI,IP,001,11,9289,9471,5647,182,PERF
42177321850000,PI,IP,001,12,9529,9711,5647,182,PERF
42177321850000,PI,IP,001,13,9771,9951,5647,180,PERF
42177321850000,PI,IP,001,14,10009,10191,5647,182,PERF
42177321850000,PI,IP,001,15,10249,10431,5647,182,PERF
42177321850000,PI,IP,001,16,10489,10671,5647,182,PERF
42177321850000,PI,IP,001,17,10729,10911,5647,182,PERF
42177321850000,PI,IP,001,18,10969,11151,5647,182,PERF
42177321850000,PI,IP,001,19,11209,11391,5647,182,PERF
42177321850000,PI,IP,001,20,11449,11631,5647,182,PERF
42177321860000,PI,IP,001,1,7140,7412,5579,272,PERF
42177321860000,PI,IP,001,2,7480,7722,5579,242,PERF
42177321860000,PI,IP,001,3,7780,8017,5579,237,PERF
42177321860000,PI,IP,001,4,8075,8297,5579,222,PERF
42177321860000,PI,IP,001,5,8350,8567,5579,217,PERF
42177321860000,PI,IP,001,6,8625,8842,5579,217,PERF
42177321860000,PI,IP,001,7,8915,9152,5579,237,PERF
42177321860000,PI,IP,001,8,9235,9477,5579,242,PERF
42177321860000,PI,IP,001,9,9545,9787,5579,242,PERF
42177321860000,PI,IP,001,10,9845,10067,5579,222,PERF
42177321860000,PI,IP,001,11,10125,10352,5579,227,PERF
42177321860000,PI,IP,001,12,10405,10632,5579,227,PERF
42177321860000,PI,IP,001,13,10690,10987,5579,297,PERF
42177321860000,PI,IP,001,14,11054,11282,5579,228,PERF
42177321860000,PI,IP,001,15,11310,11717,5579,407,PERF
42177321860000,PI,IP,001,16,11775,12027,5579,252,PERF
42177321870000,PI,IP,001,1,7025,7239,4470,214,PERF
42177321870000,PI,IP,001,2,7308,7524,4470,216,PERF
42177321870000,PI,IP,001,3,7597,7804,4470,207,PERF
42177321870000,PI,IP,001,4,7873,8082,4470,209,PERF
42177321870000,PI,IP,001,5,8156,8370,4470,214,PERF
42177321870000,PI,IP,001,6,8439,8650,4470,211,PERF
42177321870000,PI,IP,001,7,8722,8936,4470,214,PERF
42177321870000,PI,IP,001,8,9005,9214,4470,209,PERF
42177321870000,PI,IP,001,9,9287,9501,4470,214,PERF
42177321870000,PI,IP,001,10,9570,9784,4470,214,PERF
42177321870000,PI,IP,001,11,9853,10067,4470,214,PERF
42177321870000,PI,IP,001,12,10136,10279,4470,143,PERF
42177321870000,PI,IP,001,13,10417,10632,4470,215,PERF
42177321880000,PI,IP,001,1,11355,16554,5596,5199,PERF
42177321900000,PI,IP,001,1,11567,15190,4257,3623,PERF
42177321910000,PI,IP,001,1,11425,16708,5677,5283,PERF
42177321920000,PI,IP,001,1,11590,16268,5359,4678,OPENHOLE
42177321930000,PI,IP,001,1,11447,13538,3271,2091,PERF
42177321940000,PI,IP,001,1,11646,15331,4553,3685,PERF
42177321960000,PI,IP,001,1,10067,16015,6424,5948,PERF
42177321970000,PI,IP,001,1,11858,16276,5229,4418,PERF
42177321980000,PI,IP,001,1,7976,8205,,229,PERF
42177321980000,PI,IP,001,2,8278,8505,,227,PERF
42177321980000,PI,IP,001,3,8577,8804,,227,PERF
42177321980000,PI,IP,001,4,8880,9097,,217,PERF
42177321980000,PI,IP,001,5,9174,9402,,228,PERF
42177321980000,PI,IP,001,6,9476,9703,,227,PERF
42177321980000,PI,IP,001,7,9775,10002,,227,PERF
42177321980000,PI,IP,001,8,10075,10302,,227,PERF
42177321980000,PI,IP,001,9,10374,10601,,227,PERF
42177321980000,PI,IP,001,10,10674,11901,,1227,PERF
42177321980000,PI,IP,001,11,10973,11200,,227,PERF
42177321980000,PI,IP,001,12,11273,11498,,225,PERF
42177321980000,PI,IP,001,13,11572,11799,,227,PERF
42177321980000,PI,IP,001,14,11872,12099,,227,PERF
42177321980000,PI,IP,001,15,12171,12398,,227,PERF
42177321990000,PI,IP,001,1,11358,15658,4892,4300,PERF
42177322000100,PI,IP,001,1,11388,15806,4903,4418,PERF
42177322060000,PI,IP,001,1,7145,7387,4605,242,PERF
42177322060000,PI,IP,001,2,7455,7697,4605,242,PERF
42177322060000,PI,IP,001,3,7765,8007,4605,242,PERF
42177322060000,PI,IP,001,4,8075,8317,4605,242,PERF
42177322060000,PI,IP,001,5,8425,8677,4605,252,PERF
42177322060000,PI,IP,001,6,8740,9047,4605,307,PERF
42177322060000,PI,IP,001,7,9115,9357,4605,242,PERF
42177322060000,PI,IP,001,8,9425,9667,4605,242,PERF
42177322060000,PI,IP,001,9,9735,9977,4605,242,PERF
42177322060000,PI,IP,001,10,10045,10287,4605,242,PERF
42177322060000,PI,IP,001,11,10335,10597,4605,262,PERF
42177322060000,PI,IP,001,12,10665,10907,4605,242,PERF
42177322060000,PI,IP,001,13,10975,11217,4605,242,PERF
42177322080100,PI,IP,001,1,11488,15941,5049,4453,PERF
42177322090100,PI,IP,001,1,11688,15601,4689,3913,PERF
42177322100000,PI,IP,001,1,11477,14379,4439,2902,PERF
42177322130000,PI,IP,001,1,10679,15024,5239,4345,PERF
42177322140000,PI,IP,001,1,10811,14611,4742,3800,PERF
42177322150000,PI,IP,001,1,10684,14432,4589,3748,PERF
42177322160000,PI,IP,001,1,10810,15010,5168,4200,PERF
42177322170000,PI,IP,001,1,11704,16157,5582,4453,PERF
42177322180100,PI,IP,001,1,11619,15550,4656,3931,PERF
42177322190000,PI,IP,001,1,10097,15450,6201,5353,PERF
42177322200000,PI,IP,001,1,9795,13899,4389,4104,PERF
42177322220000,PI,IP,001,1,11427,15627,4723,4200,PERF
42177322240000,PI,IP,001,1,10140,15026,5464,4886,PERF
42177322250000,PI,IP,001,1,10881,15651,5004,4770,PERF
42177322260000,PI,IP,001,1,10951,15747,5266,4796,PERF
42177322270000,PI,IP,001,1,11059,15321,4843,4262,PERF
42177322280000,PI,IP,001,1,10810,15771,5126,4961,PERF
42177322290000,PI,IP,001,1,10848,15719,5192,4871,PERF
42177322310000,PI,IP,001,1,11191,15609,,4418,PERF
42177322320000,PI,IP,001,1,11298,16886,6182,5588,PERF
42177322330000,PI,IP,001,1,11812,16875,5608,5063,PERF
42177322340000,PI,IP,001,1,11668,17746,6554,6078,PERF
42177322350200,PI,IP,001,1,11821,17119,5880,5298,PERF
42177322360000,PI,IP,001,1,12137,16791,5892,4654,PERF
42177322370000,PI,IP,001,1,6997,7224,5399,227,PERF
42177322370000,PI,IP,001,2,7295,7520,5399,225,PERF
42177322370000,PI,IP,001,3,7593,7818,5399,225,PERF
42177322370000,PI,IP,001,4,7891,8116,5399,225,PERF
42177322370000,PI,IP,001,5,8487,8712,5399,225,PERF
42177322370000,PI,IP,001,6,8785,9008,5399,223,PERF
42177322370000,PI,IP,001,7,9083,9306,5399,223,PERF
42177322370000,PI,IP,001,8,9381,9606,5399,225,PERF
42177322370000,PI,IP,001,9,9679,9904,5399,225,PERF
42177322370000,PI,IP,001,10,9977,10202,5399,225,PERF
42177322370000,PI,IP,001,11,10275,10500,5399,225,PERF
42177322370000,PI,IP,001,12,10573,10798,5399,225,PERF
42177322370000,PI,IP,001,13,10871,11096,5399,225,PERF
42177322380000,PI,IP,001,1,11441,12635,5997,1194,PERF
42177322390000,PI,IP,001,1,11548,15856,4817,4308,PERF
42177322400000,PI,IP,001,1,10968,11183,5190,215,PERF
42177322400000,PI,IP,001,2,11253,11468,5190,215,PERF
42177322400000,PI,IP,001,3,11532,11759,5190,227,PERF
42177322410000,PI,IP,001,1,11446,15366,4713,3920,PERF
42177322430000,PI,IP,001,1,11410,15949,5351,4539,PERF
42177322440000,PI,IP,001,1,7160,7410,7533,250,PERF
42177322440000,PI,IP,001,2,7508,7737,7533,229,PERF
42177322440000,PI,IP,001,3,7800,8042,7533,242,PERF
42177322440000,PI,IP,001,4,8100,8372,7533,272,PERF
42177322440000,PI,IP,001,5,8454,8712,7533,258,PERF
42177322440000,PI,IP,001,6,8800,9057,7533,257,PERF
42177322440000,PI,IP,001,7,9138,9342,7533,204,PERF
42177322440000,PI,IP,001,8,9410,9617,7533,207,PERF
42177322440000,PI,IP,001,9,9770,10082,7533,312,PERF
42177322440000,PI,IP,001,10,10150,10372,7533,222,PERF
42177322440000,PI,IP,001,11,10436,10655,7533,219,PERF
42177322440000,PI,IP,001,12,10715,10883,7533,168,PERF
42177322440000,PI,IP,001,13,10960,11150,7533,190,PERF
42177322440000,PI,IP,001,14,11230,11418,7533,188,PERF
42177322440000,PI,IP,001,15,11497,11803,7533,306,PERF
42177322440000,PI,IP,001,16,11892,12126,7533,234,PERF
42177322440000,PI,IP,001,17,12226,12462,7533,236,PERF
42177322440000,PI,IP,001,18,12539,12737,7533,198,PERF
42177322440000,PI,IP,001,19,12820,13092,7533,272,PERF
42177322440000,PI,IP,001,20,13369,13371,7533,2,PERF
42177322480000,PI,IP,001,1,11931,16018,4692,4087,PERF
42177322490000,PI,IP,001,1,7690,7917,6065,227,PERF
42177322490000,PI,IP,001,2,7985,8212,6065,227,PERF
42177322490000,PI,IP,001,3,8280,8507,6065,227,PERF
42177322490000,PI,IP,001,4,8575,8802,6065,227,PERF
42177322490000,PI,IP,001,5,8870,9097,6065,227,PERF
42177322490000,PI,IP,001,6,9160,9386,6065,226,PERF
42177322490000,PI,IP,001,7,9458,9683,6065,225,PERF
42177322490000,PI,IP,001,8,9755,9982,6065,227,PERF
42177322490000,PI,IP,001,9,10050,10277,6065,227,PERF
42177322490000,PI,IP,001,10,10345,10572,6065,227,PERF
42177322490000,PI,IP,001,11,10640,10867,6065,227,PERF
42177322490000,PI,IP,001,12,10935,11162,6065,227,PERF
42177322490000,PI,IP,001,13,11230,11457,6065,227,PERF
42177322490000,PI,IP,001,14,11525,11752,6065,227,PERF
42177322490000,PI,IP,001,15,11820,12047,6065,227,PERF
42177322500000,PI,IP,001,1,9565,16344,7078,6779,PERF
42177322510000,PI,IP,001,1,9652,13506,4737,3854,PERF
42177322520000,PI,IP,001,1,11749,16115,4865,4366,PERF
42177322530000,PI,IP,001,1,10954,15720,5264,4766,PERF
42177322540000,PI,IP,001,1,11745,15199,3912,3454,PERF
42177322550000,PI,IP,001,1,11669,16301,5089,4632,PERF
42177322560000,PI,IP,001,1,11652,15924,4958,4272,PERF
42177322600000,PI,IP,001,1,9792,14294,5262,4502,PERF
42177322630000,PI,IP,001,1,10003,13764,5535,3761,PERF
42177322640000,PI,IP,001,1,10621,14574,4381,3953,PERF
42177322650000,PI,IP,001,1,10655,14555,4489,3900,PERF
42177322660000,PI,IP,001,1,9430,14601,5428,5171,PERF
42177322690000,PI,IP,001,1,6400,6642,4431,242,PERF
42177322690000,PI,IP,001,2,6800,7016,4431,216,PERF
42177322690000,PI,IP,001,3,7140,7332,4431,192,PERF
42177322690000,PI,IP,001,4,7402,7552,4431,150,PERF
42177322690000,PI,IP,001,5,7634,7896,4431,262,PERF
42177322690000,PI,IP,001,6,7966,8262,4431,296,PERF
42177322690000,PI,IP,001,7,8350,8550,4431,200,PERF
42177322690000,PI,IP,001,8,8625,8832,4431,207,PERF
42177322690000,PI,IP,001,9,8910,9097,4431,187,PERF
42177322690000,PI,IP,001,10,9180,9387,4431,207,PERF
42177322690000,PI,IP,001,11,9465,9671,4431,206,PERF
42177322690000,PI,IP,001,12,9739,9962,4431,223,PERF
42177322700000,PI,IP,001,1,7620,7875,4937,255,PERF
42177322700000,PI,IP,001,2,7906,8150,4937,244,PERF
42177322700000,PI,IP,001,3,8210,8425,4937,215,PERF
42177322700000,PI,IP,001,4,8480,8700,4937,220,PERF
42177322700000,PI,IP,001,5,8746,9050,4937,304,PERF
42177322700000,PI,IP,001,6,9100,9425,4937,325,PERF
42177322700000,PI,IP,001,7,9460,9785,4937,325,PERF
42177322700000,PI,IP,001,8,9834,10060,4937,226,PERF
42177322700000,PI,IP,001,9,10110,10400,4937,290,PERF
42177322700000,PI,IP,001,10,10430,10675,4937,245,PERF
42177322700000,PI,IP,001,11,10732,10950,4937,218,PERF
42177322700000,PI,IP,001,12,10974,11235,4937,261,PERF
42177322700000,PI,IP,001,13,11266,11524,4937,258,PERF
42177322700000,PI,IP,001,14,11561,11787,4937,226,PERF
42177322710000,PI,IP,001,1,11143,16979,6565,5836,PERF
42177322760000,PI,IP,001,1,11653,15806,4975,4153,PERF
42177322770000,PI,IP,001,1,13680,13923,6016,243,PERF
42177322770000,PI,IP,001,2,13990,14233,6016,243,PERF
42177322770000,PI,IP,001,3,14300,14543,6016,243,PERF
42177322770000,PI,IP,001,4,14610,14853,6016,243,PERF
42177322770000,PI,IP,001,5,14920,15163,6016,243,PERF
42177322770000,PI,IP,001,6,15230,15473,6016,243,PERF
42177322770000,PI,IP,001,7,15540,15783,6016,243,PERF
42177322770000,PI,IP,001,8,15850,16093,6016,243,PERF
42177322770000,PI,IP,001,9,16160,16403,6016,243,PERF
42177322770000,PI,IP,001,10,16470,16713,6016,243,PERF
42177322770000,PI,IP,001,11,16780,17033,6016,253,PERF
42177322780000,PI,IP,001,1,11815,12073,6116,258,PERF
42177322780000,PI,IP,001,2,12140,12398,6116,258,PERF
42177322780000,PI,IP,001,3,12465,12723,6116,258,PERF
42177322780000,PI,IP,001,4,12790,13048,6116,258,PERF
42177322780000,PI,IP,001,5,13115,13373,6116,258,PERF
42177322780000,PI,IP,001,6,13440,13698,6116,258,PERF
42177322780000,PI,IP,001,7,13765,14023,6116,258,PERF
42177322780000,PI,IP,001,8,14090,14348,6116,258,PERF
42177322780000,PI,IP,001,9,14415,14673,6116,258,PERF
42177322780000,PI,IP,001,10,14740,14998,6116,258,PERF
42177322780000,PI,IP,001,11,15065,15323,6116,258,PERF
42177322780000,PI,IP,001,12,15390,15648,6116,258,PERF
42177322780000,PI,IP,001,13,15715,15973,6116,258,PERF
42177322780000,PI,IP,001,14,16040,16298,6116,258,PERF
42177322780000,PI,IP,001,15,16365,16620,6116,255,PERF
42177322780000,PI,IP,001,16,16690,16945,6116,255,PERF
42177322780000,PI,IP,001,17,17015,17273,6116,258,PERF
42177322780000,PI,IP,001,18,17340,17592,6116,252,PERF
42177322790000,PI,IP,001,1,10987,16709,6136,5722,PERF
42177322800000,PI,IP,001,1,11104,14007,3859,2903,PERF
42177322810100,PI,IP,001,1,9946,14346,5380,4400,PERF
42177322840000,PI,IP,001,1,9890,14785,5303,4895,PERF
42177322860000,PI,IP,001,1,11686,11686,5650,0,PERF
42177322860000,PI,IP,001,2,11748,11748,5650,0,PERF
42177322860000,PI,IP,001,3,11809,11809,5650,0,PERF
42177322860000,PI,IP,001,4,11870,11870,5650,0,PERF
42177322860000,PI,IP,001,5,11931,11931,5650,0,PERF
42177322860000,PI,IP,001,6,11993,11993,5650,0,PERF
42177322860000,PI,IP,001,7,12054,12054,5650,0,PERF
42177322860000,PI,IP,001,8,12115,12115,5650,0,PERF
42177322860000,PI,IP,001,9,12176,12176,5650,0,PERF
42177322860000,PI,IP,001,10,12238,12238,5650,0,PERF
42177322860000,PI,IP,001,11,12299,12299,5650,0,PERF
42177322860000,PI,IP,001,12,12360,12360,5650,0,PERF
42177322860000,PI,IP,001,13,12421,12421,5650,0,PERF
42177322860000,PI,IP,001,14,12483,12483,5650,0,PERF
42177322860000,PI,IP,001,15,12544,12544,5650,0,PERF
42177322860000,PI,IP,001,16,12605,12605,5650,0,PERF
42177322860000,PI,IP,001,17,12666,12666,5650,0,PERF
42177322860000,PI,IP,001,18,12728,12728,5650,0,PERF
42177322860000,PI,IP,001,19,12789,12789,5650,0,PERF
42177322860000,PI,IP,001,20,12850,12850,5650,0,PERF
42177322860000,PI,IP,001,21,12911,12911,5650,0,PERF
42177322860000,PI,IP,001,22,12973,12973,5650,0,PERF
42177322860000,PI,IP,001,23,13034,13034,5650,0,PERF
42177322860000,PI,IP,001,24,13095,13095,5650,0,PERF
42177322860000,PI,IP,001,25,13156,13156,5650,0,PERF
42177322860000,PI,IP,001,26,13218,13218,5650,0,PERF
42177322860000,PI,IP,001,27,13279,13279,5650,0,PERF
42177322860000,PI,IP,001,28,13340,13340,5650,0,PERF
42177322860000,PI,IP,001,29,13401,13401,5650,0,PERF
42177322860000,PI,IP,001,30,13463,13463,5650,0,PERF
42177322860000,PI,IP,001,31,13524,13524,5650,0,PERF
42177322860000,PI,IP,001,32,13585,13585,5650,0,PERF
42177322860000,PI,IP,001,33,13646,13646,5650,0,PERF
42177322860000,PI,IP,001,34,13708,13708,5650,0,PERF
42177322860000,PI,IP,001,35,13769,13769,5650,0,PERF
42177322860000,PI,IP,001,36,13830,13830,5650,0,PERF
42177322860000,PI,IP,001,37,13891,13891,5650,0,PERF
42177322860000,PI,IP,001,38,13953,13953,5650,0,PERF
42177322860000,PI,IP,001,39,14014,14014,5650,0,PERF
42177322860000,PI,IP,001,40,14075,14075,5650,0,PERF
42177322860000,PI,IP,001,41,14136,14136,5650,0,PERF
42177322860000,PI,IP,001,42,14198,14198,5650,0,PERF
42177322860000,PI,IP,001,43,14259,14259,5650,0,PERF
42177322860000,PI,IP,001,44,14320,14320,5650,0,PERF
42177322860000,PI,IP,001,45,14381,14381,5650,0,PERF
42177322860000,PI,IP,001,46,14443,14443,5650,0,PERF
42177322860000,PI,IP,001,47,14504,14504,5650,0,PERF
42177322860000,PI,IP,001,48,14565,14565,5650,0,PERF
42177322860000,PI,IP,001,49,14626,14626,5650,0,PERF
42177322860000,PI,IP,001,50,14688,14688,5650,0,PERF
42177322860000,PI,IP,001,51,14749,14749,5650,0,PERF
42177322860000,PI,IP,001,52,14810,14810,5650,0,PERF
42177322860000,PI,IP,001,53,14871,14871,5650,0,PERF
42177322860000,PI,IP,001,54,14933,14933,5650,0,PERF
42177322860000,PI,IP,001,55,14994,14994,5650,0,PERF
42177322860000,PI,IP,001,56,15055,15055,5650,0,PERF
42177322860000,PI,IP,001,57,15157,15157,5650,0,PERF
42177322860000,PI,IP,001,58,15036,15036,5650,0,PERF
42177322860000,PI,IP,001,59,15498,15498,5650,0,PERF
42177322860000,PI,IP,001,60,15691,15691,5650,0,PERF
42177322860000,PI,IP,001,61,15884,15884,5650,0,PERF
42177322860000,PI,IP,001,62,16076,16076,5650,0,PERF
42177322860000,PI,IP,001,63,16267,16267,5650,0,PERF
42177322860000,PI,IP,001,64,16459,16459,5650,0,PERF
42177322860000,PI,IP,001,65,16652,16652,5650,0,PERF
42177322870000,PI,IP,001,1,11254,15473,5078,4219,PERF
42177322920000,PI,IP,001,1,11204,14196,4057,2992,PERF
42177322930000,PI,IP,001,1,11024,16977,6486,5953,PERF
42177322970000,PI,IP,001,1,10942,17600,7085,6658,PERF
42177322980000,PI,IP,001,1,11038,16387,6459,5349,PERF
42177322990000,PI,IP,001,1,10411,10411,6119,0,PERF
42177322990000,PI,IP,001,2,10470,10470,6119,0,PERF
42177322990000,PI,IP,001,3,10529,10529,6119,0,PERF
42177322990000,PI,IP,001,4,10588,10588,6119,0,PERF
42177322990000,PI,IP,001,5,10646,10646,6119,0,PERF
42177322990000,PI,IP,001,6,10705,10705,6119,0,PERF
42177322990000,PI,IP,001,7,10764,10764,6119,0,PERF
42177322990000,PI,IP,001,8,10823,10823,6119,0,PERF
42177322990000,PI,IP,001,9,10881,10881,6119,0,PERF
42177322990000,PI,IP,001,10,10941,10941,6119,0,PERF
42177322990000,PI,IP,001,11,11001,11001,6119,0,PERF
42177322990000,PI,IP,001,12,11061,11061,6119,0,PERF
42177322990000,PI,IP,001,13,11121,11121,6119,0,PERF
42177322990000,PI,IP,001,14,11180,11180,6119,0,PERF
42177322990000,PI,IP,001,15,11239,11239,6119,0,PERF
42177322990000,PI,IP,001,16,11298,11298,6119,0,PERF
42177322990000,PI,IP,001,17,11356,11356,6119,0,PERF
42177322990000,PI,IP,001,18,11416,11416,6119,0,PERF
42177322990000,PI,IP,001,19,11476,11476,6119,0,PERF
42177322990000,PI,IP,001,20,11536,11536,6119,0,PERF
42177322990000,PI,IP,001,21,11596,11596,6119,0,PERF
42177322990000,PI,IP,001,22,11656,11656,6119,0,PERF
42177322990000,PI,IP,001,23,11716,11716,6119,0,PERF
42177322990000,PI,IP,001,24,11776,11776,6119,0,PERF
42177322990000,PI,IP,001,25,11836,11836,6119,0,PERF
42177322990000,PI,IP,001,26,11896,11896,6119,0,PERF
42177322990000,PI,IP,001,27,11956,11956,6119,0,PERF
42177322990000,PI,IP,001,28,12016,12016,6119,0,PERF
42177322990000,PI,IP,001,29,12076,12076,6119,0,PERF
42177322990000,PI,IP,001,30,12136,12136,6119,0,PERF
42177322990000,PI,IP,001,31,12196,12196,6119,0,PERF
42177322990000,PI,IP,001,32,12256,12256,6119,0,PERF
42177322990000,PI,IP,001,33,12316,12316,6119,0,PERF
42177322990000,PI,IP,001,34,12376,12376,6119,0,PERF
42177322990000,PI,IP,001,35,12436,12436,6119,0,PERF
42177322990000,PI,IP,001,36,12496,12496,6119,0,PERF
42177322990000,PI,IP,001,37,12556,12556,6119,0,PERF
42177322990000,PI,IP,001,38,12616,12616,6119,0,PERF
42177322990000,PI,IP,001,39,12676,12676,6119,0,PERF
42177322990000,PI,IP,001,40,12736,12736,6119,0,PERF
42177322990000,PI,IP,001,41,12796,12796,6119,0,PERF
42177322990000,PI,IP,001,42,12856,12856,6119,0,PERF
42177322990000,PI,IP,001,43,12916,12916,6119,0,PERF
42177322990000,PI,IP,001,44,12976,12976,6119,0,PERF
42177322990000,PI,IP,001,45,13036,13036,6119,0,PERF
42177322990000,PI,IP,001,46,13096,13096,6119,0,PERF
42177322990000,PI,IP,001,47,13156,13156,6119,0,PERF
42177322990000,PI,IP,001,48,13216,13216,6119,0,PERF
42177322990000,PI,IP,001,49,13276,13276,6119,0,PERF
42177322990000,PI,IP,001,50,13336,13336,6119,0,PERF
42177322990000,PI,IP,001,51,13396,13396,6119,0,PERF
42177322990000,PI,IP,001,52,13456,13456,6119,0,PERF
42177322990000,PI,IP,001,53,13516,13516,6119,0,PERF
42177322990000,PI,IP,001,54,13576,13576,6119,0,PERF
42177322990000,PI,IP,001,55,13636,13636,6119,0,PERF
42177322990000,PI,IP,001,56,13696,13696,6119,0,PERF
42177322990000,PI,IP,001,57,13756,13816,6119,60,PERF
42177322990000,PI,IP,001,58,13816,13816,6119,0,PERF
42177322990000,PI,IP,001,59,13876,13876,6119,0,PERF
42177322990000,PI,IP,001,60,13936,13936,6119,0,PERF
42177322990000,PI,IP,001,61,14038,14038,6119,0,PERF
42177322990000,PI,IP,001,62,14229,14229,6119,0,PERF
42177322990000,PI,IP,001,63,14422,14422,6119,0,PERF
42177322990000,PI,IP,001,64,14615,14615,6119,0,PERF
42177322990000,PI,IP,001,65,14808,14808,6119,0,PERF
42177322990000,PI,IP,001,66,15001,15001,6119,0,PERF
42177322990000,PI,IP,001,67,15194,15194,6119,0,PERF
42177322990000,PI,IP,001,68,15387,15387,6119,0,PERF
42177322990000,PI,IP,001,69,15580,15580,6119,0,PERF
42177323000000,PI,IP,001,1,10990,16675,6331,5685,PERF
42177323030000,PI,IP,001,1,10771,16982,6739,6211,PERF
42177323040000,PI,IP,001,1,11463,14366,4727,2903,PERF
42177323050000,PI,IP,001,1,10795,17141,6520,6346,PERF
42177323060000,PI,IP,001,1,10837,16744,6018,5907,PERF
42177323080000,PI,IP,001,1,10852,17381,6791,6529,PERF
42177323100000,PI,IP,001,1,10948,15625,4930,4677,PERF
42177323110000,PI,IP,001,1,12072,16280,4463,4208,PERF
42177323120000,PI,IP,001,1,11161,16890,6455,5729,PERF
42177323130000,PI,IP,001,1,10752,14308,4106,3556,PERF
42177323150100,PI,IP,001,1,9515,12966,6331,3451,PERF
42177323160000,PI,IP,001,1,11142,14849,4377,3707,PERF
42177323170000,PI,IP,001,1,11370,11598,3360,228,PERF
42177323170000,PI,IP,001,2,11670,11895,3360,225,PERF
42177323170000,PI,IP,001,3,11970,12195,3360,225,PERF
42177323170000,PI,IP,001,4,12270,12495,3360,225,PERF
42177323170000,PI,IP,001,5,12570,12798,3360,228,PERF
42177323170000,PI,IP,001,6,12870,13098,3360,228,PERF
42177323170000,PI,IP,001,7,13170,13398,3360,228,PERF
42177323170000,PI,IP,001,8,13470,13698,3360,228,PERF
42177323170000,PI,IP,001,9,13770,14013,3360,243,PERF
42177323170000,PI,IP,001,10,14080,14323,3360,243,PERF
42177323170000,PI,IP,001,11,14387,14630,3360,243,PERF
42177323180000,PI,IP,001,1,9930,15117,5552,5187,PERF
42177323190000,PI,IP,001,1,10773,13906,3870,3133,PERF
42177323200000,PI,IP,001,1,9711,17417,8067,7706,PERF
42177323220000,PI,IP,001,1,12046,18234,7427,6188,PERF
42177323240000,PI,IP,001,1,11109,14084,3331,2975,PERF
42177323250000,PI,IP,001,1,11507,15460,5142,3953,PERF
42177323270000,PI,IP,001,1,11579,17826,6739,6247,PERF
42177323280000,PI,IP,001,1,11373,14526,3897,3153,PERF
42177323290000,PI,IP,001,1,11670,18048,6725,6378,PERF
42177323300000,PI,IP,001,1,11705,17357,6034,5652,PERF
42177323310000,PI,IP,001,1,11705,16538,5170,4833,PERF
42177323320000,PI,IP,001,1,11752,16131,4759,4379,PERF
42177323330000,PI,IP,001,1,11373,14526,4020,3153,PERF
42177323360000,PI,IP,001,1,11722,15586,4853,3864,PERF
42177323370000,PI,IP,001,1,10068,14350,4978,4282,PERF
42177323380000,PI,IP,001,1,11342,14745,4124,3403,PERF
42177323430000,PI,IP,001,1,11828,17727,6852,5899,PERF
42177323450000,PI,IP,001,1,10937,15369,4607,4432,PERF
42177323460000,PI,IP,001,1,9700,12301,3393,2601,PERF
42177323470000,PI,IP,001,1,11175,14404,3629,3229,PERF
42177323480000,PI,IP,001,1,11852,16463,5242,4611,PERF
42177323490000,PI,IP,001,1,12308,12310,6332,2,PERF
42177323490000,PI,IP,001,2,12425,12427,6332,2,PERF
42177323490000,PI,IP,001,3,12514,12516,6332,2,PERF
42177323490000,PI,IP,001,4,12603,12605,6332,2,PERF
42177323490000,PI,IP,001,5,12692,12694,6332,2,PERF
42177323490000,PI,IP,001,6,12781,12783,6332,2,PERF
42177323490000,PI,IP,001,7,12870,12872,6332,2,PERF
42177323490000,PI,IP,001,8,12959,12961,6332,2,PERF
42177323490000,PI,IP,001,9,13048,13050,6332,2,PERF
42177323490000,PI,IP,001,10,13136,13138,6332,2,PERF
42177323490000,PI,IP,001,11,13225,13227,6332,2,PERF
42177323490000,PI,IP,001,12,13314,13316,6332,2,PERF
42177323490000,PI,IP,001,13,13403,13405,6332,2,PERF
42177323490000,PI,IP,001,14,13492,13494,6332,2,PERF
42177323490000,PI,IP,001,15,13581,13583,6332,2,PERF
42177323490000,PI,IP,001,16,13670,13672,6332,2,PERF
42177323490000,PI,IP,001,17,13759,13761,6332,2,PERF
42177323490000,PI,IP,001,18,13848,13850,6332,2,PERF
42177323490000,PI,IP,001,19,13937,13939,6332,2,PERF
42177323490000,PI,IP,001,20,14026,14028,6332,2,PERF
42177323490000,PI,IP,001,21,14115,14117,6332,2,PERF
42177323490000,PI,IP,001,22,14204,14206,6332,2,PERF
42177323490000,PI,IP,001,23,14293,14295,6332,2,PERF
42177323490000,PI,IP,001,24,14382,14384,6332,2,PERF
42177323490000,PI,IP,001,25,14471,14473,6332,2,PERF
42177323490000,PI,IP,001,26,14560,14562,6332,2,PERF
42177323490000,PI,IP,001,27,14649,14651,6332,2,PERF
42177323490000,PI,IP,001,28,14738,14740,6332,2,PERF
42177323490000,PI,IP,001,29,15183,15185,6332,2,PERF
42177323490000,PI,IP,001,30,15272,15274,6332,2,PERF
42177323490000,PI,IP,001,31,15361,15363,6332,2,PERF
42177323490000,PI,IP,001,32,15450,15452,6332,2,PERF
42177323490000,PI,IP,001,33,15539,15541,6332,2,PERF
42177323490000,PI,IP,001,34,15628,15630,6332,2,PERF
42177323490000,PI,IP,001,35,15717,15719,6332,2,PERF
42177323490000,PI,IP,001,36,15806,15808,6332,2,PERF
42177323490000,PI,IP,001,37,15895,15897,6332,2,PERF
42177323490000,PI,IP,001,38,15983,15985,6332,2,PERF
42177323490000,PI,IP,001,39,16072,16074,6332,2,PERF
42177323490000,PI,IP,001,40,16161,16163,6332,2,PERF
42177323490000,PI,IP,001,41,16250,16252,6332,2,PERF
42177323490000,PI,IP,001,42,16339,16341,6332,2,PERF
42177323490000,PI,IP,001,43,16428,16430,6332,2,PERF
42177323490000,PI,IP,001,44,16517,16519,6332,2,PERF
42177323490000,PI,IP,001,45,16606,16608,6332,2,PERF
42177323490000,PI,IP,001,46,16695,16697,6332,2,PERF
42177323490000,PI,IP,001,47,16784,16786,6332,2,PERF
42177323490000,PI,IP,001,48,16873,16875,6332,2,PERF
42177323490000,PI,IP,001,49,16962,16964,6332,2,PERF
42177323490000,PI,IP,001,50,17051,17053,6332,2,PERF
42177323490000,PI,IP,001,51,17140,17142,6332,2,PERF
42177323490000,PI,IP,001,52,17229,17231,6332,2,PERF
42177323490000,PI,IP,001,53,17318,17320,6332,2,PERF
42177323490000,PI,IP,001,54,17398,17400,6332,2,PERF
42177323490000,PI,IP,001,55,17478,17480,6332,2,PERF
42177323490000,PI,IP,001,56,17558,17560,6332,2,PERF
42177323500000,PI,IP,001,1,10119,15694,6147,5575,PERF
42177323510000,PI,IP,001,1,9745,16294,7401,6549,PERF
42177323520000,PI,IP,001,1,11494,11734,,240,PERF
42177323520000,PI,IP,001,2,11804,12044,,240,PERF
42177323520000,PI,IP,001,3,12114,12354,,240,PERF
42177323520000,PI,IP,001,4,12424,12667,,243,PERF
42177323520000,PI,IP,001,5,12734,12974,,240,PERF
42177323520000,PI,IP,001,6,13044,13284,,240,PERF
42177323520000,PI,IP,001,7,13354,13594,,240,PERF
42177323520000,PI,IP,001,8,13664,13904,,240,PERF
42177323520000,PI,IP,001,9,13974,14214,,240,PERF
42177323520000,PI,IP,001,10,14284,14524,,240,PERF
42177323520000,PI,IP,001,11,14594,14834,,240,PERF
42177323520000,PI,IP,001,12,14904,15144,,240,PERF
42177323520000,PI,IP,001,13,15214,15454,,240,PERF
42177323520000,PI,IP,001,14,15524,15764,,240,PERF
42177323520000,PI,IP,001,15,15834,16074,,240,PERF
42177323520000,PI,IP,001,16,16144,16386,,242,PERF
42177323520000,PI,IP,001,17,16454,16696,,242,PERF
42177323530000,PI,IP,001,1,10900,15779,5183,4879,PERF
42177323540000,PI,IP,001,1,9800,16044,6746,6244,PERF
42177323550000,PI,IP,001,1,9790,15233,5980,5443,PERF
42177323560000,PI,IP,001,1,11745,17572,6440,5827,PERF
42177323570000,PI,IP,001,1,11907,15060,4741,3153,PERF
42177323580000,PI,IP,001,1,11314,16484,5377,5170,PERF
42177323590000,PI,IP,001,1,11652,15924,4502,4272,PERF
42177323600000,PI,IP,001,1,9930,14507,5133,4577,PERF
42177323610000,PI,IP,001,1,10154,14694,5265,4540,PERF
42177323620000,PI,IP,001,1,9911,15038,5694,5127,PERF
42177323630000,PI,IP,001,1,10096,14801,5417,4705,PERF
42177323650000,PI,IP,001,1,11692,16378,5050,4686,PERF
42177323660000,PI,IP,001,1,11474,14889,4228,3415,PERF
42177323680000,PI,IP,001,1,9993,13878,4491,3885,PERF
42177323690000,PI,IP,001,1,9872,15247,5926,5375,PERF
42177323700000,PI,IP,001,1,11684,16994,5628,5310,PERF
42177323710000,PI,IP,001,1,11683,16670,5274,4987,PERF
42177323720000,PI,IP,001,1,11766,17396,6055,5630,PERF
42177323730000,PI,IP,001,1,11897,17277,5957,5380,PERF
42177323740000,PI,IP,001,1,9467,14953,5893,5486,PERF
42177323750000,PI,IP,001,1,11132,12832,2661,1700,PERF
42177323760000,PI,IP,001,1,10994,14438,4506,3444,PERF
42177323790000,PI,IP,001,1,9669,14572,4477,4903,PERF
42177323810000,PI,IP,001,1,9850,14566,,4716,PERF
42177323820000,PI,IP,001,1,10043,14585,5214,4542,PERF
42177323830000,PI,IP,001,1,9935,15445,6306,5510,PERF
42177323850000,PI,IP,001,1,9850,16058,6795,6208,PERF
42177323860000,PI,IP,001,1,10230,10532,5867,302,PERF
42177323860000,PI,IP,001,2,10628,10844,5867,216,PERF
42177323860000,PI,IP,001,3,10924,11172,5867,248,PERF
42177323860000,PI,IP,001,4,11234,11470,5867,236,PERF
42177323860000,PI,IP,001,5,11500,11762,5867,262,PERF
42177323860000,PI,IP,001,6,11834,12070,5867,236,PERF
42177323860000,PI,IP,001,7,12138,12350,5867,212,PERF
42177323860000,PI,IP,001,8,12430,12636,5867,206,PERF
42177323860000,PI,IP,001,9,12712,12950,5867,238,PERF
42177323860000,PI,IP,001,10,13020,13238,5867,218,PERF
42177323860000,PI,IP,001,11,13308,13444,5867,136,PERF
42177323860000,PI,IP,001,12,13622,13850,5867,228,PERF
42177323860000,PI,IP,001,13,13954,14186,5867,232,PERF
42177323860000,PI,IP,001,14,14278,14526,5867,248,PERF
42177323860000,PI,IP,001,15,14762,14998,5867,236,PERF
42177323860000,PI,IP,001,16,15070,15302,5867,232,PERF
42177323870000,PI,IP,001,1,11887,17911,6584,6024,PERF
42177323880000,PI,IP,001,1,11000,15939,5482,4939,PERF
42177323890000,PI,IP,001,1,12241,12423,4755,182,PERF
42177323890000,PI,IP,001,2,12491,12673,4755,182,PERF
42177323890000,PI,IP,001,3,12737,12923,4755,186,PERF
42177323890000,PI,IP,001,4,12991,13173,4755,182,PERF
42177323890000,PI,IP,001,5,13241,13423,4755,182,PERF
42177323890000,PI,IP,001,6,13491,13673,4755,182,PERF
42177323890000,PI,IP,001,7,13741,13923,4755,182,PERF
42177323890000,PI,IP,001,8,13991,14168,4755,177,PERF
42177323890000,PI,IP,001,9,14241,14423,4755,182,PERF
42177323890000,PI,IP,001,10,14487,14673,4755,186,PERF
42177323890000,PI,IP,001,11,14741,14923,4755,182,PERF
42177323890000,PI,IP,001,12,14991,15173,4755,182,PERF
42177323890000,PI,IP,001,13,15241,15423,4755,182,PERF
42177323890000,PI,IP,001,14,15491,15733,4755,242,PERF
42177323900000,PI,IP,001,1,11687,11929,5343,242,PERF
42177323900000,PI,IP,001,2,11997,12239,5343,242,PERF
42177323900000,PI,IP,001,3,12307,12549,5343,242,PERF
42177323900000,PI,IP,001,4,12617,12859,5343,242,PERF
42177323900000,PI,IP,001,5,12927,13169,5343,242,PERF
42177323900000,PI,IP,001,6,13237,13479,5343,242,PERF
42177323900000,PI,IP,001,7,13547,13789,5343,242,PERF
42177323900000,PI,IP,001,8,13857,14099,5343,242,PERF
42177323900000,PI,IP,001,9,14167,14409,5343,242,PERF
42177323900000,PI,IP,001,10,14477,14719,5343,242,PERF
42177323900000,PI,IP,001,11,14787,15029,5343,242,PERF
42177323900000,PI,IP,001,12,15097,15339,5343,242,PERF
42177323900000,PI,IP,001,13,15407,15649,5343,242,PERF
42177323900000,PI,IP,001,14,15717,15879,5343,162,PERF
42177323910000,PI,IP,001,1,9927,14657,5658,4730,PERF
42177323930000,PI,IP,001,1,11680,11862,6233,182,PERF
42177323930000,PI,IP,001,2,11920,12160,6233,240,PERF
42177323930000,PI,IP,001,3,12240,12482,6233,242,PERF
42177323930000,PI,IP,001,4,12560,12802,6233,242,PERF
42177323930000,PI,IP,001,5,12880,13122,6233,242,PERF
42177323930000,PI,IP,001,6,13200,13442,6233,242,PERF
42177323930000,PI,IP,001,7,13520,13762,6233,242,PERF
42177323930000,PI,IP,001,8,13840,14082,6233,242,PERF
42177323930000,PI,IP,001,9,14160,14402,6233,242,PERF
42177323930000,PI,IP,001,10,14480,14722,6233,242,PERF
42177323930000,PI,IP,001,11,14800,15042,6233,242,PERF
42177323930000,PI,IP,001,12,15120,15362,6233,242,PERF
42177323930000,PI,IP,001,13,15440,15682,6233,242,PERF
42177323930000,PI,IP,001,14,15760,16002,6233,242,PERF
42177323930000,PI,IP,001,15,16145,16405,6233,260,PERF
42177323940000,PI,IP,001,1,11904,12146,6400,242,PERF
42177323940000,PI,IP,001,2,12218,12456,6400,238,PERF
42177323940000,PI,IP,001,3,12524,12766,6400,242,PERF
42177323940000,PI,IP,001,4,12834,13076,6400,242,PERF
42177323940000,PI,IP,001,5,13144,13384,6400,240,PERF
42177323940000,PI,IP,001,6,13454,13692,6400,238,PERF
42177323940000,PI,IP,001,7,13764,14006,6400,242,PERF
42177323940000,PI,IP,001,8,14076,14316,6400,240,PERF
42177323940000,PI,IP,001,9,14384,14624,6400,240,PERF
42177323940000,PI,IP,001,10,14694,14936,6400,242,PERF
42177323940000,PI,IP,001,11,15002,15244,6400,242,PERF
42177323940000,PI,IP,001,12,15314,15554,6400,240,PERF
42177323940000,PI,IP,001,13,15624,15864,6400,240,PERF
42177323940000,PI,IP,001,14,15934,16174,6400,240,PERF
42177323940000,PI,IP,001,15,16244,16486,6400,242,PERF
42177323940000,PI,IP,001,16,16554,16794,6400,240,PERF
42177323950000,PI,IP,001,1,10031,14335,4856,4304,PERF
42177323960000,PI,IP,001,1,9899,14439,4952,4540,PERF
42177323980000,PI,IP,001,1,11323,13226,3651,1903,PERF
42177323990000,PI,IP,001,1,11607,14010,4219,2403,PERF
42177324000000,PI,IP,001,1,11015,16041,5630,5026,PERF
42177324010000,PI,IP,001,1,11061,17310,6963,6249,PERF
42177324020000,PI,IP,001,1,11975,15670,4685,3695,PERF
42177324030000,PI,IP,001,1,10704,17038,6682,6334,PERF
42177324040000,PI,IP,001,1,10874,17334,6677,6460,PERF
42177324060000,PI,IP,001,1,10996,15740,5191,4744,PERF
42177324110000,PI,IP,001,1,11110,15764,5191,4654,PERF
42177324120000,PI,IP,001,1,11650,15066,3779,3416,PERF
42177324130000,PI,IP,001,1,11675,14911,3645,3236,PERF
42177324150000,PI,IP,001,1,12000,15744,4774,3744,PERF
42177324160000,PI,IP,001,1,11448,15236,5528,3788,PERF
42177324170200,PI,IP,001,1,9885,14320,5365,4435,PERF
42177324180000,PI,IP,001,1,11674,11674,3376,0,PERF
42177324180000,PI,IP,001,2,11823,11823,3376,0,PERF
42177324180000,PI,IP,001,3,12013,12013,3376,0,PERF
42177324180000,PI,IP,001,4,12203,12203,3376,0,PERF
42177324180000,PI,IP,001,5,12397,12397,3376,0,PERF
42177324180000,PI,IP,001,6,12588,12588,3376,0,PERF
42177324180000,PI,IP,001,7,12781,12781,3376,0,PERF
42177324180000,PI,IP,001,8,12974,12974,3376,0,PERF
42177324180000,PI,IP,001,9,13167,13167,3376,0,PERF
42177324190000,PI,IP,001,1,11810,16650,5556,4840,PERF
42177324200000,PI,IP,001,1,12285,16676,4995,4391,PERF
42177324210000,PI,IP,001,1,12048,17059,5661,5011,PERF
42177324220000,PI,IP,001,1,12130,15984,4739,3854,PERF
42177324230000,PI,IP,001,1,11912,18000,6570,6088,PERF
42177324240000,PI,IP,001,1,9988,10190,5564,202,PERF
42177324240000,PI,IP,001,2,10273,10475,5564,202,PERF
42177324240000,PI,IP,001,3,10558,10760,5564,202,PERF
42177324240000,PI,IP,001,4,10843,11045,5564,202,PERF
42177324240000,PI,IP,001,5,11128,11330,5564,202,PERF
42177324240000,PI,IP,001,6,11413,11615,5564,202,PERF
42177324240000,PI,IP,001,7,11698,11900,5564,202,PERF
42177324240000,PI,IP,001,8,11983,12185,5564,202,PERF
42177324240000,PI,IP,001,9,12268,12470,5564,202,PERF
42177324240000,PI,IP,001,10,12553,12755,5564,202,PERF
42177324240000,PI,IP,001,11,12838,13040,5564,202,PERF
42177324240000,PI,IP,001,12,13123,13325,5564,202,PERF
42177324240000,PI,IP,001,13,13408,13610,5564,202,PERF
42177324240000,PI,IP,001,14,13693,13893,5564,200,PERF
42177324240000,PI,IP,001,15,13978,14180,5564,202,PERF
42177324240000,PI,IP,001,16,14263,14465,5564,202,PERF
42177324240000,PI,IP,001,17,14530,14750,5564,220,PERF
42177324250000,PI,IP,001,1,11425,15128,4407,3703,PERF
42177324270000,PI,IP,001,1,12142,16334,5247,4192,PERF
42177324280000,PI,IP,001,1,12045,16084,4803,4039,PERF
42177324290000,PI,IP,001,1,12174,17104,5334,4930,PERF
42177324300000,PI,IP,001,1,11985,16370,5284,4385,PERF
42177324310000,PI,IP,001,1,12072,16459,5652,4387,PERF
42177324330000,PI,IP,001,1,11815,16428,5248,4613,PERF
42177324340100,PI,IP,001,1,10404,15095,6023,4691,PERF
42177324360000,PI,IP,001,1,9900,14226,5263,4326,PERF
42177324370000,PI,IP,001,1,11760,17106,6106,5346,PERF
42177324390000,PI,IP,001,1,10889,14287,4331,3398,PERF
42177324400000,PI,IP,001,1,11002,14951,4428,3949,PERF
42177324410000,PI,IP,001,1,11040,15390,5311,4350,PERF
42177324420000,PI,IP,001,1,11794,16400,5268,4606,PERF
42177324430000,PI,IP,001,1,11928,17301,5660,5373,PERF
42177324440000,PI,IP,001,1,10025,14759,5353,4734,PERF
42177324450000,PI,IP,001,1,9944,15289,5533,5345,PERF
42177324460100,PI,IP,001,1,10169,14572,5647,4403,PERF
42177324470000,PI,IP,001,1,11552,17361,6654,5809,PERF
42177324480000,PI,IP,001,1,10907,14770,4903,3863,PERF
42177324490000,PI,IP,001,1,10932,14513,4751,3581,PERF
42177324500000,PI,IP,001,1,10971,14315,4682,3344,PERF
42177324510000,PI,IP,001,1,11063,15348,4845,4285,PERF
42177324520000,PI,IP,001,1,10981,15110,4429,4129,PERF
42177324530000,PI,IP,001,1,10731,16048,5403,5317,PERF
42177324540000,PI,IP,001,1,10842,15911,5348,5069,PERF
42177324550000,PI,IP,001,1,11844,15817,4481,3973,PERF
42177324560000,PI,IP,001,1,12180,12360,5837,180,PERF
42177324560000,PI,IP,001,2,12430,12610,5837,180,PERF
42177324560000,PI,IP,001,3,12680,12875,5837,195,PERF
42177324560000,PI,IP,001,4,12945,13142,5837,197,PERF
42177324560000,PI,IP,001,5,13210,13412,5837,202,PERF
42177324560000,PI,IP,001,6,13475,13672,5837,197,PERF
42177324560000,PI,IP,001,7,13740,13937,5837,197,PERF
42177324560000,PI,IP,001,8,14005,14202,5837,197,PERF
42177324560000,PI,IP,001,9,14270,14467,5837,197,PERF
42177324560000,PI,IP,001,10,14538,14732,5837,194,PERF
42177324560000,PI,IP,001,11,14804,14997,5837,193,PERF
42177324560000,PI,IP,001,12,15060,15262,5837,202,PERF
42177324560000,PI,IP,001,13,15326,15527,5837,201,PERF
42177324560000,PI,IP,001,14,15593,15792,5837,199,PERF
42177324560000,PI,IP,001,15,15860,16057,5837,197,PERF
42177324560000,PI,IP,001,16,16125,16322,5837,197,PERF
42177324560000,PI,IP,001,17,16478,16539,5837,61,PERF
42177324570000,PI,IP,001,1,11479,16003,5163,4524,PERF
42177324610000,PI,IP,001,1,12625,12855,5533,230,PERF
42177324610000,PI,IP,001,2,12892,13107,5533,215,PERF
42177324610000,PI,IP,001,3,13165,13377,5533,212,PERF
42177324610000,PI,IP,001,4,13435,13647,5533,212,PERF
42177324610000,PI,IP,001,5,13705,13917,5533,212,PERF
42177324610000,PI,IP,001,6,13975,14187,5533,212,PERF
42177324610000,PI,IP,001,7,14245,14457,5533,212,PERF
42177324610000,PI,IP,001,8,14515,14727,5533,212,PERF
42177324610000,PI,IP,001,9,14785,14997,5533,212,PERF
42177324610000,PI,IP,001,10,15102,15317,5533,215,PERF
42177324610000,PI,IP,001,11,15375,15587,5533,212,PERF
42177324610000,PI,IP,001,12,15642,15857,5533,215,PERF
42177324610000,PI,IP,001,13,15915,16127,5533,212,PERF
42177324610000,PI,IP,001,14,16185,16397,5533,212,PERF
42177324620000,PI,IP,001,1,11811,15850,4410,4039,PERF
42177324630000,PI,IP,001,1,12439,12441,6405,2,PERF
42177324630000,PI,IP,001,2,12515,12517,6405,2,PERF
42177324630000,PI,IP,001,3,12591,12593,6405,2,PERF
42177324630000,PI,IP,001,4,12667,12669,6405,2,PERF
42177324630000,PI,IP,001,5,12743,12745,6405,2,PERF
42177324630000,PI,IP,001,6,12819,12821,6405,2,PERF
42177324630000,PI,IP,001,7,12895,12897,6405,2,PERF
42177324630000,PI,IP,001,8,12971,12973,6405,2,PERF
42177324630000,PI,IP,001,9,13047,13049,6405,2,PERF
42177324630000,PI,IP,001,10,13123,13125,6405,2,PERF
42177324630000,PI,IP,001,11,13199,13201,6405,2,PERF
42177324630000,PI,IP,001,12,13275,13277,6405,2,PERF
42177324630000,PI,IP,001,13,13351,13353,6405,2,PERF
42177324630000,PI,IP,001,14,13427,13429,6405,2,PERF
42177324630000,PI,IP,001,15,13503,13505,6405,2,PERF
42177324630000,PI,IP,001,16,13579,13581,6405,2,PERF
42177324630000,PI,IP,001,17,13655,13657,6405,2,PERF
42177324630000,PI,IP,001,18,13731,13733,6405,2,PERF
42177324630000,PI,IP,001,19,13807,13809,6405,2,PERF
42177324630000,PI,IP,001,20,13883,13885,6405,2,PERF
42177324630000,PI,IP,001,21,13959,13961,6405,2,PERF
42177324630000,PI,IP,001,22,14035,14037,6405,2,PERF
42177324630000,PI,IP,001,23,14111,14113,6405,2,PERF
42177324630000,PI,IP,001,24,14187,14189,6405,2,PERF
42177324630000,PI,IP,001,25,14263,14265,6405,2,PERF
42177324630000,PI,IP,001,26,14339,14341,6405,2,PERF
42177324630000,PI,IP,001,27,14415,14417,6405,2,PERF
42177324630000,PI,IP,001,28,14491,14493,6405,2,PERF
42177324630000,PI,IP,001,29,14567,14569,6405,2,PERF
42177324630000,PI,IP,001,30,14643,14645,6405,2,PERF
42177324630000,PI,IP,001,31,14719,14721,6405,2,PERF
42177324630000,PI,IP,001,32,14795,14797,6405,2,PERF
42177324630000,PI,IP,001,33,14871,14873,6405,2,PERF
42177324630000,PI,IP,001,34,14947,14949,6405,2,PERF
42177324630000,PI,IP,001,35,15023,15025,6405,2,PERF
42177324630000,PI,IP,001,36,15099,15101,6405,2,PERF
42177324630000,PI,IP,001,37,15175,15177,6405,2,PERF
42177324630000,PI,IP,001,38,15251,15253,6405,2,PERF
42177324630000,PI,IP,001,39,15327,15329,6405,2,PERF
42177324630000,PI,IP,001,40,15403,15405,6405,2,PERF
42177324630000,PI,IP,001,41,15479,15481,6405,2,PERF
42177324630000,PI,IP,001,42,15555,15557,6405,2,PERF
42177324630000,PI,IP,001,43,15631,15633,6405,2,PERF
42177324630000,PI,IP,001,44,15707,15709,6405,2,PERF
42177324630000,PI,IP,001,45,15783,15785,6405,2,PERF
42177324630000,PI,IP,001,46,15859,15861,6405,2,PERF
42177324630000,PI,IP,001,47,15935,15937,6405,2,PERF
42177324630000,PI,IP,001,48,16011,16013,6405,2,PERF
42177324630000,PI,IP,001,49,16087,16089,6405,2,PERF
42177324630000,PI,IP,001,50,16163,16165,6405,2,PERF
42177324630000,PI,IP,001,51,16239,16241,6405,2,PERF
42177324630000,PI,IP,001,52,16315,16317,6405,2,PERF
42177324630000,PI,IP,001,53,16391,16393,6405,2,PERF
42177324630000,PI,IP,001,54,16467,16469,6405,2,PERF
42177324630000,PI,IP,001,55,16543,16545,6405,2,PERF
42177324630000,PI,IP,001,56,16619,16621,6405,2,PERF
42177324630000,PI,IP,001,57,16695,16697,6405,2,PERF
42177324630000,PI,IP,001,58,16771,16773,6405,2,PERF
42177324630000,PI,IP,001,59,16847,16849,6405,2,PERF
42177324630000,PI,IP,001,60,16923,16925,6405,2,PERF
42177324630000,PI,IP,001,61,17010,17012,6405,2,PERF
42177324630000,PI,IP,001,62,17090,17092,6405,2,PERF
42177324630000,PI,IP,001,63,17170,17172,6405,2,PERF
42177324630000,PI,IP,001,64,17250,17252,6405,2,PERF
42177324640000,PI,IP,001,1,11445,16922,6089,5477,PERF
42177324650000,PI,IP,001,1,11850,12122,6021,272,PERF
42177324650000,PI,IP,001,2,12210,12482,6021,272,PERF
42177324650000,PI,IP,001,3,12570,12842,6021,272,PERF
42177324650000,PI,IP,001,4,12934,13202,6021,268,PERF
42177324650000,PI,IP,001,5,13290,13562,6021,272,PERF
42177324650000,PI,IP,001,6,13650,13922,6021,272,PERF
42177324650000,PI,IP,001,7,14010,14282,6021,272,PERF
42177324650000,PI,IP,001,8,14370,14642,6021,272,PERF
42177324650000,PI,IP,001,9,14730,15002,6021,272,PERF
42177324650000,PI,IP,001,10,15094,15362,6021,268,PERF
42177324650000,PI,IP,001,11,15450,15722,6021,272,PERF
42177324650000,PI,IP,001,12,15810,16082,6021,272,PERF
42177324650000,PI,IP,001,13,16170,16442,6021,272,PERF
42177324650000,PI,IP,001,14,16530,16802,6021,272,PERF
42177324650000,PI,IP,001,15,16892,17164,6021,272,PERF
42177324660000,PI,IP,001,1,11865,16654,5657,4789,PERF
42177324670000,PI,IP,001,1,9949,10163,5534,214,PERF
42177324670000,PI,IP,001,2,10233,10447,5534,214,PERF
42177324670000,PI,IP,001,3,10517,10731,5534,214,PERF
42177324670000,PI,IP,001,4,10816,11015,5534,199,PERF
42177324670000,PI,IP,001,5,11085,11299,5534,214,PERF
42177324670000,PI,IP,001,6,11369,11582,5534,213,PERF
42177324670000,PI,IP,001,7,11653,11867,5534,214,PERF
42177324670000,PI,IP,001,8,11941,12151,5534,210,PERF
42177324670000,PI,IP,001,9,12221,12435,5534,214,PERF
42177324670000,PI,IP,001,10,12505,12722,5534,217,PERF
42177324670000,PI,IP,001,11,12789,12997,5534,208,PERF
42177324670000,PI,IP,001,12,13083,13287,5534,204,PERF
42177324670000,PI,IP,001,13,13357,13573,5534,216,PERF
42177324670000,PI,IP,001,14,13641,13855,5534,214,PERF
42177324670000,PI,IP,001,15,13930,14139,5534,209,PERF
42177324670000,PI,IP,001,16,14209,14423,5534,214,PERF
42177324670000,PI,IP,001,17,14490,14707,5534,217,PERF
42177324670000,PI,IP,001,18,14775,14977,5534,202,PERF
42177324680000,PI,IP,001,1,9987,14948,5714,4961,PERF
42177324690000,PI,IP,001,1,9915,14810,5544,4895,PERF
42177324710000,PI,IP,001,1,11708,17253,5978,5545,PERF
42177324720000,PI,IP,001,1,10841,14544,4415,3703,PERF
42177324730000,PI,IP,001,1,11761,17395,6212,5634,PERF
42177324740000,PI,IP,001,1,11915,17509,6205,5594,PERF
42177324750000,PI,IP,001,1,11710,17245,6203,5535,PERF
42177324760000,PI,IP,001,1,11688,17187,5920,5499,PERF
42177324770000,PI,IP,001,1,11647,17445,5959,5798,PERF
42177324780000,PI,IP,001,1,9186,13825,5425,4639,PERF
42177324790000,PI,IP,001,1,9914,15642,6377,5728,PERF
42177324800000,PI,IP,001,1,10886,14089,3522,3203,PERF
42177324810000,PI,IP,001,1,10893,14043,3342,3150,PERF
42177324850000,PI,IP,001,1,10002,14460,4900,4458,PERF
42177324860000,PI,IP,001,1,10116,14502,5024,4386,PERF
42177324870000,PI,IP,001,1,9975,14764,5265,4789,PERF
42177324880000,PI,IP,001,1,11196,16355,6013,5159,PERF
42177324920100,PI,IP,001,1,9886,15632,6411,5746,PERF
42177324940000,PI,IP,001,1,9686,9907,4863,221,PERF
42177324940000,PI,IP,001,2,9985,10212,4863,227,PERF
42177324940000,PI,IP,001,3,10290,10517,4863,227,PERF
42177324940000,PI,IP,001,4,10593,10822,4863,229,PERF
42177324940000,PI,IP,001,5,10900,11127,4863,227,PERF
42177324940000,PI,IP,001,6,11205,11432,4863,227,PERF
42177324940000,PI,IP,001,7,11510,11737,4863,227,PERF
42177324940000,PI,IP,001,8,11815,12042,4863,227,PERF
42177324940000,PI,IP,001,9,12120,12347,4863,227,PERF
42177324940000,PI,IP,001,10,12425,12652,4863,227,PERF
42177324940000,PI,IP,001,11,12730,12737,4863,7,PERF
42177324940000,PI,IP,001,12,12810,13022,4863,212,PERF
42177324940000,PI,IP,001,13,13097,13312,4863,215,PERF
42177324940000,PI,IP,001,14,13390,13602,4863,212,PERF
42177324940000,PI,IP,001,15,13680,13892,4863,212,PERF
42177324950000,PI,IP,001,1,11896,15450,5123,3554,PERF
42177324960000,PI,IP,001,1,11633,15376,4249,3743,PERF
42177324970000,PI,IP,001,1,10116,14909,5743,4793,PERF
42177324980000,PI,IP,001,1,11025,14962,4509,3937,PERF
42177324990000,PI,IP,001,1,11718,16015,4754,4297,PERF
42177325000000,PI,IP,001,1,12150,19050,8306,6900,PERF
42177325010000,PI,IP,002,1,12107,16236,4544,4129,PERF
42177325010000,PI,PT,001,1,12107,16236,4544,4129,PERF
42177325020000,PI,IP,002,1,12199,15475,,3276,PERF
42177325020000,PI,PT,001,1,12199,15475,,3276,PERF
42177325030000,PI,IP,002,1,12262,14881,,2619,PERF
42177325030000,PI,PT,001,1,12262,14881,,2619,PERF
42177325050000,PI,IP,001,1,11051,15108,4546,4057,PERF
42177325060000,PI,IP,001,1,10184,16051,6893,5867,PERF
42177325070000,PI,IP,001,1,10935,13588,3607,2653,PERF
42177325080000,PI,IP,001,1,12185,19202,7833,7017,PERF
42177325090000,PI,IP,001,1,11123,14578,4811,3455,PERF
42177325100000,PI,IP,001,1,10634,15787,6783,5153,PERF
42177325120000,PI,IP,001,1,11822,16120,4844,4298,PERF
42177325130000,PI,IP,001,1,11873,15678,4368,3805,PERF
42177325140000,PI,IP,001,1,12231,19439,7931,7208,PERF
42177325160000,PI,IP,001,1,10462,14782,5454,4320,PERF
42177325170000,PI,IP,001,1,11859,15786,4359,3927,PERF
42177325180000,PI,IP,001,1,10740,15643,6213,4903,PERF
42177325190000,PI,IP,001,1,11727,11926,7807,199,PERF
42177325190000,PI,IP,001,2,12055,12315,7807,260,PERF
42177325190000,PI,IP,001,3,12449,12713,7807,264,PERF
42177325190000,PI,IP,001,4,12843,13107,7807,264,PERF
42177325190000,PI,IP,001,5,13236,13501,7807,265,PERF
42177325190000,PI,IP,001,6,13630,13895,7807,265,PERF
42177325190000,PI,IP,001,7,15827,16091,7807,264,PERF
42177325190000,PI,IP,001,8,16220,16485,7807,265,PERF
42177325190000,PI,IP,001,9,16614,16879,7807,265,PERF
42177325190000,PI,IP,001,10,17008,17272,7807,264,PERF
42177325190000,PI,IP,001,11,17402,17666,7807,264,PERF
42177325190000,PI,IP,001,12,17888,18112,7807,224,PERF
42177325200000,PI,IP,001,1,9187,9384,4309,197,PERF
42177325200000,PI,IP,001,2,9438,9639,4309,201,PERF
42177325200000,PI,IP,001,3,9697,9896,4309,199,PERF
42177325200000,PI,IP,001,4,9952,10149,4309,197,PERF
42177325200000,PI,IP,001,5,10207,10404,4309,197,PERF
42177325200000,PI,IP,001,6,10468,10659,4309,191,PERF
42177325200000,PI,IP,001,7,10717,10914,4309,197,PERF
42177325200000,PI,IP,001,8,10972,11169,4309,197,PERF
42177325200000,PI,IP,001,9,11227,11420,4309,193,PERF
42177325200000,PI,IP,001,10,11482,11679,4309,197,PERF
42177325200000,PI,IP,001,11,11737,11965,4309,228,PERF
42177325210000,PI,IP,001,1,9758,15660,6673,5902,PERF
42177325220000,PI,IP,001,1,12104,15627,4266,3523,PERF
42177325240000,PI,IP,001,1,9786,14436,5437,4650,PERF
42177325250000,PI,IP,001,1,11831,15891,4616,4060,PERF
42177325260000,PI,IP,001,1,7270,7452,5468,182,PERF
42177325260000,PI,IP,001,2,7510,7692,5468,182,PERF
42177325260000,PI,IP,001,3,7750,7932,5468,182,PERF
42177325260000,PI,IP,001,4,7990,8172,5468,182,PERF
42177325260000,PI,IP,001,5,8230,8412,5468,182,PERF
42177325260000,PI,IP,001,6,8468,8662,5468,194,PERF
42177325260000,PI,IP,001,7,8720,8902,5468,182,PERF
42177325260000,PI,IP,001,8,8958,9140,5468,182,PERF
42177325260000,PI,IP,001,9,9200,9378,5468,178,PERF
42177325260000,PI,IP,001,10,9440,9622,5468,182,PERF
42177325260000,PI,IP,001,11,9682,9862,5468,180,PERF
42177325260000,PI,IP,001,12,9920,10102,5468,182,PERF
42177325260000,PI,IP,001,13,10160,10342,5468,182,PERF
42177325260000,PI,IP,001,14,10400,10582,5468,182,PERF
42177325260000,PI,IP,001,15,10640,10822,5468,182,PERF
42177325260000,PI,IP,001,16,10880,11062,5468,182,PERF
42177325260000,PI,IP,001,17,11120,11302,5468,182,PERF
42177325260000,PI,IP,001,18,11360,11542,5468,182,PERF
42177325260000,PI,IP,001,19,11600,11802,5468,202,PERF
42177325300000,PI,IP,001,1,11340,15846,5362,4506,PERF
42177325310100,PI,IP,001,1,9633,13925,5177,4292,PERF
42177325340000,PI,IP,001,1,10638,16851,6044,6213,PERF
42177325350000,PI,IP,001,1,10751,13904,3969,3153,PERF
42177325360000,PI,IP,001,1,11929,15704,4350,3775,PERF
42177325370000,PI,IP,001,1,9746,13046,4587,3300,PERF
42177325380200,PI,IP,001,1,12439,17483,5759,5044,PERF
42177325390000,PI,IP,001,1,11296,16381,5587,5085,PERF
42177325400000,PI,IP,001,1,11690,16236,5049,4546,PERF
42177325410000,PI,IP,001,1,11202,15525,5038,4323,PERF
42177325420000,PI,IP,001,1,10973,15715,5345,4742,PERF
42177325430000,PI,IP,001,1,11390,15519,4589,4129,PERF
42177325440000,PI,IP,001,1,11042,15766,5394,4724,PERF
42177325450000,PI,IP,001,1,11937,18235,7068,6298,PERF
42177325460000,PI,IP,001,1,11343,16765,6062,5422,PERF
42177325470000,PI,IP,001,1,10981,16499,6046,5518,PERF
42177325510000,PI,IP,001,1,11301,15934,,4633,PERF
42177325520000,PI,IP,001,1,10974,17293,6763,6319,PERF
42177325530000,PI,IP,001,1,11527,16958,,5431,PERF
42177325540000,PI,IP,001,1,9762,16442,7470,6680,PERF
42177325560000,PI,IP,001,1,10340,10602,6099,262,PERF
42177325560000,PI,IP,001,2,10683,10946,6099,263,PERF
42177325560000,PI,IP,001,3,11024,11287,6099,263,PERF
42177325560000,PI,IP,001,4,11365,11628,6099,263,PERF
42177325560000,PI,IP,001,5,11706,11969,6099,263,PERF
42177325560000,PI,IP,001,6,12047,12314,6099,267,PERF
42177325560000,PI,IP,001,7,12388,12651,6099,263,PERF
42177325560000,PI,IP,001,8,12729,12992,6099,263,PERF
42177325560000,PI,IP,001,9,13070,13333,6099,263,PERF
42177325560000,PI,IP,001,10,13411,13674,6099,263,PERF
42177325560000,PI,IP,001,11,13752,14013,6099,261,PERF
42177325560000,PI,IP,001,12,14093,14352,6099,259,PERF
42177325560000,PI,IP,001,13,14434,14697,6099,263,PERF
42177325560000,PI,IP,001,14,14775,15047,6099,272,PERF
42177325560000,PI,IP,001,15,15125,15397,6099,272,PERF
42177325560000,PI,IP,001,16,15475,15747,6099,272,PERF
42177325560000,PI,IP,001,17,15827,16097,6099,270,PERF
42177325570000,PI,IP,001,1,11923,15260,4268,3337,PERF
42177325580000,PI,IP,001,1,11615,14800,4116,3185,PERF
42177325590000,PI,IP,001,1,11668,14665,3379,2997,PERF
42177325600000,PI,IP,001,1,13098,18585,6571,5487,PERF
42177325610000,PI,IP,001,1,12200,15858,4426,3658,PERF
42177325620000,PI,IP,001,1,12068,16695,5340,4627,PERF
42177325630000,PI,IP,001,1,11873,16988,5808,5115,PERF
42177325640000,PI,IP,001,1,11150,16364,5454,5214,PERF
42177325650000,PI,IP,001,1,11100,16318,5439,5218,PERF
42177325660000,PI,IP,001,1,11550,16615,5697,5065,PERF
42177325670000,PI,IP,001,1,11150,14717,5386,3567,PERF
42177325690000,PI,IP,001,1,10990,16116,5876,5126,PERF
42177325700000,PI,IP,001,1,13266,16280,5912,3014,PERF
42177325740000,PI,IP,001,1,9570,14653,6025,5083,PERF
42177325750000,PI,IP,001,1,9886,14879,5447,4993,PERF
42177325790000,PI,IP,001,1,11480,15933,4756,4453,PERF
42177325800000,PI,IP,001,1,11700,14700,3613,3000,PERF
42177325810000,PI,IP,001,1,11764,15084,4092,3320,PERF
42177325820000,PI,IP,001,1,11700,15820,4384,4120,PERF
42177325830000,PI,IP,001,1,11993,15672,4427,3679,PERF
42177325890000,PI,IP,001,1,12549,16692,5171,4143,PERF
42177325900000,PI,IP,001,1,7211,7378,6467,167,PERF
42177325900000,PI,IP,001,2,7431,7592,6467,161,PERF
42177325900000,PI,IP,001,3,7651,7818,6467,167,PERF
42177325900000,PI,IP,001,4,7871,8038,6467,167,PERF
42177325900000,PI,IP,001,5,8091,8258,6467,167,PERF
42177325900000,PI,IP,001,6,8311,8478,6467,167,PERF
42177325900000,PI,IP,001,7,8531,8698,6467,167,PERF
42177325900000,PI,IP,001,8,8751,8918,6467,167,PERF
42177325900000,PI,IP,001,9,8971,9138,6467,167,PERF
42177325900000,PI,IP,001,10,9191,9358,6467,167,PERF
42177325900000,PI,IP,001,11,9411,9578,6467,167,PERF
42177325900000,PI,IP,001,12,9631,9798,6467,167,PERF
42177325900000,PI,IP,001,13,9851,10018,6467,167,PERF
42177325900000,PI,IP,001,14,10071,10238,6467,167,PERF
42177325900000,PI,IP,001,15,10291,10458,6467,167,PERF
42177325900000,PI,IP,001,16,10511,10678,6467,167,PERF
42177325900000,PI,IP,001,17,10731,10898,6467,167,PERF
42177325900000,PI,IP,001,18,10951,11118,6467,167,PERF
42177325900000,PI,IP,001,19,11171,11338,6467,167,PERF
42177325900000,PI,IP,001,20,11391,11558,6467,167,PERF
42177325900000,PI,IP,001,21,11611,11778,6467,167,PERF
42177325900000,PI,IP,001,22,11826,11998,6467,172,PERF
42177325900000,PI,IP,001,23,12053,12216,6467,163,PERF
42177325900000,PI,IP,001,24,12271,12438,6467,167,PERF
42177325900000,PI,IP,001,25,12491,12658,6467,167,PERF
42177325900000,PI,IP,001,26,12711,12878,6467,167,PERF
42177325920000,PI,IP,001,1,6867,7034,5761,167,PERF
42177325920000,PI,IP,001,2,7087,7254,5761,167,PERF
42177325920000,PI,IP,001,3,7306,7474,5761,168,PERF
42177325920000,PI,IP,001,4,7526,7691,5761,165,PERF
42177325920000,PI,IP,001,5,7745,7909,5761,164,PERF
42177325920000,PI,IP,001,6,7965,8127,5761,162,PERF
42177325920000,PI,IP,001,7,8184,8347,5761,163,PERF
42177325920000,PI,IP,001,8,8404,8572,5761,168,PERF
42177325920000,PI,IP,001,9,8623,8790,5761,167,PERF
42177325920000,PI,IP,001,10,8843,9010,5761,167,PERF
42177325920000,PI,IP,001,11,9062,9229,5761,167,PERF
42177325920000,PI,IP,001,12,9282,9449,5761,167,PERF
42177325920000,PI,IP,001,13,9501,9668,5761,167,PERF
42177325920000,PI,IP,001,14,9721,9888,5761,167,PERF
42177325920000,PI,IP,001,15,9940,10107,5761,167,PERF
42177325920000,PI,IP,001,16,10160,10327,5761,167,PERF
42177325920000,PI,IP,001,17,10379,10546,5761,167,PERF
42177325920000,PI,IP,001,18,10599,10766,5761,167,PERF
42177325920000,PI,IP,001,19,10818,10985,5761,167,PERF
42177325920000,PI,IP,001,20,11038,11205,5761,167,PERF
42177325920000,PI,IP,001,21,11257,11424,5761,167,PERF
42177325920000,PI,IP,001,22,11477,11644,5761,167,PERF
42177325920000,PI,IP,001,23,11696,11863,5761,167,PERF
42177325930000,PI,IP,001,1,7248,7415,6030,167,PERF
42177325930000,PI,IP,001,2,7468,7635,6030,167,PERF
42177325930000,PI,IP,001,3,7690,7855,6030,165,PERF
42177325930000,PI,IP,001,4,7910,8075,6030,165,PERF
42177325930000,PI,IP,001,5,8130,8295,6030,165,PERF
42177325930000,PI,IP,001,6,8351,8515,6030,164,PERF
42177325930000,PI,IP,001,7,8564,8735,6030,171,PERF
42177325930000,PI,IP,001,8,8792,8955,6030,163,PERF
42177325930000,PI,IP,001,9,9003,9175,6030,172,PERF
42177325930000,PI,IP,001,10,9225,9395,6030,170,PERF
42177325930000,PI,IP,001,11,9443,9600,6030,157,PERF
42177325930000,PI,IP,001,12,9668,9835,6030,167,PERF
42177325930000,PI,IP,001,13,9888,10055,6030,167,PERF
42177325930000,PI,IP,001,14,10108,10275,6030,167,PERF
42177325930000,PI,IP,001,15,10328,10495,6030,167,PERF
42177325930000,PI,IP,001,16,10546,10715,6030,169,PERF
42177325930000,PI,IP,001,17,10768,10935,6030,167,PERF
42177325930000,PI,IP,001,18,11141,11190,6030,49,PERF
42177325930000,PI,IP,001,19,11208,11375,6030,167,PERF
42177325930000,PI,IP,001,20,11428,11595,6030,167,PERF
42177325930000,PI,IP,001,21,11648,11814,6030,166,PERF
42177325930000,PI,IP,001,22,11868,12035,6030,167,PERF
42177325930000,PI,IP,001,23,12088,12200,6030,112,PERF
42177325930000,PI,IP,001,24,12308,12475,6030,167,PERF
42177325950000,PI,IP,001,1,11150,16831,5952,5681,PERF
42177325960000,PI,IP,001,1,11918,15909,4580,3991,PERF
42177325970000,PI,IP,001,1,7472,7639,6285,167,PERF
42177325970000,PI,IP,001,2,7692,7862,6285,170,PERF
42177325970000,PI,IP,001,3,7912,8079,6285,167,PERF
42177325970000,PI,IP,001,4,8132,8299,6285,167,PERF
42177325970000,PI,IP,001,5,8350,8519,6285,169,PERF
42177325970000,PI,IP,001,6,8572,8739,6285,167,PERF
42177325970000,PI,IP,001,7,8792,8959,6285,167,PERF
42177325970000,PI,IP,001,8,9012,9179,6285,167,PERF
42177325970000,PI,IP,001,9,9232,9399,6285,167,PERF
42177325970000,PI,IP,001,10,9452,9616,6285,164,PERF
42177325970000,PI,IP,001,11,9672,9839,6285,167,PERF
42177325970000,PI,IP,001,12,9894,10059,6285,165,PERF
42177325970000,PI,IP,001,13,10112,10279,6285,167,PERF
42177325970000,PI,IP,001,14,10332,10499,6285,167,PERF
42177325970000,PI,IP,001,15,10552,10719,6285,167,PERF
42177325970000,PI,IP,001,16,10772,10939,6285,167,PERF
42177325970000,PI,IP,001,17,10992,11159,6285,167,PERF
42177325970000,PI,IP,001,18,11212,11379,6285,167,PERF
42177325970000,PI,IP,001,19,11432,11600,6285,168,PERF
42177325970000,PI,IP,001,20,11652,11818,6285,166,PERF
42177325970000,PI,IP,001,21,11872,12042,6285,170,PERF
42177325970000,PI,IP,001,22,12092,12259,6285,167,PERF
42177325970000,PI,IP,001,23,12312,12479,6285,167,PERF
42177325970000,PI,IP,001,24,12532,12699,6285,167,PERF
42177325970000,PI,IP,001,25,12752,12919,6285,167,PERF
42177326000000,PI,IP,001,1,11814,15390,4511,3576,PERF
42177326010000,PI,IP,001,1,7195,7357,5570,162,PERF
42177326010000,PI,IP,001,2,7408,7570,5570,162,PERF
42177326010000,PI,IP,001,3,7621,7783,5570,162,PERF
42177326010000,PI,IP,001,4,7834,7993,5570,159,PERF
42177326010000,PI,IP,001,5,8047,8209,5570,162,PERF
42177326010000,PI,IP,001,6,8258,8422,5570,164,PERF
42177326010000,PI,IP,001,7,8473,8635,5570,162,PERF
42177326010000,PI,IP,001,8,8686,8848,5570,162,PERF
42177326010000,PI,IP,001,9,8899,9058,5570,159,PERF
42177326010000,PI,IP,001,10,9112,9274,5570,162,PERF
42177326010000,PI,IP,001,11,9321,9487,5570,166,PERF
42177326010000,PI,IP,001,12,9538,9700,5570,162,PERF
42177326010000,PI,IP,001,13,9751,9913,5570,162,PERF
42177326010000,PI,IP,001,14,10017,10128,5570,111,PERF
42177326010000,PI,IP,001,15,10177,10339,5570,162,PERF
42177326010000,PI,IP,001,16,10392,10552,5570,160,PERF
42177326010000,PI,IP,001,17,10603,10765,5570,162,PERF
42177326010000,PI,IP,001,18,10816,10978,5570,162,PERF
42177326010000,PI,IP,001,19,11029,11191,5570,162,PERF
42177326010000,PI,IP,001,20,11242,11404,5570,162,PERF
42177326010000,PI,IP,001,21,11455,11617,5570,162,PERF
42177326010000,PI,IP,001,22,11668,11830,5570,162,PERF
42177326010000,PI,IP,001,23,11881,12050,5570,169,PERF
42177326030000,PI,IP,001,1,10795,15537,5292,4742,PERF
42177326040000,PI,IP,001,1,11726,15392,4364,3666,PERF
42177326050000,PI,IP,001,1,11718,15255,4369,3537,PERF
42177326060000,PI,IP,001,1,11816,18806,7466,6990,PERF
42177326070000,PI,IP,001,1,11868,16203,4817,4335,PERF
42177326090000,PI,IP,001,1,11306,15397,4685,4091,PERF
42177326100000,PI,IP,001,1,11841,17472,6311,5631,PERF
42177326110000,PI,IP,001,1,11871,18114,7204,6243,PERF
42177326120000,PI,IP,001,1,9370,12896,,3526,PERF
42177326130000,PI,IP,001,1,9900,18228,9299,8328,PERF
42177326160000,PI,IP,001,1,12044,16066,4504,4022,PERF
42177326170000,PI,IP,001,1,10948,15059,2536,4111,PERF
42177326210000,PI,IP,001,1,12273,19349,8062,7076,PERF
42177326220000,PI,IP,001,1,12852,19046,7757,6194,PERF
42177326230000,PI,IP,001,1,11635,16107,5316,4472,PERF
42177326240000,PI,IP,001,1,11718,17883,6741,6165,PERF
42177326250000,PI,IP,001,1,9728,9885,5741,157,PERF
42177326250000,PI,IP,001,2,9939,10102,5741,163,PERF
42177326250000,PI,IP,001,3,10154,10313,5741,159,PERF
42177326250000,PI,IP,001,4,10369,10532,5741,163,PERF
42177326250000,PI,IP,001,5,10584,10747,5741,163,PERF
42177326250000,PI,IP,001,6,10803,10959,5741,156,PERF
42177326250000,PI,IP,001,7,11014,11175,5741,161,PERF
42177326250000,PI,IP,001,8,11229,11387,5741,158,PERF
42177326250000,PI,IP,001,9,11444,11605,5741,161,PERF
42177326250000,PI,IP,001,10,11659,11820,5741,161,PERF
42177326250000,PI,IP,001,11,11876,12032,5741,156,PERF
42177326250000,PI,IP,001,12,12089,12252,5741,163,PERF
42177326250000,PI,IP,001,13,12304,12462,5741,158,PERF
42177326250000,PI,IP,001,14,12519,12682,5741,163,PERF
42177326250000,PI,IP,001,15,12734,12897,5741,163,PERF
42177326250000,PI,IP,001,16,12949,13107,5741,158,PERF
42177326250000,PI,IP,001,17,13164,13327,5741,163,PERF
42177326250000,PI,IP,001,18,13379,13542,5741,163,PERF
42177326250000,PI,IP,001,19,13594,13757,5741,163,PERF
42177326250000,PI,IP,001,20,13809,13972,5741,163,PERF
42177326260001,PI,IP,001,1,9540,9546,,6,PERF
42177326260001,PI,PT,001,1,9654,14557,,4903,PERF
42177326290000,PI,IP,001,1,8119,8273,6094,154,PERF
42177326290000,PI,IP,001,2,8273,8560,6094,287,PERF
42177326290000,PI,IP,001,3,8778,8945,6094,167,PERF
42177326290000,PI,IP,001,4,8997,9164,6094,167,PERF
42177326290000,PI,IP,001,5,9217,9384,6094,167,PERF
42177326290000,PI,IP,001,6,9436,9603,6094,167,PERF
42177326290000,PI,IP,001,7,9656,9823,6094,167,PERF
42177326290000,PI,IP,001,8,9875,10042,6094,167,PERF
42177326290000,PI,IP,001,9,10095,10262,6094,167,PERF
42177326290000,PI,IP,001,10,10314,10481,6094,167,PERF
42177326290000,PI,IP,001,11,10536,10701,6094,165,PERF
42177326290000,PI,IP,001,12,10753,10920,6094,167,PERF
42177326290000,PI,IP,001,13,10973,11140,6094,167,PERF
42177326290000,PI,IP,001,14,11192,11361,6094,169,PERF
42177326290000,PI,IP,001,15,11412,11576,6094,164,PERF
42177326290000,PI,IP,001,16,11631,11796,6094,165,PERF
42177326290000,PI,IP,001,17,11851,12018,6094,167,PERF
42177326290000,PI,IP,001,18,12070,12237,6094,167,PERF
42177326290000,PI,IP,001,19,12290,12457,6094,167,PERF
42177326290000,PI,IP,001,20,12512,12676,6094,164,PERF
42177326290000,PI,IP,001,21,12722,12896,6094,174,PERF
42177326290000,PI,IP,001,22,12948,13115,6094,167,PERF
42177326300000,PI,IP,001,1,11691,15549,4436,3858,PERF
42177326310000,PI,IP,001,1,9997,13861,4653,3864,PERF
42177326330000,PI,IP,001,1,11991,16624,5072,4633,PERF
42177326340000,PI,IP,001,1,12138,15939,4404,3801,PERF
42177326350000,PI,IP,001,1,12026,16045,4341,4019,PERF
42177326360100,PI,IP,001,1,12018,16528,5503,4510,PERF
42177326380000,PI,IP,001,1,12198,16330,5163,4132,PERF
42177326390000,PI,IP,001,1,11671,15187,3963,3516,PERF
42177326400000,PI,IP,001,1,12250,12460,6281,210,PERF
42177326400000,PI,IP,001,2,12530,12739,6281,209,PERF
42177326400000,PI,IP,001,3,12808,13017,6281,209,PERF
42177326400000,PI,IP,001,4,13089,13296,6281,207,PERF
42177326400000,PI,IP,001,5,13366,13575,6281,209,PERF
42177326400000,PI,IP,001,6,13677,13876,6281,199,PERF
42177326400000,PI,IP,001,7,13942,14138,6281,196,PERF
42177326400000,PI,IP,001,8,14240,14478,6281,238,PERF
42177326400000,PI,IP,001,9,14549,14779,6281,230,PERF
42177326400000,PI,IP,001,10,14858,15085,6281,227,PERF
42177326400000,PI,IP,001,11,15164,15391,6281,227,PERF
42177326400000,PI,IP,001,12,15467,15697,6281,230,PERF
42177326400000,PI,IP,001,13,15773,15998,6281,225,PERF
42177326400000,PI,IP,001,14,16339,16617,6281,278,PERF
42177326410000,PI,IP,001,1,11677,15117,3910,3440,PERF
42177326450000,PI,IP,001,1,7630,7797,5960,167,PERF
42177326450000,PI,IP,001,2,7850,8017,5960,167,PERF
42177326450000,PI,IP,001,3,8069,8236,5960,167,PERF
42177326450000,PI,IP,001,4,8289,8456,5960,167,PERF
42177326450000,PI,IP,001,5,8508,8675,5960,167,PERF
42177326450000,PI,IP,001,6,8728,8747,5960,19,PERF
42177326450000,PI,IP,001,7,8895,9114,5960,219,PERF
42177326450000,PI,IP,001,8,9167,9334,5960,167,PERF
42177326450000,PI,IP,001,9,9386,9554,5960,168,PERF
42177326450000,PI,IP,001,10,9606,9776,5960,170,PERF
42177326450000,PI,IP,001,11,9825,9990,5960,165,PERF
42177326450000,PI,IP,001,12,10045,10212,5960,167,PERF
42177326450000,PI,IP,001,13,10264,10431,5960,167,PERF
42177326450000,PI,IP,001,14,10484,10651,5960,167,PERF
42177326450000,PI,IP,001,15,10706,10780,5960,74,PERF
42177326450000,PI,IP,001,16,10921,11090,5960,169,PERF
42177326450000,PI,IP,001,17,11142,11309,5960,167,PERF
42177326450000,PI,IP,001,18,11362,11529,5960,167,PERF
42177326450000,PI,IP,001,19,11581,11748,5960,167,PERF
42177326450000,PI,IP,001,20,11801,11968,5960,167,PERF
42177326450000,PI,IP,001,21,12020,12187,5960,167,PERF
42177326450000,PI,IP,001,22,12240,12407,5960,167,PERF
42177326450000,PI,IP,001,23,12549,12626,5960,77,PERF
42177326560000,PI,IP,001,1,9913,14450,4948,4537,PERF
42177326570000,PI,IP,001,1,10545,14998,5063,4453,PERF
42177326650000,PI,IP,001,1,12148,15621,4426,3473,PERF
42177326660000,PI,IP,001,1,11690,16738,5533,5048,PERF
42177326670000,PI,IP,001,1,10222,14481,5305,4259,PERF
42177326710000,PI,IP,001,1,11793,16811,5519,5018,PERF
42177326750000,PI,IP,001,1,9405,14115,6252,4710,PERF
42177326760000,PI,IP,001,1,10135,15872,6424,5737,PERF
42177326770000,PI,IP,001,1,8771,8925,5629,154,PERF
42177326770000,PI,IP,001,2,8973,9125,5629,152,PERF
42177326770000,PI,IP,001,3,9173,9325,5629,152,PERF
42177326770000,PI,IP,001,4,9373,9525,5629,152,PERF
42177326770000,PI,IP,001,5,9773,9925,5629,152,PERF
42177326770000,PI,IP,001,6,9973,10125,5629,152,PERF
42177326770000,PI,IP,001,7,10173,10325,5629,152,PERF
42177326770000,PI,IP,001,8,10373,10525,5629,152,PERF
42177326770000,PI,IP,001,9,10573,10725,5629,152,PERF
42177326770000,PI,IP,001,10,10773,10925,5629,152,PERF
42177326770000,PI,IP,001,11,10973,11122,5629,149,PERF
42177326770000,PI,IP,001,12,11173,11325,5629,152,PERF
42177326770000,PI,IP,001,13,11373,11525,5629,152,PERF
42177326770000,PI,IP,001,14,11573,11723,5629,150,PERF
42177326770000,PI,IP,001,15,11773,11925,5629,152,PERF
42177326770000,PI,IP,001,16,11973,12075,5629,102,PERF
42177326780000,PI,IP,001,1,9927,15704,6112,5777,PERF
42177326870000,PI,IP,001,1,9882,15697,6088,5815,PERF
42177326880000,PI,IP,001,1,11927,16554,5097,4627,PERF
42177326890000,PI,IP,001,1,8905,14511,6301,5606,PERF
42177326900000,PI,IP,001,1,11514,16363,5134,4849,PERF
42177326910000,PI,IP,001,1,11927,16074,4422,4147,PERF
42177326920000,PI,IP,001,1,11923,16655,5137,4732,PERF
42177326930000,PI,IP,001,1,11735,16437,5328,4702,PERF
42177326940000,PI,IP,001,1,11717,18914,7708,7197,PERF
42177326960000,PI,IP,001,1,11517,16742,5537,5225,PERF
42177326980000,PI,IP,001,1,9971,17158,8013,7187,PERF
42177327020000,PI,IP,001,1,11950,15821,4651,3871,PERF
42177327030000,PI,IP,001,1,11765,16083,,4318,PERF
42177327040000,PI,IP,001,1,10092,16109,6748,6017,PERF
42177327100000,PI,IP,001,1,9930,16109,6627,6179,PERF
42177327110000,PI,IP,001,1,11967,18459,7280,6492,PERF
42177327120000,PI,IP,001,1,12070,15560,4007,3490,PERF
42177327130100,PI,IP,001,1,11932,15820,4405,3888,PERF
42177327140000,PI,IP,001,1,11867,16325,5762,4458,PERF
42177327150000,PI,IP,001,1,9984,15338,,5354,PERF
42177327160000,PI,IP,001,1,9962,15127,5185,5165,PERF
42177327170000,PI,IP,001,1,9950,15282,5801,5332,PERF
42177327180000,PI,IP,001,1,10700,17018,6566,6318,PERF
42177327190000,PI,IP,001,1,10989,17153,6883,6164,PERF
42177327200000,PI,IP,001,1,11570,15719,4365,4149,PERF
42177327210000,PI,IP,001,1,11906,16716,5512,4810,PERF
42177327220000,PI,IP,001,1,11687,16716,5500,5029,PERF
42177327230000,PI,IP,001,1,11297,16900,6307,5603,PERF
42177327250000,PI,IP,001,1,10791,14302,3634,3511,PERF
42177327260000,PI,IP,001,1,10785,15660,5259,4875,PERF
42177327270000,PI,IP,001,1,10982,13531,3162,2549,PERF
42177327280000,PI,IP,001,1,10102,15917,6158,5815,PERF
42177327320000,PI,IP,001,1,11604,16925,,5321,PERF
42177327340000,PI,IP,001,1,9907,15769,6448,5862,PERF
42177327350000,PI,IP,001,1,12180,15201,3487,3021,PERF
42177327360000,PI,IP,001,1,12087,15376,3564,3289,PERF
42177327370000,PI,IP,001,1,12112,15379,3670,3267,PERF
42177327380100,PI,PT,001,1,11402,17262,,5860,PERF
42177327390000,PI,IP,001,1,9640,14822,5986,5182,PERF
42177327400000,PI,IP,001,1,9300,14017,5087,4717,PERF
42177327430000,PI,IP,001,1,12197,16812,5579,4615,PERF
42177327440000,PI,IP,001,1,11759,16968,5721,5209,PERF
42177327470000,PI,IP,001,1,11875,15856,4511,3981,PERF
42177327480000,PI,IP,001,1,10911,15061,5386,4150,PERF
42177327490000,PI,IP,001,1,9755,15092,6172,5337,PERF
42177327540000,PI,IP,001,1,11535,15810,4515,4275,PERF
42177327550000,PI,IP,001,1,11542,15760,4363,4218,PERF
42177327560000,PI,IP,001,1,11660,15791,4645,4131,PERF
42177327620000,PI,IP,001,1,10266,13968,4512,3702,PERF
42185308030000,PI,IP,001,1,10995,16187,6540,5192,PERF
42255001790001,PI,IP,001,1,10269,10365,,96,PERF
42255315930000,PI,IP,001,1,13419,16500,3533,3081,PERF
42255316080000,PI,IP,001,1,11056,12870,3188,1814,PERF
42255316120000,PI,IP,001,1,10830,13325,4465,2495,PERF
42255316160000,PI,IP,001,1,12400,12660,6367,260,PERF
42255316160000,PI,IP,001,2,12719,12979,6367,260,PERF
42255316160000,PI,IP,001,3,13038,13298,6367,260,PERF
42255316160000,PI,IP,001,4,13357,13617,6367,260,PERF
42255316160000,PI,IP,001,5,13676,13936,6367,260,PERF
42255316160000,PI,IP,001,6,13995,14255,6367,260,PERF
42255316160000,PI,IP,001,7,14314,14574,6367,260,PERF
42255316160000,PI,IP,001,8,14633,14893,6367,260,PERF
42255316160000,PI,IP,001,9,14952,15212,6367,260,PERF
42255316160000,PI,IP,001,10,15271,15531,6367,260,PERF
42255316160000,PI,IP,001,11,15590,15850,6367,260,PERF
42255316160000,PI,IP,001,12,15909,16169,6367,260,PERF
42255316160000,PI,IP,001,13,16228,16488,6367,260,PERF
42255316160000,PI,IP,001,14,16547,16807,6367,260,PERF
42255316160000,PI,IP,001,15,16866,17126,6367,260,PERF
42255316180000,PI,IP,001,1,10806,10812,3261,6,PERF
42255316180000,PI,IP,001,2,10990,10996,3261,6,PERF
42255316180000,PI,IP,001,3,11160,11166,3261,6,PERF
42255316180000,PI,IP,001,4,11326,11332,3261,6,PERF
42255316180000,PI,IP,001,5,11373,11379,3261,6,PERF
42255316180000,PI,IP,001,6,11516,11522,3261,6,PERF
42255316180000,PI,IP,001,7,11659,11665,3261,6,PERF
42255316180000,PI,IP,001,8,11704,11710,3261,6,PERF
42255316180000,PI,IP,001,9,11850,11856,3261,6,PERF
42255316180000,PI,IP,001,10,11990,11996,3261,6,PERF
42255316180000,PI,IP,001,11,12150,12156,3261,6,PERF
42255316180000,PI,IP,001,12,12296,12302,3261,6,PERF
42255316180000,PI,IP,001,13,12450,12456,3261,6,PERF
42255316180000,PI,IP,001,14,12594,12600,3261,6,PERF
42255316180000,PI,IP,001,15,12750,12756,3261,6,PERF
42255316180000,PI,IP,001,16,12900,12906,3261,6,PERF
42255316180000,PI,IP,001,17,13085,13091,3261,6,PERF
42255316180000,PI,IP,001,18,13200,13203,3261,3,PERF
42255316200000,PI,IP,001,1,10820,10826,2247,6,PERF
42255316200000,PI,IP,001,2,10970,10976,2247,6,PERF
42255316200000,PI,IP,001,3,11120,11126,2247,6,PERF
42255316200000,PI,IP,001,4,11270,11276,2247,6,PERF
42255316200000,PI,IP,001,5,11420,11426,2247,6,PERF
42255316200000,PI,IP,001,6,11560,11566,2247,6,PERF
42255316200000,PI,IP,001,7,11720,11726,2247,6,PERF
42255316200000,PI,IP,001,8,11870,11873,2247,3,PERF
42255316200000,PI,IP,001,9,11886,11892,2247,6,PERF
42255316220000,PI,IP,001,1,13639,15850,2707,2211,PERF
42255316290000,PI,IP,001,1,10864,10870,2336,6,PERF
42255316290000,PI,IP,001,2,11024,11030,2336,6,PERF
42255316290000,PI,IP,001,3,11166,11172,2336,6,PERF
42255316290000,PI,IP,001,4,11320,11326,2336,6,PERF
42255316290000,PI,IP,001,5,11460,11466,2336,6,PERF
42255316290000,PI,IP,001,6,11620,11626,2336,6,PERF
42255316290000,PI,IP,001,7,11740,11746,2336,6,PERF
42255316290000,PI,IP,001,8,11920,11926,2336,6,PERF
42255316290000,PI,IP,001,9,12054,12060,2336,6,PERF
42255316290000,PI,IP,001,10,12210,12216,2336,6,PERF
42255316290000,PI,IP,001,11,12373,12379,2336,6,PERF
42255316330000,PI,IP,001,1,10575,13828,3617,3253,PERF
42255316340000,PI,IP,001,1,10650,10656,,6,PERF
42255316340000,PI,IP,001,2,10853,10859,,6,PERF
42255316340000,PI,IP,001,3,11038,11044,,6,PERF
42255316340000,PI,IP,001,4,11240,11246,,6,PERF
42255316340000,PI,IP,001,5,11440,11446,,6,PERF
42255316340000,PI,IP,001,6,11646,11652,,6,PERF
42255316340000,PI,IP,001,7,11848,11854,,6,PERF
42255316340000,PI,IP,001,8,12050,12056,,6,PERF
42255316340000,PI,IP,001,9,12250,12256,,6,PERF
42255316340000,PI,IP,001,10,12450,12456,,6,PERF
42255316340000,PI,IP,001,11,12650,12656,,6,PERF
42255316340000,PI,IP,001,12,12767,12773,,6,PERF
42255316340000,PI,IP,001,13,12817,12825,,8,PERF
42255316350100,PI,IP,001,1,13513,17860,5396,4347,PERF
42255316370000,PI,IP,001,1,11005,11011,2804,6,PERF
42255316370000,PI,IP,001,2,11125,11131,2804,6,PERF
42255316370000,PI,IP,001,3,11244,11250,2804,6,PERF
42255316370000,PI,IP,001,4,11388,11394,2804,6,PERF
42255316370000,PI,IP,001,5,11560,11566,2804,6,PERF
42255316370000,PI,IP,001,6,11700,11706,2804,6,PERF
42255316370000,PI,IP,001,7,11850,11856,2804,6,PERF
42255316370000,PI,IP,001,8,11990,11996,2804,6,PERF
42255316370000,PI,IP,001,9,12150,12156,2804,6,PERF
42255316370000,PI,IP,001,10,12300,12306,2804,6,PERF
42255316370000,PI,IP,001,11,12450,12456,2804,6,PERF
42255316370000,PI,IP,001,12,12590,12596,2804,6,PERF
42255316370000,PI,IP,001,13,12750,12756,2804,6,PERF
42255316380000,PI,IP,001,1,10900,10906,3345,6,PERF
42255316380000,PI,IP,001,2,11050,11056,3345,6,PERF
42255316380000,PI,IP,001,3,11200,11206,3345,6,PERF
42255316380000,PI,IP,001,4,11350,11356,3345,6,PERF
42255316380000,PI,IP,001,5,11500,11506,3345,6,PERF
42255316380000,PI,IP,001,6,11650,11656,3345,6,PERF
42255316380000,PI,IP,001,7,11800,11806,3345,6,PERF
42255316380000,PI,IP,001,8,11935,11941,3345,6,PERF
42255316380000,PI,IP,001,9,12100,12106,3345,6,PERF
42255316380000,PI,IP,001,10,12250,12256,3345,6,PERF
42255316380000,PI,IP,001,11,12400,12406,3345,6,PERF
42255316380000,PI,IP,001,12,12550,12556,3345,6,PERF
42255316380000,PI,IP,001,13,12700,12706,3345,6,PERF
42255316380000,PI,IP,001,14,12850,12856,3345,6,PERF
42255316380000,PI,IP,001,15,13018,13024,3345,6,PERF
42255316380000,PI,IP,001,16,13150,13156,3345,6,PERF
42255316380000,PI,IP,001,17,13250,13256,3345,6,PERF
42255316380000,PI,IP,001,18,13301,13307,3345,6,PERF
42255316410000,PI,IP,001,1,10810,10813,4896,3,PERF
42255316410000,PI,IP,001,2,10974,10977,4896,3,PERF
42255316410000,PI,IP,001,3,11230,11233,4896,3,PERF
42255316410000,PI,IP,001,4,11422,11425,4896,3,PERF
42255316410000,PI,IP,001,5,11490,11496,4896,6,PERF
42255316410000,PI,IP,001,6,11622,11625,4896,3,PERF
42255316410000,PI,IP,001,7,11822,11825,4896,3,PERF
42255316410000,PI,IP,001,8,12010,12013,4896,3,PERF
42255316410000,PI,IP,001,9,12222,12225,4896,3,PERF
42255316410000,PI,IP,001,10,12342,12345,4896,3,PERF
42255316410000,PI,IP,001,11,12422,12428,4896,6,PERF
42255316410000,PI,IP,001,12,12622,12625,4896,3,PERF
42255316410000,PI,IP,001,13,12822,12825,4896,3,PERF
42255316410000,PI,IP,001,14,13022,13025,4896,3,PERF
42255316410000,PI,IP,001,15,13232,13535,4896,303,PERF
42255316410000,PI,IP,001,16,13422,13425,4896,3,PERF
42255316410000,PI,IP,001,17,13622,13625,4896,3,PERF
42255316410000,PI,IP,001,18,13900,13903,4896,3,PERF
42255316410000,PI,IP,001,19,14022,14025,4896,3,PERF
42255316410000,PI,IP,001,20,14412,14415,4896,3,PERF
42255316410000,PI,IP,001,21,14632,14635,4896,3,PERF
42255316410000,PI,IP,001,22,14822,14825,4896,3,PERF
42255316410000,PI,IP,001,23,15022,15025,4896,3,PERF
42255316410000,PI,IP,001,24,15216,15219,4896,3,PERF
42255316450000,PI,IP,002,1,13223,17350,4533,4127,PERF
42255316450000,PI,PT,001,1,13223,17350,4533,4127,PERF
42255316460000,PI,IP,001,1,10949,10952,5138,3,PERF
42255316460000,PI,IP,001,2,11209,11212,5138,3,PERF
42255316460000,PI,IP,001,3,11542,11545,5138,3,PERF
42255316460000,PI,IP,001,4,11863,11866,5138,3,PERF
42255316460000,PI,IP,001,5,12161,12164,5138,3,PERF
42255316460000,PI,IP,001,6,12406,12412,5138,6,PERF
42255316460000,PI,IP,001,7,12602,12605,5138,3,PERF
42255316460000,PI,IP,001,8,12828,12834,5138,6,PERF
42255316460000,PI,IP,001,9,13009,13015,5138,6,PERF
42255316460000,PI,IP,001,10,13136,13139,5138,3,PERF
42255316460000,PI,IP,001,11,13456,13462,5138,6,PERF
42255316460000,PI,IP,001,12,13770,13773,5138,3,PERF
42255316460000,PI,IP,001,13,14070,14076,5138,6,PERF
42255316460000,PI,IP,001,14,14350,14353,5138,3,PERF
42255316460000,PI,IP,001,15,14648,14654,5138,6,PERF
42255316460000,PI,IP,001,16,14897,14900,5138,3,PERF
42255316460000,PI,IP,001,17,15172,15178,5138,6,PERF
42255316460000,PI,IP,001,18,15462,15465,5138,3,PERF
42255316460000,PI,IP,001,19,15713,15716,5138,3,PERF
42255316490000,PI,IP,001,1,11108,11111,4855,3,PERF
42255316490000,PI,IP,001,2,11400,11403,4855,3,
42255316490000,PI,IP,001,3,11539,11542,4855,3,
42255316490000,PI,IP,001,4,11700,11703,4855,3,
42255316490000,PI,IP,001,5,11854,11857,4855,3,
42255316490000,PI,IP,001,6,11992,11995,4855,3,
42255316490000,PI,IP,001,7,12151,12154,4855,3,
42255316490000,PI,IP,001,8,12303,12303,4855,0,
42255316490000,PI,IP,001,9,12436,12439,4855,3,
42255316490000,PI,IP,001,10,12583,12586,4855,3,
42255316490000,PI,IP,001,11,12754,12757,4855,3,
42255316490000,PI,IP,001,12,12896,12896,4855,0,
42255316490000,PI,IP,001,13,13044,13047,4855,3,
42255316490000,PI,IP,001,14,13200,13203,4855,3,
42255316490000,PI,IP,001,15,13346,13349,4855,3,
42255316490000,PI,IP,001,16,13500,13503,4855,3,
42255316490000,PI,IP,001,17,13644,13647,4855,3,
42255316490000,PI,IP,001,18,13810,13813,4855,3,
42255316490000,PI,IP,001,19,13950,13953,4855,3,
42255316490000,PI,IP,001,20,14106,14109,4855,3,
42255316490000,PI,IP,001,21,14220,14223,4855,3,
42255316490000,PI,IP,001,22,14640,14643,4855,3,
42255316490000,PI,IP,001,23,14790,14793,4855,3,
42255316490000,PI,IP,001,24,14952,14955,4855,3,
42255316490000,PI,IP,001,25,15090,15093,4855,3,
42255316490000,PI,IP,001,26,15240,15243,4855,3,
42255316490000,PI,IP,001,27,15390,15393,4855,3,
42255316490000,PI,IP,001,28,15622,15628,4855,6,
42255316500000,PI,IP,001,1,15995,18258,5018,2263,PERF
42255316510000,PI,IP,001,1,11638,11640,4966,2,PERF
42255316510000,PI,IP,001,2,11898,11900,4966,2,PERF
42255316510000,PI,IP,001,3,12158,12160,4966,2,PERF
42255316510000,PI,IP,001,4,12418,12420,4966,2,PERF
42255316510000,PI,IP,001,5,12484,12486,4966,2,PERF
42255316510000,PI,IP,001,6,12578,12580,4966,2,PERF
42255316510000,PI,IP,001,7,12673,12675,4966,2,PERF
42255316510000,PI,IP,001,8,12718,12720,4966,2,PERF
42255316510000,PI,IP,001,9,12770,12772,4966,2,PERF
42255316510000,PI,IP,001,10,12822,12824,4966,2,PERF
42255316510000,PI,IP,001,11,12867,12869,4966,2,PERF
42255316510000,PI,IP,001,12,12945,12947,4966,2,PERF
42255316510000,PI,IP,001,13,13023,13025,4966,2,PERF
42255316510000,PI,IP,001,14,13073,13075,4966,2,PERF
42255316510000,PI,IP,001,15,13148,13150,4966,2,PERF
42255316510000,PI,IP,001,16,13223,13225,4966,2,PERF
42255316510000,PI,IP,001,17,13273,13275,4966,2,PERF
42255316510000,PI,IP,001,18,13331,13333,4966,2,PERF
42255316510000,PI,IP,001,19,13390,13392,4966,2,PERF
42255316510000,PI,IP,001,20,13449,13451,4966,2,PERF
42255316510000,PI,IP,001,21,13498,13500,4966,2,PERF
42255316510000,PI,IP,001,22,13558,13560,4966,2,PERF
42255316510000,PI,IP,001,23,13618,13620,4966,2,PERF
42255316510000,PI,IP,001,24,13678,13680,4966,2,PERF
42255316510000,PI,IP,001,25,13729,13731,4966,2,PERF
42255316510000,PI,IP,001,26,13787,13789,4966,2,PERF
42255316510000,PI,IP,001,27,13845,13847,4966,2,PERF
42255316510000,PI,IP,001,28,13903,13905,4966,2,PERF
42255316510000,PI,IP,001,29,13953,13955,4966,2,PERF
42255316510000,PI,IP,001,30,14043,14045,4966,2,PERF
42255316510000,PI,IP,001,31,14133,14135,4966,2,PERF
42255316510000,PI,IP,001,32,14223,14225,4966,2,PERF
42255316510000,PI,IP,001,33,14273,14275,4966,2,PERF
42255316510000,PI,IP,001,34,14381,14383,4966,2,PERF
42255316510000,PI,IP,001,35,14489,14491,4966,2,PERF
42255316510000,PI,IP,001,36,14597,14599,4966,2,PERF
42255316510000,PI,IP,001,37,14648,14650,4966,2,PERF
42255316510000,PI,IP,001,38,14723,14725,4966,2,PERF
42255316510000,PI,IP,001,39,14798,14800,4966,2,PERF
42255316510000,PI,IP,001,40,14873,14875,4966,2,PERF
42255316510000,PI,IP,001,41,14930,14932,4966,2,PERF
42255316510000,PI,IP,001,42,15043,15045,4966,2,PERF
42255316510000,PI,IP,001,43,15156,15158,4966,2,PERF
42255316510000,PI,IP,001,44,15268,15270,4966,2,PERF
42255316520000,PI,IP,001,1,11105,15103,5439,3998,PERF
42255316530000,PI,IP,001,1,10830,10833,4949,3,PERF
42255316530000,PI,IP,001,2,10922,10925,4949,3,PERF
42255316530000,PI,IP,001,3,11022,11025,4949,3,PERF
42255316530000,PI,IP,001,4,11122,11125,4949,3,PERF
42255316530000,PI,IP,001,5,11227,11230,4949,3,PERF
42255316530000,PI,IP,001,6,11320,11323,4949,3,PERF
42255316530000,PI,IP,001,7,11427,11433,4949,6,PERF
42255316530000,PI,IP,001,8,11532,11535,4949,3,PERF
42255316530000,PI,IP,001,9,11632,11635,4949,3,PERF
42255316530000,PI,IP,001,10,11732,11738,4949,6,PERF
42255316530000,PI,IP,001,11,11837,11840,4949,3,PERF
42255316530000,PI,IP,001,12,11937,11940,4949,3,PERF
42255316530000,PI,IP,001,13,12037,12043,4949,6,PERF
42255316530000,PI,IP,001,14,12142,12145,4949,3,PERF
42255316530000,PI,IP,001,15,12230,12233,4949,3,PERF
42255316530000,PI,IP,001,16,12342,12348,4949,6,PERF
42255316530000,PI,IP,001,17,12447,12450,4949,3,PERF
42255316530000,PI,IP,001,18,12547,12550,4949,3,PERF
42255316530000,PI,IP,001,19,12647,12653,4949,6,PERF
42255316530000,PI,IP,001,20,12748,12751,4949,3,PERF
42255316530000,PI,IP,001,21,12856,12859,4949,3,PERF
42255316530000,PI,IP,001,22,12952,12958,4949,6,PERF
42255316530000,PI,IP,001,23,13057,13060,4949,3,PERF
42255316530000,PI,IP,001,24,13157,13160,4949,3,PERF
42255316530000,PI,IP,001,25,13250,13256,4949,6,PERF
42255316530000,PI,IP,001,26,13362,13365,4949,3,PERF
42255316530000,PI,IP,001,27,13462,13465,4949,3,PERF
42255316530000,PI,IP,001,28,13562,13568,4949,6,PERF
42255316530000,PI,IP,001,29,13670,13673,4949,3,PERF
42255316530000,PI,IP,001,30,13767,13770,4949,3,PERF
42255316530000,PI,IP,001,31,13867,13873,4949,6,PERF
42255316530000,PI,IP,001,32,13972,13975,4949,3,PERF
42255316530000,PI,IP,001,33,14075,14078,4949,3,PERF
42255316530000,PI,IP,001,34,14172,14178,4949,6,PERF
42255316530000,PI,IP,001,35,14277,14280,4949,3,PERF
42255316530000,PI,IP,001,36,14377,14380,4949,3,PERF
42255316530000,PI,IP,001,37,14465,14471,4949,6,PERF
42255316530000,PI,IP,001,38,14582,14585,4949,3,PERF
42255316530000,PI,IP,001,39,14682,14685,4949,3,PERF
42255316530000,PI,IP,001,40,14782,14788,4949,6,PERF
42255316560000,PI,IP,001,1,10759,10762,4975,3,PERF
42255316560000,PI,IP,001,2,10849,10852,4975,3,PERF
42255316560000,PI,IP,001,3,10939,10945,4975,6,PERF
42255316560000,PI,IP,001,4,11027,11034,4975,7,PERF
42255316560000,PI,IP,001,5,11124,11127,4975,3,PERF
42255316560000,PI,IP,001,6,11214,11220,4975,6,PERF
42255316560000,PI,IP,001,7,11309,11312,4975,3,PERF
42255316560000,PI,IP,001,8,11399,11402,4975,3,PERF
42255316560000,PI,IP,001,9,11489,11495,4975,6,PERF
42255316560000,PI,IP,001,10,11584,11587,4975,3,PERF
42255316560000,PI,IP,001,11,11674,11677,4975,3,PERF
42255316560000,PI,IP,001,12,11764,11770,4975,6,PERF
42255316560000,PI,IP,001,13,11857,11860,4975,3,PERF
42255316560000,PI,IP,001,14,11945,11948,4975,3,PERF
42255316560000,PI,IP,001,15,12034,12040,4975,6,PERF
42255316560000,PI,IP,001,16,12134,12137,4975,3,PERF
42255316560000,PI,IP,001,17,12224,12227,4975,3,PERF
42255316560000,PI,IP,001,18,12314,12320,4975,6,PERF
42255316560000,PI,IP,001,19,12409,12412,4975,3,PERF
42255316560000,PI,IP,001,20,12499,12502,4975,3,PERF
42255316560000,PI,IP,001,21,12589,12595,4975,6,PERF
42255316560000,PI,IP,001,22,12684,12687,4975,3,PERF
42255316560000,PI,IP,001,23,12774,12777,4975,3,PERF
42255316560000,PI,IP,001,24,12864,12870,4975,6,PERF
42255316560000,PI,IP,001,25,12959,12962,4975,3,PERF
42255316560000,PI,IP,001,26,13047,13050,4975,3,PERF
42255316560000,PI,IP,001,27,13144,13150,4975,6,PERF
42255316560000,PI,IP,001,28,13234,13237,4975,3,PERF
42255316560000,PI,IP,001,29,13324,13327,4975,3,PERF
42255316560000,PI,IP,001,30,13414,13420,4975,6,PERF
42255316560000,PI,IP,001,31,13509,13512,4975,3,PERF
42255316560000,PI,IP,001,32,13599,13602,4975,3,PERF
42255316560000,PI,IP,001,33,13689,13695,4975,6,PERF
42255316560000,PI,IP,001,34,13784,13787,4975,3,PERF
42255316560000,PI,IP,001,35,13874,13877,4975,3,PERF
42255316560000,PI,IP,001,36,13964,13970,4975,6,PERF
42255316560000,PI,IP,001,37,14059,14062,4975,3,PERF
42255316560000,PI,IP,001,38,14149,14153,4975,4,PERF
42255316560000,PI,IP,001,39,14239,14245,4975,6,PERF
42255316560000,PI,IP,001,40,14829,14832,4975,3,PERF
42255316560000,PI,IP,001,41,14929,14932,4975,3,PERF
42255316560000,PI,IP,001,42,15029,15035,4975,6,PERF
42255316570000,PI,IP,001,1,13400,17558,5136,4158,PERF
42255316580000,PI,IP,001,1,10800,10803,5373,3,PERF
42255316580000,PI,IP,001,2,10897,10900,5373,3,PERF
42255316580000,PI,IP,001,3,11010,11013,5373,3,PERF
42255316580000,PI,IP,001,4,11100,11103,5373,3,PERF
42255316580000,PI,IP,001,5,11200,11203,5373,3,PERF
42255316580000,PI,IP,001,6,11310,11313,5373,3,PERF
42255316580000,PI,IP,001,7,11400,11406,5373,6,PERF
42255316580000,PI,IP,001,8,12700,12703,5373,3,PERF
42255316580000,PI,IP,001,9,12810,12813,5373,3,PERF
42255316580000,PI,IP,001,10,12900,12906,5373,6,PERF
42255316580000,PI,IP,001,11,13000,13003,5373,3,PERF
42255316580000,PI,IP,001,12,13110,13113,5373,3,PERF
42255316580000,PI,IP,001,13,13200,13203,5373,3,PERF
42255316580000,PI,IP,001,14,13300,13330,5373,30,PERF
42255316580000,PI,IP,001,15,13395,13398,5373,3,PERF
42255316580000,PI,IP,001,16,13510,13513,5373,3,PERF
42255316580000,PI,IP,001,17,13600,13603,5373,3,PERF
42255316580000,PI,IP,001,18,13700,13703,5373,3,PERF
42255316580000,PI,IP,001,19,13810,13813,5373,3,PERF
42255316580000,PI,IP,001,20,13900,13903,5373,3,PERF
42255316580000,PI,IP,001,21,14000,14003,5373,3,PERF
42255316580000,PI,IP,001,22,14095,14098,5373,3,PERF
42255316580000,PI,IP,001,23,14200,14203,5373,3,PERF
42255316580000,PI,IP,001,24,14300,14303,5373,3,PERF
42255316580000,PI,IP,001,25,14400,14403,5373,3,PERF
42255316580000,PI,IP,001,26,14510,14513,5373,3,PERF
42255316580000,PI,IP,001,27,14600,14603,5373,3,PERF
42255316580000,PI,IP,001,28,14700,14703,5373,3,PERF
42255316580000,PI,IP,001,29,14795,14798,5373,3,PERF
42255316580000,PI,IP,001,30,14905,14908,5373,3,PERF
42255316580000,PI,IP,001,31,15000,15003,5373,3,PERF
42255316580000,PI,IP,001,32,15090,15093,5373,3,PERF
42255316580000,PI,IP,001,33,15180,15183,5373,3,PERF
42255316580000,PI,IP,001,34,15270,15273,5373,3,PERF
42255316580000,PI,IP,001,35,15369,15372,5373,3,PERF
42255316580000,PI,IP,001,36,15469,15472,5373,3,PERF
42255316580000,PI,IP,001,37,15563,15569,5373,6,PERF
42255316590000,PI,IP,001,1,10800,11003,5519,203,PERF
42255316590000,PI,IP,001,2,11200,11403,5519,203,PERF
42255316590000,PI,IP,001,3,11595,11803,5519,208,PERF
42255316590000,PI,IP,001,4,11995,12213,5519,218,PERF
42255316590000,PI,IP,001,5,12400,12603,5519,203,PERF
42255316590000,PI,IP,001,6,12800,13003,5519,203,PERF
42255316590000,PI,IP,001,7,13200,13203,5519,3,PERF
42255316590000,PI,IP,001,8,13400,13603,5519,203,PERF
42255316590000,PI,IP,001,9,13800,13803,5519,3,PERF
42255316590000,PI,IP,001,10,14000,14003,5519,3,PERF
42255316590000,PI,IP,001,11,14200,14203,5519,3,PERF
42255316590000,PI,IP,001,12,14400,14403,5519,3,PERF
42255316590000,PI,IP,001,13,14600,14603,5519,3,PERF
42255316590000,PI,IP,001,14,14800,14803,5519,3,PERF
42255316590000,PI,IP,001,15,15000,15003,5519,3,PERF
42255316590000,PI,IP,001,16,15176,15179,5519,3,PERF
42255316610001,PI,IP,001,1,12640,16533,,3893,PERF
42255316650000,PI,IP,001,1,11570,16673,5652,5103,PERF
42255316660000,PI,IP,001,1,10695,10698,4598,3,PERF
42255316660000,PI,IP,001,2,10790,10793,4598,3,PERF
42255316660000,PI,IP,001,3,10885,10888,4598,3,PERF
42255316660000,PI,IP,001,4,10980,10983,4598,3,PERF
42255316660000,PI,IP,001,5,11070,11073,4598,3,PERF
42255316660000,PI,IP,001,6,11170,11176,4598,6,PERF
42255316660000,PI,IP,001,7,11500,11503,4598,3,PERF
42255316660000,PI,IP,001,8,11619,11622,4598,3,PERF
42255316660000,PI,IP,001,9,11710,11716,4598,6,PERF
42255316660000,PI,IP,001,10,11805,11808,4598,3,PERF
42255316660000,PI,IP,001,11,11905,11908,4598,3,PERF
42255316660000,PI,IP,001,12,12005,12011,4598,6,PERF
42255316660000,PI,IP,001,13,12100,12103,4598,3,PERF
42255316660000,PI,IP,001,14,12200,12203,4598,3,PERF
42255316660000,PI,IP,001,15,12288,12294,4598,6,PERF
42255316660000,PI,IP,001,16,12400,12403,4598,3,PERF
42255316660000,PI,IP,001,17,12495,12498,4598,3,PERF
42255316660000,PI,IP,001,18,12595,12601,4598,6,PERF
42255316660000,PI,IP,001,19,12690,12693,4598,3,PERF
42255316660000,PI,IP,001,20,12790,12793,4598,3,PERF
42255316660000,PI,IP,001,21,12890,12896,4598,6,PERF
42255316660000,PI,IP,001,22,12985,12988,4598,3,PERF
42255316660000,PI,IP,001,23,13080,13083,4598,3,PERF
42255316660000,PI,IP,001,24,13190,13196,4598,6,PERF
42255316660000,PI,IP,001,25,13280,13283,4598,3,PERF
42255316660000,PI,IP,001,26,13380,13383,4598,3,PERF
42255316660000,PI,IP,001,27,13480,13486,4598,6,PERF
42255316660000,PI,IP,001,28,13575,13578,4598,3,PERF
42255316660000,PI,IP,001,29,13675,13678,4598,3,PERF
42255316660000,PI,IP,001,30,13775,13781,4598,6,PERF
42255316660000,PI,IP,001,31,13870,13873,4598,3,PERF
42255316660000,PI,IP,001,32,13964,13967,4598,3,PERF
42255316660000,PI,IP,001,33,14070,14076,4598,6,PERF
42255316660000,PI,IP,001,34,14165,14168,4598,3,PERF
42255316660000,PI,IP,001,35,14265,14268,4598,3,PERF
42255316660000,PI,IP,001,36,14365,14371,4598,6,PERF
42255316660000,PI,IP,001,37,14460,14463,4598,3,PERF
42255316660000,PI,IP,001,38,14560,14563,4598,3,PERF
42255316660000,PI,IP,001,39,14640,14646,4598,6,PERF
42255316670000,PI,IP,001,1,11650,11653,5785,3,PERF
42255316670000,PI,IP,001,2,11725,11728,5785,3,PERF
42255316670000,PI,IP,001,3,11790,11796,5785,6,PERF
42255316670000,PI,IP,001,4,12000,12003,5785,3,PERF
42255316670000,PI,IP,001,5,12100,12103,5785,3,PERF
42255316670000,PI,IP,001,6,12200,12206,5785,6,PERF
42255316670000,PI,IP,001,7,12300,12303,5785,3,PERF
42255316670000,PI,IP,001,8,12390,12393,5785,3,PERF
42255316670000,PI,IP,001,9,12480,12486,5785,6,PERF
42255316670000,PI,IP,001,10,12570,12573,5785,3,PERF
42255316670000,PI,IP,001,11,12660,12663,5785,3,PERF
42255316670000,PI,IP,001,12,12750,12756,5785,6,PERF
42255316670000,PI,IP,001,13,12840,12843,5785,3,PERF
42255316670000,PI,IP,001,14,12930,12933,5785,3,PERF
42255316670000,PI,IP,001,15,13020,13026,5785,6,PERF
42255316670000,PI,IP,001,16,13110,13113,5785,3,PERF
42255316670000,PI,IP,001,17,13204,13207,5785,3,PERF
42255316670000,PI,IP,001,18,13296,13302,5785,6,PERF
42255316670000,PI,IP,001,19,13367,13370,5785,3,PERF
42255316670000,PI,IP,001,20,13457,13460,5785,3,PERF
42255316670000,PI,IP,001,21,13546,13552,5785,6,PERF
42255316670000,PI,IP,001,22,13640,13643,5785,3,PERF
42255316670000,PI,IP,001,23,13740,13743,5785,3,PERF
42255316670000,PI,IP,001,24,13826,13832,5785,6,PERF
42255316670000,PI,IP,001,25,13920,13923,5785,3,PERF
42255316670000,PI,IP,001,26,14010,14013,5785,3,PERF
42255316670000,PI,IP,001,27,14100,14106,5785,6,PERF
42255316670000,PI,IP,001,28,14310,14313,5785,3,PERF
42255316670000,PI,IP,001,29,14415,14418,5785,3,PERF
42255316670000,PI,IP,001,30,14506,14512,5785,6,PERF
42255316670000,PI,IP,001,31,14625,14628,5785,3,PERF
42255316670000,PI,IP,001,32,14730,14733,5785,3,PERF
42255316670000,PI,IP,001,33,14840,14846,5785,6,PERF
42255316670000,PI,IP,001,34,14940,14943,5785,3,PERF
42255316670000,PI,IP,001,35,15045,15048,5785,3,PERF
42255316670000,PI,IP,001,36,15150,15156,5785,6,PERF
42255316670000,PI,IP,001,37,15255,15258,5785,3,PERF
42255316670000,PI,IP,001,38,15355,15358,5785,3,PERF
42255316670000,PI,IP,001,39,15452,15458,5785,6,PERF
42255316680001,PI,IP,001,1,11920,15993,,4073,PERF
42255316690000,PI,IP,001,1,13700,18182,5120,4482,PERF
42255316710000,PI,IP,001,1,12918,17084,4952,4166,PERF
42255316730000,PI,IP,001,1,13490,16922,4252,3432,PERF
42255316740000,PI,IP,001,1,11336,16020,5629,4684,PERF
42255316750000,PI,IP,001,1,11076,15253,4786,4177,PERF
42255316760000,PI,IP,001,1,10579,14100,4254,3521,OPENHOLE
42255316770000,PI,IP,001,1,13506,17400,,3894,OPENHOLE
42255316790000,PI,IP,001,1,13560,16992,4383,3432,PERF
42255316800000,PI,IP,001,1,13640,18750,6111,5110,PERF
42255316810000,PI,IP,001,1,13485,17308,4373,3823,PERF
42255316830000,PI,IP,001,1,12407,16717,5648,4310,PERF
42255316840000,PI,IP,001,1,12330,12332,5552,2,PERF
42255316840000,PI,IP,001,2,12397,12399,5552,2,PERF
42255316840000,PI,IP,001,3,12464,12466,5552,2,PERF
42255316840000,PI,IP,001,4,12513,12531,5552,18,PERF
42255316840000,PI,IP,001,5,12613,12615,5552,2,PERF
42255316840000,PI,IP,001,6,12680,12682,5552,2,PERF
42255316840000,PI,IP,001,7,12747,12749,5552,2,PERF
42255316840000,PI,IP,001,8,12814,12816,5552,2,PERF
42255316840000,PI,IP,001,9,12896,12898,5552,2,PERF
42255316840000,PI,IP,001,10,12963,12995,5552,32,PERF
42255316840000,PI,IP,001,11,13030,13032,5552,2,PERF
42255316840000,PI,IP,001,12,13097,13099,5552,2,PERF
42255316840000,PI,IP,001,13,13180,13182,5552,2,PERF
42255316840000,PI,IP,001,14,13247,13249,5552,2,PERF
42255316840000,PI,IP,001,15,13314,13316,5552,2,PERF
42255316840000,PI,IP,001,16,13381,13383,5552,2,PERF
42255316840000,PI,IP,001,17,13463,13465,5552,2,PERF
42255316840000,PI,IP,001,18,13530,13532,5552,2,PERF
42255316840000,PI,IP,001,19,13579,13581,5552,2,PERF
42255316840000,PI,IP,001,20,13664,13666,5552,2,PERF
42255316840000,PI,IP,001,21,13746,13748,5552,2,PERF
42255316840000,PI,IP,001,22,13813,13815,5552,2,PERF
42255316840000,PI,IP,001,23,13880,13882,5552,2,PERF
42255316840000,PI,IP,001,24,13947,13949,5552,2,PERF
42255316840000,PI,IP,001,25,14029,14031,5552,2,PERF
42255316840000,PI,IP,001,26,14096,14098,5552,2,PERF
42255316840000,PI,IP,001,27,14163,14165,5552,2,PERF
42255316840000,PI,IP,001,28,14230,14232,5552,2,PERF
42255316840000,PI,IP,001,29,14312,14314,5552,2,PERF
42255316840000,PI,IP,001,30,14379,14381,5552,2,PERF
42255316840000,PI,IP,001,31,14446,14448,5552,2,PERF
42255316840000,PI,IP,001,32,14513,14515,5552,2,PERF
42255316840000,PI,IP,001,33,14595,14597,5552,2,PERF
42255316840000,PI,IP,001,34,14662,14664,5552,2,PERF
42255316840000,PI,IP,001,35,14729,14731,5552,2,PERF
42255316840000,PI,IP,001,36,14796,14798,5552,2,PERF
42255316840000,PI,IP,001,37,14878,14881,5552,3,PERF
42255316840000,PI,IP,001,38,14945,14947,5552,2,PERF
42255316840000,PI,IP,001,39,15012,15014,5552,2,PERF
42255316840000,PI,IP,001,40,15079,15081,5552,2,PERF
42255316840000,PI,IP,001,41,15161,15163,5552,2,PERF
42255316840000,PI,IP,001,42,15228,15230,5552,2,PERF
42255316840000,PI,IP,001,43,15295,15297,5552,2,PERF
42255316840000,PI,IP,001,44,15362,15364,5552,2,PERF
42255316840000,PI,IP,001,45,15445,15447,5552,2,PERF
42255316840000,PI,IP,001,46,15512,15515,5552,3,PERF
42255316840000,PI,IP,001,47,15579,15581,5552,2,PERF
42255316840000,PI,IP,001,48,15646,15648,5552,2,PERF
42255316840000,PI,IP,001,49,15929,15931,5552,2,PERF
42255316840000,PI,IP,001,50,15862,15864,5552,2,PERF
42255316840000,PI,IP,001,51,15795,15797,5552,2,PERF
42255316840000,PI,IP,001,52,16728,16730,5552,2,PERF
42255316840000,PI,IP,001,53,16212,16214,5552,2,PERF
42255316840000,PI,IP,001,54,16145,16147,5552,2,PERF
42255316840000,PI,IP,001,55,16078,16080,5552,2,PERF
42255316840000,PI,IP,001,56,16011,16013,5552,2,PERF
42255316840000,PI,IP,001,57,16294,16296,5552,2,PERF
42255316840000,PI,IP,001,58,16361,16363,5552,2,PERF
42255316840000,PI,IP,001,59,16428,16430,5552,2,PERF
42255316840000,PI,IP,001,60,16495,16497,5552,2,PERF
42255316840000,PI,IP,001,61,16577,16579,5552,2,PERF
42255316840000,PI,IP,001,62,16644,16646,5552,2,PERF
42255316840000,PI,IP,001,63,16711,16713,5552,2,PERF
42255316840000,PI,IP,001,64,16778,16780,5552,2,PERF
42255316850000,PI,IP,001,1,13380,17720,4750,4340,PERF
42255316880000,PI,IP,001,1,9281,12466,3799,3185,PERF
42255316890000,PI,IP,001,1,10137,13155,4899,3018,PERF
42255316900000,PI,IP,001,1,14280,17444,6358,3164,PERF
42255316910000,PI,IP,001,1,13100,17442,5003,4342,PERF
42255316920000,PI,IP,001,1,13675,13940,,265,PERF
42255316920000,PI,IP,001,2,14020,14270,,250,PERF
42255316920000,PI,IP,001,3,14335,14591,,256,PERF
42255316920000,PI,IP,001,4,14665,14930,,265,PERF
42255316920000,PI,IP,001,5,15004,15260,,256,PERF
42255316920000,PI,IP,001,6,15325,15575,,250,PERF
42255316920000,PI,IP,001,7,15655,15920,,265,PERF
42255316920000,PI,IP,001,8,15985,16250,,265,PERF
42255316920000,PI,IP,001,9,16315,16580,,265,PERF
42255316920000,PI,IP,001,10,16656,16910,,254,PERF
42255316920000,PI,IP,001,11,16975,17245,,270,PERF
42255316920000,PI,IP,001,12,17305,17570,,265,PERF
42255316940000,PI,IP,001,1,13701,17361,4149,3660,PERF
42255316950000,PI,IP,001,1,12000,14689,5554,2689,PERF
42255316960000,PI,IP,001,1,12344,12346,5170,2,PERF
42255316960000,PI,IP,001,2,12415,12416,5170,1,PERF
42255316960000,PI,IP,001,3,12485,12487,5170,2,PERF
42255316960000,PI,IP,001,4,12556,12557,5170,1,PERF
42255316960000,PI,IP,001,5,12640,12642,5170,2,PERF
42255316960000,PI,IP,001,6,12709,12710,5170,1,PERF
42255316960000,PI,IP,001,7,12777,12779,5170,2,PERF
42255316960000,PI,IP,001,8,12846,12847,5170,1,PERF
42255316960000,PI,IP,001,9,12930,12932,5170,2,PERF
42255316960000,PI,IP,001,10,12999,13000,5170,1,PERF
42255316960000,PI,IP,001,11,13069,13070,5170,1,PERF
42255316960000,PI,IP,001,12,13136,13137,5170,1,PERF
42255316960000,PI,IP,001,13,13220,13222,5170,2,PERF
42255316960000,PI,IP,001,14,13289,13290,5170,1,PERF
42255316960000,PI,IP,001,15,13357,13359,5170,2,PERF
42255316960000,PI,IP,001,16,13426,13427,5170,1,PERF
42255316960000,PI,IP,001,17,13510,13512,5170,2,PERF
42255316960000,PI,IP,001,18,13579,13580,5170,1,PERF
42255316960000,PI,IP,001,19,13674,13676,5170,2,PERF
42255316960000,PI,IP,001,20,13716,13717,5170,1,PERF
42255316960000,PI,IP,001,21,13800,13802,5170,2,PERF
42255316960000,PI,IP,001,22,13869,13870,5170,1,PERF
42255316960000,PI,IP,001,23,13937,13939,5170,2,PERF
42255316960000,PI,IP,001,24,14006,14007,5170,1,PERF
42255316960000,PI,IP,001,25,14090,14092,5170,2,PERF
42255316960000,PI,IP,001,26,14159,14160,5170,1,PERF
42255316960000,PI,IP,001,27,14227,14229,5170,2,PERF
42255316960000,PI,IP,001,28,14296,14297,5170,1,PERF
42255316960000,PI,IP,001,29,14380,14382,5170,2,PERF
42255316960000,PI,IP,001,30,14449,14450,5170,1,PERF
42255316960000,PI,IP,001,31,14517,14519,5170,2,PERF
42255316960000,PI,IP,001,32,14586,14587,5170,1,PERF
42255316960000,PI,IP,001,33,14670,14672,5170,2,PERF
42255316960000,PI,IP,001,34,14739,14740,5170,1,PERF
42255316960000,PI,IP,001,35,14807,14809,5170,2,PERF
42255316960000,PI,IP,001,36,14876,14877,5170,1,PERF
42255316960000,PI,IP,001,37,14960,14962,5170,2,PERF
42255316960000,PI,IP,001,38,15029,15030,5170,1,PERF
42255316960000,PI,IP,001,39,15097,15099,5170,2,PERF
42255316960000,PI,IP,001,40,15166,15167,5170,1,PERF
42255316960000,PI,IP,001,41,15250,15252,5170,2,PERF
42255316960000,PI,IP,001,42,15319,15320,5170,1,PERF
42255316960000,PI,IP,001,43,15387,15389,5170,2,PERF
42255316960000,PI,IP,001,44,15456,15457,5170,1,PERF
42255316960000,PI,IP,001,45,15540,15542,5170,2,PERF
42255316960000,PI,IP,001,46,15609,15610,5170,1,PERF
42255316960000,PI,IP,001,47,15677,15679,5170,2,PERF
42255316960000,PI,IP,001,48,15746,15747,5170,1,PERF
42255316960000,PI,IP,001,49,15830,15832,5170,2,PERF
42255316960000,PI,IP,001,50,15899,15900,5170,1,PERF
42255316960000,PI,IP,001,51,15967,15969,5170,2,PERF
42255316960000,PI,IP,001,52,16036,16037,5170,1,PERF
42255316960000,PI,IP,001,53,16121,16122,5170,1,PERF
42255316960000,PI,IP,001,54,16189,16190,5170,1,PERF
42255316960000,PI,IP,001,55,16257,16258,5170,1,PERF
42255316960000,PI,IP,001,56,16325,16326,5170,1,PERF
42255316960000,PI,IP,001,57,16408,16410,5170,2,PERF
42255316960000,PI,IP,001,58,16477,16479,5170,2,PERF
42255316960000,PI,IP,001,59,16546,16548,5170,2,PERF
42255316960000,PI,IP,001,60,16615,16617,5170,2,PERF
42255316970000,PI,IP,001,1,12305,12306,5477,1,PERF
42255316970000,PI,IP,001,2,12353,12354,5477,1,PERF
42255316970000,PI,IP,001,3,12401,12402,5477,1,PERF
42255316970000,PI,IP,001,4,12449,12450,5477,1,PERF
42255316970000,PI,IP,001,5,12554,12556,5477,2,PERF
42255316970000,PI,IP,001,6,12596,12597,5477,1,PERF
42255316970000,PI,IP,001,7,12637,12639,5477,2,PERF
42255316970000,PI,IP,001,8,12679,12680,5477,1,PERF
42255316970000,PI,IP,001,9,12782,12784,5477,2,PERF
42255316970000,PI,IP,001,10,12878,12879,5477,1,PERF
42255316970000,PI,IP,001,11,12973,12975,5477,2,PERF
42255316970000,PI,IP,001,12,13069,13070,5477,1,PERF
42255316970000,PI,IP,001,13,13174,13176,5477,2,PERF
42255316970000,PI,IP,001,14,13266,13267,5477,1,PERF
42255316970000,PI,IP,001,15,13357,13359,5477,2,PERF
42255316970000,PI,IP,001,16,13449,13450,5477,1,PERF
42255316970000,PI,IP,001,17,13552,13554,5477,2,PERF
42255316970000,PI,IP,001,18,13618,13619,5477,1,PERF
42255316970000,PI,IP,001,19,13683,13685,5477,2,PERF
42255316970000,PI,IP,001,20,13749,13750,5477,1,PERF
42255316970000,PI,IP,001,21,13854,13855,5477,1,PERF
42255316970000,PI,IP,001,22,13919,13920,5477,1,PERF
42255316970000,PI,IP,001,23,13984,13985,5477,1,PERF
42255316970000,PI,IP,001,24,14049,14050,5477,1,PERF
42255316970000,PI,IP,001,25,14154,14156,5477,2,PERF
42255316970000,PI,IP,001,26,14226,14227,5477,1,PERF
42255316970000,PI,IP,001,27,14297,14299,5477,2,PERF
42255316970000,PI,IP,001,28,14369,14370,5477,1,PERF
42255316970000,PI,IP,001,29,14474,14476,5477,2,PERF
42255316970000,PI,IP,001,30,14546,14547,5477,1,PERF
42255316970000,PI,IP,001,31,14617,14619,5477,2,PERF
42255316970000,PI,IP,001,32,14689,14690,5477,1,PERF
42255316970000,PI,IP,001,33,14794,14796,5477,2,PERF
42255316970000,PI,IP,001,34,14866,14867,5477,1,PERF
42255316970000,PI,IP,001,35,14937,14939,5477,2,PERF
42255316970000,PI,IP,001,36,15009,15010,5477,1,PERF
42255316970000,PI,IP,001,37,15114,15116,5477,2,PERF
42255316970000,PI,IP,001,38,15186,15187,5477,1,PERF
42255316970000,PI,IP,001,39,15257,15259,5477,2,PERF
42255316970000,PI,IP,001,40,15329,15330,5477,1,PERF
42255316970000,PI,IP,001,41,15434,15436,5477,2,PERF
42255316970000,PI,IP,001,42,15506,15507,5477,1,PERF
42255316970000,PI,IP,001,43,15577,15579,5477,2,PERF
42255316970000,PI,IP,001,44,15649,15650,5477,1,PERF
42255316970000,PI,IP,001,45,15754,15756,5477,2,PERF
42255316970000,PI,IP,001,46,15836,15837,5477,1,PERF
42255316970000,PI,IP,001,47,15917,15919,5477,2,PERF
42255316970000,PI,IP,001,48,15999,16000,5477,1,PERF
42255316970000,PI,IP,001,49,16102,16104,5477,2,PERF
42255316970000,PI,IP,001,50,16192,16193,5477,1,PERF
42255316970000,PI,IP,001,51,16281,16283,5477,2,PERF
42255316970000,PI,IP,001,52,16371,16372,5477,1,PERF
42255316970000,PI,IP,001,53,16506,16508,5477,2,PERF
42255316970000,PI,IP,001,54,16511,16513,5477,2,PERF
42255316970000,PI,IP,001,55,16549,16550,5477,1,PERF
42255316970000,PI,IP,001,56,16679,16680,5477,1,PERF
42255316970000,PI,IP,001,57,16759,16760,5477,1,PERF
42255316970000,PI,IP,001,58,16839,16840,5477,1,PERF
42255316970000,PI,IP,001,59,16919,16920,5477,1,PERF
42255317000100,PI,IP,001,1,12970,12972,4124,2,PERF
42255317000100,PI,IP,001,2,13035,13037,4124,2,PERF
42255317000100,PI,IP,001,3,13100,13102,4124,2,PERF
42255317000100,PI,IP,001,4,13165,13167,4124,2,PERF
42255317000100,PI,IP,001,5,13230,13232,4124,2,PERF
42255317000100,PI,IP,001,6,13295,13297,4124,2,PERF
42255317000100,PI,IP,001,7,13360,13362,4124,2,PERF
42255317000100,PI,IP,001,8,13425,13427,4124,2,PERF
42255317000100,PI,IP,001,9,13490,13492,4124,2,PERF
42255317000100,PI,IP,001,10,13555,13557,4124,2,PERF
42255317000100,PI,IP,001,11,13620,13622,4124,2,PERF
42255317000100,PI,IP,001,12,13685,13687,4124,2,PERF
42255317000100,PI,IP,001,13,13750,13752,4124,2,PERF
42255317000100,PI,IP,001,14,13815,13817,4124,2,PERF
42255317000100,PI,IP,001,15,13880,13882,4124,2,PERF
42255317000100,PI,IP,001,16,13945,13947,4124,2,PERF
42255317000100,PI,IP,001,17,14010,14012,4124,2,PERF
42255317000100,PI,IP,001,18,14075,14077,4124,2,PERF
42255317000100,PI,IP,001,19,14140,14142,4124,2,PERF
42255317000100,PI,IP,001,20,14205,14207,4124,2,PERF
42255317000100,PI,IP,001,21,14270,14272,4124,2,PERF
42255317000100,PI,IP,001,22,14335,14337,4124,2,PERF
42255317000100,PI,IP,001,23,14400,14402,4124,2,PERF
42255317000100,PI,IP,001,24,14465,14467,4124,2,PERF
42255317000100,PI,IP,001,25,14520,14522,4124,2,PERF
42255317000100,PI,IP,001,26,14595,14597,4124,2,PERF
42255317000100,PI,IP,001,27,14655,14657,4124,2,PERF
42255317000100,PI,IP,001,28,14725,14727,4124,2,PERF
42255317000100,PI,IP,001,29,14790,14792,4124,2,PERF
42255317000100,PI,IP,001,30,14855,14857,4124,2,PERF
42255317000100,PI,IP,001,31,14920,14922,4124,2,PERF
42255317000100,PI,IP,001,32,14985,14987,4124,2,PERF
42255317000100,PI,IP,001,33,15050,15052,4124,2,PERF
42255317000100,PI,IP,001,34,15115,15117,4124,2,PERF
42255317000100,PI,IP,001,35,15180,15182,4124,2,PERF
42255317000100,PI,IP,001,36,15245,15247,4124,2,PERF
42255317000100,PI,IP,001,37,15520,15522,4124,2,PERF
42255317000100,PI,IP,001,38,15796,15798,4124,2,PERF
42255317000100,PI,IP,001,39,16070,16072,4124,2,PERF
42255317000100,PI,IP,001,40,16348,16350,4124,2,PERF
42255317010000,PI,IP,001,1,13210,16850,4345,3640,PERF
42255317020000,PI,IP,001,1,12580,17884,5533,5304,PERF
42255317030100,PI,IP,001,1,13192,17114,4891,3922,PERF
42255317040000,PI,IP,001,1,10896,14384,3778,3488,PERF
42255317050000,PI,IP,001,1,11300,11303,4820,3,PERF
42255317050000,PI,IP,001,2,11400,11403,4820,3,PERF
42255317050000,PI,IP,001,3,11500,11503,4820,3,PERF
42255317050000,PI,IP,001,4,11590,11593,4820,3,PERF
42255317050000,PI,IP,001,5,11700,11703,4820,3,PERF
42255317050000,PI,IP,001,6,11800,11803,4820,3,PERF
42255317050000,PI,IP,001,7,11900,11906,4820,6,PERF
42255317050000,PI,IP,001,8,12000,12003,4820,3,PERF
42255317050000,PI,IP,001,9,12090,12093,4820,3,PERF
42255317050000,PI,IP,001,10,12200,12206,4820,6,PERF
42255317050000,PI,IP,001,11,12300,12303,4820,3,PERF
42255317050000,PI,IP,001,12,12400,12403,4820,3,PERF
42255317050000,PI,IP,001,13,12500,12506,4820,6,PERF
42255317050000,PI,IP,001,14,12600,12603,4820,3,PERF
42255317050000,PI,IP,001,15,12700,12703,4820,3,PERF
42255317050000,PI,IP,001,16,12800,12806,4820,6,PERF
42255317050000,PI,IP,001,17,12900,12903,4820,3,PERF
42255317050000,PI,IP,001,18,13000,13003,4820,3,PERF
42255317050000,PI,IP,001,19,13100,13106,4820,6,PERF
42255317050000,PI,IP,001,20,13200,13203,4820,3,PERF
42255317050000,PI,IP,001,21,13310,13313,4820,3,PERF
42255317050000,PI,IP,001,22,13400,13406,4820,6,PERF
42255317050000,PI,IP,001,23,13500,13503,4820,3,PERF
42255317050000,PI,IP,001,24,13600,13603,4820,3,PERF
42255317050000,PI,IP,001,25,13700,13706,4820,6,PERF
42255317050000,PI,IP,001,26,13800,13803,4820,3,PERF
42255317050000,PI,IP,001,27,13910,13913,4820,3,PERF
42255317050000,PI,IP,001,28,14000,14006,4820,6,PERF
42255317050000,PI,IP,001,29,14100,14103,4820,3,PERF
42255317050000,PI,IP,001,30,14200,14203,4820,3,PERF
42255317050000,PI,IP,001,31,14303,14306,4820,3,PERF
42255317050000,PI,IP,001,32,14998,14998,4820,0,PERF
42255317050000,PI,IP,001,33,15286,15286,4820,0,PERF
42255317050000,PI,IP,001,34,15486,15486,4820,0,PERF
42255317060000,PI,IP,001,1,10700,10702,4440,2,PERF
42255317060000,PI,IP,001,2,10775,10777,4440,2,PERF
42255317060000,PI,IP,001,3,10850,10852,4440,2,PERF
42255317060000,PI,IP,001,4,10925,10928,4440,3,PERF
42255317060000,PI,IP,001,5,11015,11017,4440,2,PERF
42255317060000,PI,IP,001,6,11085,11087,4440,2,PERF
42255317060000,PI,IP,001,7,11165,11167,4440,2,PERF
42255317060000,PI,IP,001,8,11250,11253,4440,3,PERF
42255317060000,PI,IP,001,9,11335,11337,4440,2,PERF
42255317060000,PI,IP,001,10,11405,11407,4440,2,PERF
42255317060000,PI,IP,001,11,11480,11482,4440,2,PERF
42255317060000,PI,IP,001,12,11555,11558,4440,3,PERF
42255317060000,PI,IP,001,13,11645,11647,4440,2,PERF
42255317060000,PI,IP,001,14,11720,11722,4440,2,PERF
42255317060000,PI,IP,001,15,11795,11797,4440,2,PERF
42255317060000,PI,IP,001,16,11870,11873,4440,3,PERF
42255317060000,PI,IP,001,17,11960,11962,4440,2,PERF
42255317060000,PI,IP,001,18,12025,12027,4440,2,PERF
42255317060000,PI,IP,001,19,12110,12112,4440,2,PERF
42255317060000,PI,IP,001,20,12185,12188,4440,3,PERF
42255317060000,PI,IP,001,21,12275,12277,4440,2,PERF
42255317060000,PI,IP,001,22,12345,12347,4440,2,PERF
42255317060000,PI,IP,001,23,12425,12427,4440,2,PERF
42255317060000,PI,IP,001,24,12488,12491,4440,3,PERF
42255317060000,PI,IP,001,25,13200,13202,4440,2,PERF
42255317060000,PI,IP,001,26,13275,13277,4440,2,PERF
42255317060000,PI,IP,001,27,13350,13352,4440,2,PERF
42255317060000,PI,IP,001,28,13420,13423,4440,3,PERF
42255317060000,PI,IP,001,29,13525,13527,4440,2,PERF
42255317060000,PI,IP,001,30,13600,13602,4440,2,PERF
42255317060000,PI,IP,001,31,13675,13677,4440,2,PERF
42255317060000,PI,IP,001,32,13745,13748,4440,3,PERF
42255317060000,PI,IP,001,33,14155,14157,4440,2,PERF
42255317060000,PI,IP,001,34,14230,14232,4440,2,PERF
42255317060000,PI,IP,001,35,14305,14307,4440,2,PERF
42255317060000,PI,IP,001,36,14390,14393,4440,3,PERF
42255317060000,PI,IP,001,37,14480,14483,4440,3,PERF
42255317060000,PI,IP,001,38,14563,14569,4440,6,PERF
42255317060000,PI,IP,001,39,14580,14583,4440,3,PERF
42255317070000,PI,IP,001,1,10405,10408,2707,3,PERF
42255317070000,PI,IP,001,2,10480,10483,2707,3,PERF
42255317070000,PI,IP,001,3,10560,10566,2707,6,PERF
42255317070000,PI,IP,001,4,10650,10653,2707,3,PERF
42255317070000,PI,IP,001,5,10740,10743,2707,3,PERF
42255317070000,PI,IP,001,6,10830,10836,2707,6,PERF
42255317070000,PI,IP,001,7,10930,10933,2707,3,PERF
42255317070000,PI,IP,001,8,11020,11023,2707,3,PERF
42255317070000,PI,IP,001,9,11110,11116,2707,6,PERF
42255317070000,PI,IP,001,10,11210,11213,2707,3,PERF
42255317070000,PI,IP,001,11,11300,11303,2707,3,PERF
42255317070000,PI,IP,001,12,11390,11396,2707,6,PERF
42255317070000,PI,IP,001,13,11480,11483,2707,3,PERF
42255317070000,PI,IP,001,14,11560,11563,2707,3,PERF
42255317070000,PI,IP,001,15,11643,11646,2707,3,PERF
42255317070000,PI,IP,001,16,11654,11660,2707,6,PERF
42255317070000,PI,IP,001,17,11770,11773,2707,3,PERF
42255317070000,PI,IP,001,18,11860,11863,2707,3,PERF
42255317070000,PI,IP,001,19,11950,11956,2707,6,PERF
42255317080000,PI,IP,001,1,9104,12719,,3615,PERF
42255317090000,PI,IP,001,1,12050,17230,5204,5180,PERF
42255317100000,PI,IP,001,1,13345,19369,6462,6024,PERF
42255317130000,PI,IP,001,1,10150,13900,4330,3750,PERF
42255317140000,PI,IP,001,1,13865,18018,5734,4153,PERF
42255317150000,PI,IP,001,1,13415,17405,4547,3990,PERF
42255317160000,PI,IP,001,1,13330,17236,4668,3906,PERF
42255317170000,PI,IP,001,1,10215,10217,3255,2,PERF
42255317170000,PI,IP,001,2,10230,10280,3255,50,PERF
42255317170000,PI,IP,001,3,10345,10347,3255,2,PERF
42255317170000,PI,IP,001,4,10410,10412,3255,2,PERF
42255317170000,PI,IP,001,5,10475,10477,3255,2,PERF
42255317170000,PI,IP,001,6,10540,10542,3255,2,PERF
42255317170000,PI,IP,001,7,10610,10612,3255,2,PERF
42255317170000,PI,IP,001,8,10670,10672,3255,2,PERF
42255317170000,PI,IP,001,9,10730,10732,3255,2,PERF
42255317170000,PI,IP,001,10,10800,10802,3255,2,PERF
42255317170000,PI,IP,001,11,10865,10867,3255,2,PERF
42255317170000,PI,IP,001,12,10930,10932,3255,2,PERF
42255317170000,PI,IP,001,13,10995,10997,3255,2,PERF
42255317170000,PI,IP,001,14,11050,11052,3255,2,PERF
42255317170000,PI,IP,001,15,11125,11127,3255,2,PERF
42255317170000,PI,IP,001,16,11190,11192,3255,2,PERF
42255317170000,PI,IP,001,17,11255,11257,3255,2,PERF
42255317170000,PI,IP,001,18,11320,11322,3255,2,PERF
42255317170000,PI,IP,001,19,11385,11387,3255,2,PERF
42255317170000,PI,IP,001,20,11450,11452,3255,2,PERF
42255317170000,PI,IP,001,21,11510,11512,3255,2,PERF
42255317170000,PI,IP,001,22,11580,11582,3255,2,PERF
42255317170000,PI,IP,001,23,11645,11647,3255,2,PERF
42255317170000,PI,IP,001,24,11710,11712,3255,2,PERF
42255317170000,PI,IP,001,25,11775,11777,3255,2,PERF
42255317170000,PI,IP,001,26,11842,11845,3255,3,PERF
42255317170000,PI,IP,001,27,11905,11907,3255,2,PERF
42255317170000,PI,IP,001,28,11968,11970,3255,2,PERF
42255317170000,PI,IP,001,29,12035,12038,3255,3,PERF
42255317170000,PI,IP,001,30,12100,12102,3255,2,PERF
42255317170000,PI,IP,001,31,12165,12167,3255,2,PERF
42255317170000,PI,IP,001,32,12228,12230,3255,2,PERF
42255317170000,PI,IP,001,33,12295,12297,3255,2,PERF
42255317170000,PI,IP,001,34,12360,12362,3255,2,PERF
42255317170000,PI,IP,001,35,12425,12427,3255,2,PERF
42255317170000,PI,IP,001,36,12490,12493,3255,3,PERF
42255317170000,PI,IP,001,37,12590,12596,3255,6,PERF
42255317170000,PI,IP,001,38,12690,12696,3255,6,PERF
42255317180000,PI,IP,001,1,10280,14130,4568,3850,PERF
42255317190000,PI,IP,001,1,13475,17207,4225,3732,PERF
42255317210000,PI,IP,001,1,11880,12154,5683,274,PERF
42255317210000,PI,IP,001,2,12470,12774,5683,304,PERF
42255317210000,PI,IP,001,3,12940,13244,5683,304,PERF
42255317210000,PI,IP,001,4,13410,13714,5683,304,PERF
42255317210000,PI,IP,001,5,13880,14184,5683,304,PERF
42255317210000,PI,IP,001,6,14350,14654,5683,304,PERF
42255317210000,PI,IP,001,7,14820,15124,5683,304,PERF
42255317210000,PI,IP,001,8,15290,15594,5683,304,PERF
42255317210000,PI,IP,001,9,15760,16064,5683,304,PERF
42255317210000,PI,IP,001,10,16230,16534,5683,304,PERF
42255317210000,PI,IP,001,11,16700,17004,5683,304,PERF
42255317210000,PI,IP,001,12,17170,17470,5683,300,PERF
42255317220000,PI,IP,001,1,9205,9478,6622,273,PERF
42255317220000,PI,IP,001,2,9603,9876,6622,273,PERF
42255317220000,PI,IP,001,3,10001,10274,6622,273,PERF
42255317220000,PI,IP,001,4,10399,10672,6622,273,PERF
42255317220000,PI,IP,001,5,10797,11070,6622,273,PERF
42255317220000,PI,IP,001,6,11195,11468,6622,273,PERF
42255317220000,PI,IP,001,7,11593,11866,6622,273,PERF
42255317220000,PI,IP,001,8,11991,12264,6622,273,PERF
42255317220000,PI,IP,001,9,12389,12662,6622,273,PERF
42255317220000,PI,IP,001,10,12787,13060,6622,273,PERF
42255317220000,PI,IP,001,11,13185,13458,6622,273,PERF
42255317220000,PI,IP,001,12,13583,13856,6622,273,PERF
42255317220000,PI,IP,001,13,13981,14254,6622,273,PERF
42255317220000,PI,IP,001,14,14379,14652,6622,273,PERF
42255317220000,PI,IP,001,15,14777,15050,6622,273,PERF
42255317240000,PI,IP,001,1,13119,17300,,4181,PERF
42255317250000,PI,IP,001,1,11899,12098,4644,199,PERF
42255317250000,PI,IP,001,2,12198,12397,4644,199,PERF
42255317250000,PI,IP,001,3,12497,12696,4644,199,PERF
42255317250000,PI,IP,001,4,12796,12995,4644,199,PERF
42255317250000,PI,IP,001,5,13095,13294,4644,199,PERF
42255317250000,PI,IP,001,6,13394,13593,4644,199,PERF
42255317250000,PI,IP,001,7,13693,13892,4644,199,PERF
42255317250000,PI,IP,001,8,13992,14191,4644,199,PERF
42255317250000,PI,IP,001,9,14291,14490,4644,199,PERF
42255317250000,PI,IP,001,10,14590,14789,4644,199,PERF
42255317250000,PI,IP,001,11,14889,15088,4644,199,PERF
42255317250000,PI,IP,001,12,15188,15387,4644,199,PERF
42255317250000,PI,IP,001,13,15487,15686,4644,199,PERF
42255317250000,PI,IP,001,14,15786,15985,4644,199,PERF
42255317260000,PI,IP,001,1,10970,14131,3881,3161,PERF
42255317270000,PI,IP,001,1,10976,13921,3842,2945,PERF
42255317280000,PI,IP,001,1,10750,15616,5407,4866,PERF
42255317290000,PI,IP,001,1,10815,15939,5587,5124,PERF
42255317300000,PI,IP,001,1,11390,11520,5685,130,PERF
42255317300000,PI,IP,001,2,11670,11800,5685,130,PERF
42255317300000,PI,IP,001,3,11950,12080,5685,130,PERF
42255317300000,PI,IP,001,4,12230,12360,5685,130,PERF
42255317300000,PI,IP,001,5,12510,12640,5685,130,PERF
42255317300000,PI,IP,001,6,12790,12920,5685,130,PERF
42255317300000,PI,IP,001,7,13070,13200,5685,130,PERF
42255317300000,PI,IP,001,8,13350,13480,5685,130,PERF
42255317300000,PI,IP,001,9,13630,13760,5685,130,PERF
42255317300000,PI,IP,001,10,13910,14040,5685,130,PERF
42255317300000,PI,IP,001,11,14190,14320,5685,130,PERF
42255317310000,PI,IP,001,1,12875,17257,5320,4382,PERF
42255317320000,PI,IP,001,1,12030,12154,5088,124,PERF
42255317320000,PI,IP,001,2,12440,12564,5088,124,PERF
42255317320000,PI,IP,001,3,12750,12874,5088,124,PERF
42255317320000,PI,IP,001,4,13060,13184,5088,124,PERF
42255317320000,PI,IP,001,5,13370,13494,5088,124,PERF
42255317320000,PI,IP,001,6,13680,13804,5088,124,PERF
42255317320000,PI,IP,001,7,13990,14114,5088,124,PERF
42255317320000,PI,IP,001,8,14300,14424,5088,124,PERF
42255317320000,PI,IP,001,9,14610,14734,5088,124,PERF
42255317320000,PI,IP,001,10,14920,15044,5088,124,PERF
42255317320000,PI,IP,001,11,15230,15354,5088,124,PERF
42255317320000,PI,IP,001,12,15540,15664,5088,124,PERF
42255317320000,PI,IP,001,13,15850,15974,5088,124,PERF
42255317320000,PI,IP,001,14,16160,16284,5088,124,PERF
42255317320000,PI,IP,001,15,16470,16594,5088,124,PERF
42255317320000,PI,IP,001,16,16720,16872,5088,152,PERF
42255317330000,PI,IP,001,1,10850,14669,4439,3819,PERF
42255317340000,PI,IP,001,1,9339,12110,3589,2771,PERF
42255317350000,PI,IP,001,1,10988,14878,4624,3890,PERF
42255317360000,PI,IP,001,1,13210,13521,5840,311,PERF
42255317360000,PI,IP,001,2,13650,13921,5840,271,PERF
42255317360000,PI,IP,001,3,14020,14321,5840,301,PERF
42255317360000,PI,IP,001,4,14415,14686,5840,271,PERF
42255317360000,PI,IP,001,5,14780,15031,5840,251,PERF
42255317360000,PI,IP,001,6,15130,15381,5840,251,PERF
42255317360000,PI,IP,001,7,15475,15715,5840,240,PERF
42255317360000,PI,IP,001,8,15815,16055,5840,240,PERF
42255317360000,PI,IP,001,9,16150,16395,5840,245,PERF
42255317360000,PI,IP,001,10,16490,16740,5840,250,PERF
42255317360000,PI,IP,001,11,16840,17085,5840,245,PERF
42255317360000,PI,IP,001,12,17181,17421,5840,240,PERF
42255317360000,PI,IP,001,13,17520,17766,5840,246,PERF
42255317360000,PI,IP,001,14,17860,18100,5840,240,PERF
42255317360000,PI,IP,001,15,18200,18456,5840,256,PERF
42255317370000,PI,IP,001,1,12930,17970,5709,5040,PERF
42255317380000,PI,IP,001,1,12935,16532,4168,3597,PERF
42255317390000,PI,IP,001,1,10146,13806,5509,3660,PERF
42255317410000,PI,IP,001,1,11015,15083,5258,4068,PERF
42255317430000,PI,IP,001,1,8795,12623,4533,3828,PERF
42255317440000,PI,IP,001,1,11950,12104,3192,154,PERF
42255317440000,PI,IP,001,2,12250,12404,3192,154,PERF
42255317440000,PI,IP,001,3,12475,12629,3192,154,PERF
42255317440000,PI,IP,001,4,12700,12854,3192,154,PERF
42255317440000,PI,IP,001,5,12925,13079,3192,154,PERF
42255317440000,PI,IP,001,6,13150,13304,3192,154,PERF
42255317440000,PI,IP,001,7,13375,13529,3192,154,PERF
42255317440000,PI,IP,001,8,13600,13754,3192,154,PERF
42255317440000,PI,IP,001,9,13825,13975,3192,150,PERF
42255317440000,PI,IP,001,10,14050,14204,3192,154,PERF
42255317440000,PI,IP,001,11,14275,14429,3192,154,PERF
42255317440000,PI,IP,001,12,14500,14620,3192,120,PERF
42255317440000,PI,IP,001,13,14674,14778,3192,104,PERF
42255317440000,PI,IP,001,14,14828,14982,3192,154,PERF
42255317450000,PI,IP,001,1,10600,15444,5240,4844,PERF
42255317460000,PI,IP,001,1,10823,13120,3056,2297,PERF
42255317470000,PI,IP,001,1,11900,12053,5835,153,PERF
42255317470000,PI,IP,001,2,12200,12353,5835,153,PERF
42255317470000,PI,IP,001,3,12500,12653,5835,153,PERF
42255317470000,PI,IP,001,4,12800,12953,5835,153,PERF
42255317470000,PI,IP,001,5,13100,13253,5835,153,PERF
42255317470000,PI,IP,001,6,13400,13553,5835,153,PERF
42255317470000,PI,IP,001,7,13697,13850,5835,153,PERF
42255317470000,PI,IP,001,8,13997,14150,5835,153,PERF
42255317470000,PI,IP,001,9,14297,14450,5835,153,PERF
42255317470000,PI,IP,001,10,14597,14750,5835,153,PERF
42255317470000,PI,IP,001,11,14897,15050,5835,153,PERF
42255317470000,PI,IP,001,12,15200,15350,5835,150,PERF
42255317470000,PI,IP,001,13,15950,16208,5835,258,PERF
42255317470000,PI,IP,001,14,16355,16358,5835,3,PERF
42255317480000,PI,IP,001,1,9277,9559,6198,282,PERF
42255317480000,PI,IP,001,2,9684,9966,6198,282,PERF
42255317480000,PI,IP,001,3,10091,10373,6198,282,PERF
42255317480000,PI,IP,001,4,10498,10780,6198,282,PERF
42255317480000,PI,IP,001,5,10905,11187,6198,282,PERF
42255317480000,PI,IP,001,6,11312,11594,6198,282,PERF
42255317480000,PI,IP,001,7,11719,12001,6198,282,PERF
42255317480000,PI,IP,001,8,12126,12408,6198,282,PERF
42255317480000,PI,IP,001,9,12533,12815,6198,282,PERF
42255317480000,PI,IP,001,10,12940,13222,6198,282,PERF
42255317480000,PI,IP,001,11,13347,13629,6198,282,PERF
42255317480000,PI,IP,001,12,13754,14036,6198,282,PERF
42255317480000,PI,IP,001,13,14161,14443,6198,282,PERF
42255317480000,PI,IP,001,14,14568,14850,6198,282,PERF
42255317490000,PI,IP,001,1,12900,17382,5182,4482,PERF
42255317500000,PI,IP,001,1,11076,14714,4311,3638,PERF
42255317510000,PI,IP,001,1,10950,16527,6048,5577,PERF
42255317520000,PI,IP,001,1,13013,17180,4967,4167,PERF
42255317530000,PI,IP,001,1,12532,12731,5051,199,PERF
42255317530000,PI,IP,001,2,12831,13030,5051,199,PERF
42255317530000,PI,IP,001,3,13130,13329,5051,199,PERF
42255317530000,PI,IP,001,4,13429,13628,5051,199,PERF
42255317530000,PI,IP,001,5,13728,13927,5051,199,PERF
42255317530000,PI,IP,001,6,14027,14226,5051,199,PERF
42255317530000,PI,IP,001,7,14326,14525,5051,199,PERF
42255317530000,PI,IP,001,8,14625,14824,5051,199,PERF
42255317530000,PI,IP,001,9,14924,15123,5051,199,PERF
42255317530000,PI,IP,001,10,15223,15422,5051,199,PERF
42255317530000,PI,IP,001,11,15522,15721,5051,199,PERF
42255317530000,PI,IP,001,12,15821,16020,5051,199,PERF
42255317560000,PI,IP,001,1,12914,17800,5488,4886,PERF
42255317570000,PI,IP,001,1,16050,16844,5241,794,PERF
42255317580000,PI,IP,001,1,10205,14135,4625,3930,PERF
42255317600000,PI,IP,001,1,11160,11254,5171,94,PERF
42255317600000,PI,IP,001,2,11650,11854,5171,204,PERF
42255317600000,PI,IP,001,3,11950,12154,5171,204,PERF
42255317600000,PI,IP,001,4,12250,12454,5171,204,PERF
42255317600000,PI,IP,001,5,12550,12754,5171,204,PERF
42255317600000,PI,IP,001,6,12850,13054,5171,204,PERF
42255317600000,PI,IP,001,7,13150,13354,5171,204,PERF
42255317600000,PI,IP,001,8,13450,13654,5171,204,PERF
42255317600000,PI,IP,001,9,13750,13954,5171,204,PERF
42255317600000,PI,IP,001,10,14050,14254,5171,204,PERF
42255317600000,PI,IP,001,11,14350,14554,5171,204,PERF
42255317600000,PI,IP,001,12,14650,14854,5171,204,PERF
42255317600000,PI,IP,001,13,14950,15154,5171,204,PERF
42255317600000,PI,IP,001,14,15251,15454,5171,203,PERF
42255317600000,PI,IP,001,15,15550,15754,5171,204,PERF
42255317600000,PI,IP,001,16,15850,16054,5171,204,PERF
42255317600000,PI,IP,001,17,16150,16348,5171,198,PERF
42255317610000,PI,IP,001,1,13378,17840,5026,4462,PERF
42255317620000,PI,IP,001,1,13140,17340,4829,4200,PERF
42255317630000,PI,IP,001,1,11130,16830,6730,5700,PERF
42255317660000,PI,IP,001,1,13202,17432,4551,4230,PERF
42255317670200,PI,IP,001,1,10060,10361,6150,301,PERF
42255317670200,PI,IP,001,2,10420,10721,6150,301,PERF
42255317670200,PI,IP,001,3,10780,11081,6150,301,PERF
42255317670200,PI,IP,001,4,11140,11441,6150,301,PERF
42255317670200,PI,IP,001,5,11500,11801,6150,301,PERF
42255317670200,PI,IP,001,6,11860,12161,6150,301,PERF
42255317670200,PI,IP,001,7,12220,12521,6150,301,PERF
42255317670200,PI,IP,001,8,12580,12881,6150,301,PERF
42255317670200,PI,IP,001,9,13276,13509,6150,233,PERF
42255317670200,PI,IP,001,10,13566,13799,6150,233,PERF
42255317670200,PI,IP,001,11,13856,14089,6150,233,PERF
42255317670200,PI,IP,001,12,14146,14379,6150,233,PERF
42255317670200,PI,IP,001,13,14436,14669,6150,233,PERF
42255317670200,PI,IP,001,14,14726,14959,6150,233,PERF
42255317670200,PI,IP,001,15,15016,15249,6150,233,PERF
42255317670200,PI,IP,001,16,15306,15482,6150,176,PERF
42255317680000,PI,IP,001,1,12091,15652,5293,3561,PERF
42255317700000,PI,IP,001,1,13395,17773,4742,4378,PERF
42255317710000,PI,IP,001,1,10820,15276,4991,4456,PERF
42255317730100,PI,IP,001,1,12852,18020,5564,5168,PERF
42255317750000,PI,IP,001,1,12600,18190,6003,5590,PERF
42255317770000,PI,IP,001,1,12795,18079,5662,5284,PERF
42255317780000,PI,IP,001,1,13221,13507,,286,PERF
42255317780000,PI,IP,001,2,13577,13855,,278,PERF
42255317780000,PI,IP,001,3,13934,14211,,277,PERF
42255317780000,PI,IP,001,4,14290,14576,,286,PERF
42255317780000,PI,IP,001,5,14647,14933,,286,PERF
42255317780000,PI,IP,001,6,15010,15289,,279,PERF
42255317780000,PI,IP,001,7,15370,15646,,276,PERF
42255317780000,PI,IP,001,8,15716,15980,,264,PERF
42255317780000,PI,IP,001,9,16238,16435,,197,PERF
42255317780000,PI,IP,001,10,16498,16759,,261,PERF
42255317780000,PI,IP,001,11,16823,17081,,258,PERF
42255317780000,PI,IP,001,12,17144,17409,,265,PERF
42255317780000,PI,IP,001,13,17468,17735,,267,PERF
42255317780000,PI,IP,001,14,17800,18061,,261,PERF
42255317800000,PI,IP,001,1,10950,11180,,230,PERF
42255317800000,PI,IP,001,2,11290,11530,,240,PERF
42255317800000,PI,IP,001,3,11955,12225,,270,PERF
42255317800000,PI,IP,001,4,12335,12615,,280,PERF
42255317800000,PI,IP,001,5,12725,13005,,280,PERF
42255317800000,PI,IP,001,6,13116,13395,,279,PERF
42255317800000,PI,IP,001,7,13505,13785,,280,PERF
42255317800000,PI,IP,001,8,13895,14175,,280,PERF
42255317800000,PI,IP,001,9,14286,14565,,279,PERF
42255317800000,PI,IP,001,10,14675,14955,,280,PERF
42255317800000,PI,IP,001,11,15065,15345,,280,PERF
42255317800000,PI,IP,001,12,15455,15736,,281,PERF
42255317810000,PI,IP,001,1,12750,12954,3576,204,PERF
42255317810000,PI,IP,001,2,13025,13229,3576,204,PERF
42255317810000,PI,IP,001,3,13300,13504,3576,204,PERF
42255317810000,PI,IP,001,4,13575,13775,3576,200,PERF
42255317810000,PI,IP,001,5,13850,14054,3576,204,PERF
42255317810000,PI,IP,001,6,14125,14329,3576,204,PERF
42255317810000,PI,IP,001,7,14400,14604,3576,204,PERF
42255317810000,PI,IP,001,8,14675,14879,3576,204,PERF
42255317810000,PI,IP,001,9,14950,15154,3576,204,PERF
42255317810000,PI,IP,001,10,15250,15454,3576,204,PERF
42255317810000,PI,IP,001,11,15525,15729,3576,204,PERF
42255317810000,PI,IP,001,12,15810,15974,3576,164,PERF
42255317830000,PI,IP,001,1,12999,17349,5112,4350,PERF
42255317840100,PI,IP,001,1,12853,17221,5602,4368,PERF
42255317850000,PI,IP,001,1,10125,14086,4565,3961,PERF
42255317860000,PI,IP,001,1,12819,17113,4566,4294,PERF
42255317880000,PI,IP,001,1,11024,11255,5772,231,PERF
42255317880000,PI,IP,001,2,11302,11533,5772,231,PERF
42255317880000,PI,IP,001,3,11580,11811,5772,231,PERF
42255317880000,PI,IP,001,4,11858,12089,5772,231,PERF
42255317880000,PI,IP,001,5,12136,12389,5772,253,PERF
42255317880000,PI,IP,001,6,12414,12645,5772,231,PERF
42255317880000,PI,IP,001,7,12692,12923,5772,231,PERF
42255317880000,PI,IP,001,8,12970,13201,5772,231,PERF
42255317880000,PI,IP,001,9,13248,13479,5772,231,PERF
42255317880000,PI,IP,001,10,13526,13757,5772,231,PERF
42255317880000,PI,IP,001,11,13804,14035,5772,231,PERF
42255317880000,PI,IP,001,12,14081,14313,5772,232,PERF
42255317880000,PI,IP,001,13,14360,14591,5772,231,PERF
42255317880000,PI,IP,001,14,14638,14869,5772,231,PERF
42255317880000,PI,IP,001,15,14916,15147,5772,231,PERF
42255317880000,PI,IP,001,16,15194,15425,5772,231,PERF
42255317890000,PI,IP,001,1,8860,13450,5103,4590,PERF
42255317900000,PI,IP,001,1,12654,12854,6015,200,PERF
42255317900000,PI,IP,001,2,12929,13133,6015,204,PERF
42255317900000,PI,IP,001,3,13204,13408,6015,204,PERF
42255317900000,PI,IP,001,4,13479,13683,6015,204,PERF
42255317900000,PI,IP,001,5,13754,13959,6015,205,PERF
42255317900000,PI,IP,001,6,14029,14233,6015,204,PERF
42255317900000,PI,IP,001,7,14304,14508,6015,204,PERF
42255317900000,PI,IP,001,8,14579,14783,6015,204,PERF
42255317900000,PI,IP,001,9,14854,15058,6015,204,PERF
42255317900000,PI,IP,001,10,15129,15333,6015,204,PERF
42255317900000,PI,IP,001,11,15405,15608,6015,203,PERF
42255317900000,PI,IP,001,12,15679,15883,6015,204,PERF
42255317900000,PI,IP,001,13,15954,16159,6015,205,PERF
42255317900000,PI,IP,001,14,16229,16433,6015,204,PERF
42255317900000,PI,IP,001,15,16504,16708,6015,204,PERF
42255317900000,PI,IP,001,16,16779,16893,6015,114,PERF
42255317900000,PI,IP,001,17,17050,17204,6015,154,PERF
42255317910000,PI,IP,001,1,12730,17098,5005,4368,PERF
42255317920000,PI,IP,001,1,12325,17204,5588,4879,PERF
42255317930000,PI,IP,001,1,13269,17443,5043,4174,PERF
42255317940000,PI,IP,001,1,12976,17207,4903,4231,PERF
42255317950000,PI,IP,001,1,10840,16340,6052,5500,PERF
42255317960000,PI,IP,002,1,12535,16754,4918,4219,PERF
42255317960000,PI,PT,001,1,12535,16754,4918,4219,PERF
42255317970000,PI,IP,001,1,13275,17854,5772,4579,PERF
42255317980000,PI,IP,001,1,12670,12924,5527,254,PERF
42255317980000,PI,IP,001,2,12975,13229,5527,254,PERF
42255317980000,PI,IP,001,3,13280,13534,5527,254,PERF
42255317980000,PI,IP,001,4,13585,13839,5527,254,PERF
42255317980000,PI,IP,001,5,13890,14144,5527,254,PERF
42255317980000,PI,IP,001,6,14195,14449,5527,254,PERF
42255317980000,PI,IP,001,7,14500,14754,5527,254,PERF
42255317980000,PI,IP,001,8,14805,15059,5527,254,PERF
42255317980000,PI,IP,001,9,15110,15364,5527,254,PERF
42255317980000,PI,IP,001,10,15415,15669,5527,254,PERF
42255317980000,PI,IP,001,11,15720,15974,5527,254,PERF
42255317980000,PI,IP,001,12,16025,16279,5527,254,PERF
42255317980000,PI,IP,001,13,16330,16584,5527,254,PERF
42255317980000,PI,IP,001,14,16635,16889,5527,254,PERF
42255317980000,PI,IP,001,15,16940,17194,5527,254,PERF
42255317980000,PI,IP,001,16,17245,17499,5527,254,PERF
42255317980000,PI,IP,001,17,17600,17804,5527,204,PERF
42255317990000,PI,IP,001,1,10967,16030,5705,5063,PERF
42255318000000,PI,IP,001,1,8550,12618,5249,4068,PERF
42255318010000,PI,IP,001,1,11550,11771,5929,221,PERF
42255318010000,PI,IP,001,2,11870,12151,5929,281,PERF
42255318010000,PI,IP,001,3,12250,12546,5929,296,PERF
42255318010000,PI,IP,001,4,12630,12916,5929,286,PERF
42255318010000,PI,IP,001,5,13000,13246,5929,246,PERF
42255318010000,PI,IP,001,6,13335,13596,5929,261,PERF
42255318010000,PI,IP,001,7,13690,13931,5929,241,PERF
42255318010000,PI,IP,001,8,14020,14271,5929,251,PERF
42255318010000,PI,IP,001,9,14360,14636,5929,276,PERF
42255318010000,PI,IP,001,10,14725,14971,5929,246,PERF
42255318010000,PI,IP,001,11,15055,15291,5929,236,PERF
42255318010000,PI,IP,001,12,15375,15611,5929,236,PERF
42255318010000,PI,IP,001,13,15700,15946,5929,246,PERF
42255318010000,PI,IP,001,14,16030,16276,5929,246,PERF
42255318010000,PI,IP,001,15,16370,16621,5929,251,PERF
42255318030000,PI,IP,001,1,9386,9632,5952,246,PERF
42255318030000,PI,IP,001,2,9757,10003,5952,246,PERF
42255318030000,PI,IP,001,3,10128,10374,5952,246,PERF
42255318030000,PI,IP,001,4,10499,10745,5952,246,PERF
42255318030000,PI,IP,001,5,10870,11116,5952,246,PERF
42255318030000,PI,IP,001,6,11241,11487,5952,246,PERF
42255318030000,PI,IP,001,7,11612,11858,5952,246,PERF
42255318030000,PI,IP,001,8,11983,12229,5952,246,PERF
42255318030000,PI,IP,001,9,12354,12600,5952,246,PERF
42255318030000,PI,IP,001,10,12775,13075,5952,300,PERF
42255318030000,PI,IP,001,11,13200,13500,5952,300,PERF
42255318030000,PI,IP,001,12,13625,13925,5952,300,PERF
42255318030000,PI,IP,001,13,14050,14350,5952,300,PERF
42255318040000,PI,IP,001,1,12620,18308,6103,5688,PERF
42255318050000,PI,IP,001,1,13610,19050,5825,5440,PERF
42255318060000,PI,IP,001,1,12870,13142,5268,272,PERF
42255318060000,PI,IP,001,2,13225,13498,5268,273,PERF
42255318060000,PI,IP,001,3,13576,13848,5268,272,PERF
42255318060000,PI,IP,001,4,13926,14199,5268,273,PERF
42255318060000,PI,IP,001,5,14277,14549,5268,272,PERF
42255318060000,PI,IP,001,6,14627,14899,5268,272,PERF
42255318060000,PI,IP,001,7,14977,15250,5268,273,PERF
42255318060000,PI,IP,001,8,15328,15600,5268,272,PERF
42255318060000,PI,IP,001,9,15698,15950,5268,252,PERF
42255318060000,PI,IP,001,10,16028,16301,5268,273,PERF
42255318060000,PI,IP,001,11,16375,16651,5268,276,PERF
42255318060000,PI,IP,001,12,16729,17002,5268,273,PERF
42255318060000,PI,IP,001,13,17080,17352,5268,272,PERF
42255318060000,PI,IP,001,14,17430,17700,5268,270,PERF
42255318080000,PI,IP,001,1,12892,17141,4752,4249,PERF
42255318090000,PI,IP,001,1,13396,17648,5361,4252,PERF
42255318100000,PI,IP,001,1,10925,13162,4715,2237,PERF
42255318110000,PI,IP,001,1,10500,15300,5872,4800,PERF
42255318120000,PI,IP,001,1,11196,11436,,240,PERF
42255318120000,PI,IP,001,2,11546,11786,,240,PERF
42255318120000,PI,IP,001,3,12086,12374,,288,PERF
42255318120000,PI,IP,001,4,12484,12776,,292,PERF
42255318120000,PI,IP,001,5,12887,13178,,291,PERF
42255318120000,PI,IP,001,6,13289,13580,,291,PERF
42255318120000,PI,IP,001,7,13691,13982,,291,PERF
42255318120000,PI,IP,001,8,14093,14384,,291,PERF
42255318120000,PI,IP,001,9,14495,14786,,291,PERF
42255318120000,PI,IP,001,10,14897,15188,,291,PERF
42255318120000,PI,IP,001,11,15298,15591,,293,PERF
42255318130000,PI,IP,001,1,10974,17216,7501,6242,PERF
42255318140000,PI,IP,001,1,10921,18023,7401,7102,PERF
42255318150000,PI,IP,001,1,12418,13909,3700,1491,PERF
42255318160000,PI,IP,001,1,11958,11960,5686,2,PERF
42255318160000,PI,IP,001,2,12032,12033,5686,1,PERF
42255318160000,PI,IP,001,3,12105,12107,5686,2,PERF
42255318160000,PI,IP,001,4,12179,12180,5686,1,PERF
42255318160000,PI,IP,001,5,12256,12258,5686,2,PERF
42255318160000,PI,IP,001,6,12330,12331,5686,1,PERF
42255318160000,PI,IP,001,7,12403,12405,5686,2,PERF
42255318160000,PI,IP,001,8,12477,12478,5686,1,PERF
42255318160000,PI,IP,001,9,12554,12556,5686,2,PERF
42255318160000,PI,IP,001,10,12628,12629,5686,1,PERF
42255318160000,PI,IP,001,11,12701,12703,5686,2,PERF
42255318160000,PI,IP,001,12,12775,12776,5686,1,PERF
42255318160000,PI,IP,001,13,12852,12854,5686,2,PERF
42255318160000,PI,IP,001,14,12926,12927,5686,1,PERF
42255318160000,PI,IP,001,15,12999,13001,5686,2,PERF
42255318160000,PI,IP,001,16,13073,13074,5686,1,PERF
42255318160000,PI,IP,001,17,13150,13152,5686,2,PERF
42255318160000,PI,IP,001,18,13224,13225,5686,1,PERF
42255318160000,PI,IP,001,19,13297,13299,5686,2,PERF
42255318160000,PI,IP,001,20,13371,13372,5686,1,PERF
42255318160000,PI,IP,001,21,13448,13450,5686,2,PERF
42255318160000,PI,IP,001,22,13522,13523,5686,1,PERF
42255318160000,PI,IP,001,23,13595,13597,5686,2,PERF
42255318160000,PI,IP,001,24,13669,13670,5686,1,PERF
42255318160000,PI,IP,001,25,13746,13748,5686,2,PERF
42255318160000,PI,IP,001,26,13820,13821,5686,1,PERF
42255318160000,PI,IP,001,27,13893,13895,5686,2,PERF
42255318160000,PI,IP,001,28,13967,13968,5686,1,PERF
42255318160000,PI,IP,001,29,14044,14046,5686,2,PERF
42255318160000,PI,IP,001,30,14118,14119,5686,1,PERF
42255318160000,PI,IP,001,31,14191,14193,5686,2,PERF
42255318160000,PI,IP,001,32,14265,14266,5686,1,PERF
42255318160000,PI,IP,001,33,14342,14344,5686,2,PERF
42255318160000,PI,IP,001,34,14416,14417,5686,1,PERF
42255318160000,PI,IP,001,35,14489,14491,5686,2,PERF
42255318160000,PI,IP,001,36,14563,14564,5686,1,PERF
42255318160000,PI,IP,001,37,14640,14642,5686,2,PERF
42255318160000,PI,IP,001,38,14714,14715,5686,1,PERF
42255318160000,PI,IP,001,39,14787,14789,5686,2,PERF
42255318160000,PI,IP,001,40,14861,14862,5686,1,PERF
42255318160000,PI,IP,001,41,14938,14940,5686,2,PERF
42255318160000,PI,IP,001,42,15012,15013,5686,1,PERF
42255318160000,PI,IP,001,43,15085,15087,5686,2,PERF
42255318160000,PI,IP,001,44,15159,15160,5686,1,PERF
42255318160000,PI,IP,001,45,15236,15238,5686,2,PERF
42255318160000,PI,IP,001,46,15310,15311,5686,1,PERF
42255318160000,PI,IP,001,47,15383,15385,5686,2,PERF
42255318160000,PI,IP,001,48,15457,15458,5686,1,PERF
42255318160000,PI,IP,001,49,15534,15536,5686,2,PERF
42255318160000,PI,IP,001,50,15608,15609,5686,1,PERF
42255318160000,PI,IP,001,51,15681,15683,5686,2,PERF
42255318160000,PI,IP,001,52,15755,15756,5686,1,PERF
42255318160000,PI,IP,001,53,15832,15834,5686,2,PERF
42255318160000,PI,IP,001,54,15906,15907,5686,1,PERF
42255318160000,PI,IP,001,55,15979,15981,5686,2,PERF
42255318160000,PI,IP,001,56,16053,16054,5686,1,PERF
42255318160000,PI,IP,001,57,16130,16132,5686,2,PERF
42255318160000,PI,IP,001,58,16204,16205,5686,1,PERF
42255318160000,PI,IP,001,59,16277,16279,5686,2,PERF
42255318160000,PI,IP,001,60,16351,16352,5686,1,PERF
42255318160000,PI,IP,001,61,16502,16503,5686,1,PERF
42255318160000,PI,IP,001,62,16575,16577,5686,2,PERF
42255318160000,PI,IP,001,63,16649,16650,5686,1,PERF
42255318160000,PI,IP,001,64,16726,16727,5686,1,PERF
42255318160000,PI,IP,001,65,16809,16810,5686,1,PERF
42255318160000,PI,IP,001,66,16892,16893,5686,1,PERF
42255318160000,PI,IP,001,67,16975,16976,5686,1,PERF
42255318170000,PI,IP,001,1,11840,16376,4826,4536,PERF
42255318180000,PI,IP,001,1,10743,15789,5457,5046,PERF
42255318190000,PI,IP,001,1,12734,17546,5110,4812,PERF
42255318200100,PI,IP,001,1,13447,17741,5341,4294,PERF
42255318210000,PI,IP,001,1,12380,17444,5575,5064,PERF
42255318230000,PI,IP,001,1,9285,9534,6023,249,PERF
42255318230000,PI,IP,001,2,9659,9908,6023,249,PERF
42255318230000,PI,IP,001,3,10033,10282,6023,249,PERF
42255318230000,PI,IP,001,4,10407,10656,6023,249,PERF
42255318230000,PI,IP,001,5,10781,11030,6023,249,PERF
42255318230000,PI,IP,001,6,11155,11404,6023,249,PERF
42255318230000,PI,IP,001,7,11529,11778,6023,249,PERF
42255318230000,PI,IP,001,8,11903,12152,6023,249,PERF
42255318230000,PI,IP,001,9,12277,12526,6023,249,PERF
42255318230000,PI,IP,001,10,12651,12900,6023,249,PERF
42255318240000,PI,IP,003,1,11875,16702,5726,4827,PERF
42255318240000,PI,PT,001,1,11875,16702,5726,4827,PERF
42255318240000,PI,PT,002,2,11875,16702,5726,4827,PERF
42255318250200,PI,IP,001,1,11340,11640,5138,300,PERF
42255318250200,PI,IP,001,2,11700,12000,5138,300,PERF
42255318250200,PI,IP,001,3,12060,12360,5138,300,PERF
42255318250200,PI,IP,001,4,12420,12720,5138,300,PERF
42255318250200,PI,IP,001,5,12780,13080,5138,300,PERF
42255318250200,PI,IP,001,6,13140,13440,5138,300,PERF
42255318250200,PI,IP,001,7,13500,13800,5138,300,PERF
42255318250200,PI,IP,001,8,13860,14160,5138,300,PERF
42255318250200,PI,IP,001,9,14420,14520,5138,100,PERF
42255318250200,PI,IP,001,10,14580,14880,5138,300,PERF
42255318250200,PI,IP,001,11,14940,15240,5138,300,PERF
42255318250200,PI,IP,001,12,15300,15600,5138,300,PERF
42255318260000,PI,IP,001,1,11504,11777,6353,273,PERF
42255318260000,PI,IP,001,2,11887,12160,6353,273,PERF
42255318260000,PI,IP,001,3,12270,12543,6353,273,PERF
42255318260000,PI,IP,001,4,12653,12926,6353,273,PERF
42255318260000,PI,IP,001,5,13036,13309,6353,273,PERF
42255318260000,PI,IP,001,6,13419,13692,6353,273,PERF
42255318260000,PI,IP,001,7,13802,14075,6353,273,PERF
42255318260000,PI,IP,001,8,14185,14458,6353,273,PERF
42255318260000,PI,IP,001,9,14568,14841,6353,273,PERF
42255318260000,PI,IP,001,10,14951,15224,6353,273,PERF
42255318260000,PI,IP,001,11,15334,15607,6353,273,PERF
42255318260000,PI,IP,001,12,15717,15990,6353,273,PERF
42255318280000,PI,IP,001,1,10940,14606,4321,3666,PERF
42255318290000,PI,IP,001,1,13312,17606,4863,4294,PERF
42255318300000,PI,IP,001,1,11360,11660,5653,300,PERF
42255318300000,PI,IP,001,2,11730,12030,5653,300,PERF
42255318300000,PI,IP,001,3,12100,12400,5653,300,PERF
42255318300000,PI,IP,001,4,12470,12770,5653,300,PERF
42255318300000,PI,IP,001,5,12840,13140,5653,300,PERF
42255318300000,PI,IP,001,6,13210,13510,5653,300,PERF
42255318300000,PI,IP,001,7,13580,13880,5653,300,PERF
42255318300000,PI,IP,001,8,13950,14250,5653,300,PERF
42255318300000,PI,IP,001,9,14320,14620,5653,300,PERF
42255318300000,PI,IP,001,10,14690,14990,5653,300,PERF
42255318300000,PI,IP,001,11,15060,15360,5653,300,PERF
42255318300000,PI,IP,001,12,15430,15730,5653,300,PERF
42255318300000,PI,IP,001,13,15800,16100,5653,300,PERF
42255318320000,PI,IP,001,1,10770,13195,3215,2425,PERF
42255318330000,PI,IP,001,1,12125,17254,5610,5129,PERF
42255318340000,PI,IP,001,1,11640,15917,4923,4277,PERF
42255318360000,PI,IP,001,1,12596,17556,5600,4960,PERF
42255318370000,PI,IP,001,1,9340,14090,5452,4750,PERF
42255318380000,PI,IP,001,1,11408,11410,5425,2,PERF
42255318380000,PI,IP,001,2,11483,11485,5425,2,PERF
42255318380000,PI,IP,001,3,11559,11561,5425,2,PERF
42255318380000,PI,IP,001,4,11644,11646,5425,2,PERF
42255318380000,PI,IP,001,5,11709,11711,5425,2,PERF
42255318380000,PI,IP,001,6,11775,11777,5425,2,PERF
42255318380000,PI,IP,001,7,11840,11842,5425,2,PERF
42255318380000,PI,IP,001,8,11925,11927,5425,2,PERF
42255318380000,PI,IP,001,9,11990,11992,5425,2,PERF
42255318380000,PI,IP,001,10,12056,12058,5425,2,PERF
42255318380000,PI,IP,001,11,12124,12126,5425,2,PERF
42255318380000,PI,IP,001,12,12206,12208,5425,2,PERF
42255318380000,PI,IP,001,13,12271,12273,5425,2,PERF
42255318380000,PI,IP,001,14,12337,12339,5425,2,PERF
42255318380000,PI,IP,001,15,12402,12404,5425,2,PERF
42255318380000,PI,IP,001,16,12487,12489,5425,2,PERF
42255318380000,PI,IP,001,17,12552,12554,5425,2,PERF
42255318380000,PI,IP,001,18,12622,12624,5425,2,PERF
42255318380000,PI,IP,001,19,12683,12685,5425,2,PERF
42255318380000,PI,IP,001,20,12768,12770,5425,2,PERF
42255318380000,PI,IP,001,21,12833,12835,5425,2,PERF
42255318380000,PI,IP,001,22,12899,12901,5425,2,PERF
42255318380000,PI,IP,001,23,12964,12966,5425,2,PERF
42255318380000,PI,IP,001,24,13049,13051,5425,2,PERF
42255318380000,PI,IP,001,25,13114,13116,5425,2,PERF
42255318380000,PI,IP,001,26,13180,13182,5425,2,PERF
42255318380000,PI,IP,001,27,13243,13245,5425,2,PERF
42255318380000,PI,IP,001,28,13330,13332,5425,2,PERF
42255318380000,PI,IP,001,29,13395,13397,5425,2,PERF
42255318380000,PI,IP,001,30,13461,13463,5425,2,PERF
42255318380000,PI,IP,001,31,13526,13528,5425,2,PERF
42255318380000,PI,IP,001,32,13611,13613,5425,2,PERF
42255318380000,PI,IP,001,33,13676,13678,5425,2,PERF
42255318380000,PI,IP,001,34,13744,13746,5425,2,PERF
42255318380000,PI,IP,001,35,13807,13809,5425,2,PERF
42255318380000,PI,IP,001,36,13892,13894,5425,2,PERF
42255318380000,PI,IP,001,37,13957,13959,5425,2,PERF
42255318380000,PI,IP,001,38,14023,14025,5425,2,PERF
42255318380000,PI,IP,001,39,14088,14090,5425,2,PERF
42255318380000,PI,IP,001,40,14173,14175,5425,2,PERF
42255318380000,PI,IP,001,41,14238,14240,5425,2,PERF
42255318380000,PI,IP,001,42,14368,14370,5425,2,PERF
42255318380000,PI,IP,001,43,14369,14371,5425,2,REPERF
42255318380000,PI,IP,001,44,14454,14456,5425,2,PERF
42255318380000,PI,IP,001,45,14519,14521,5425,2,PERF
42255318380000,PI,IP,001,46,14585,14587,5425,2,PERF
42255318380000,PI,IP,001,47,14650,14652,5425,2,PERF
42255318380000,PI,IP,001,48,14732,14734,5425,2,PERF
42255318380000,PI,IP,001,49,14800,14802,5425,2,PERF
42255318380000,PI,IP,001,50,14866,14868,5425,2,PERF
42255318380000,PI,IP,001,51,14931,14933,5425,2,PERF
42255318380000,PI,IP,001,52,15016,15018,5425,2,PERF
42255318380000,PI,IP,001,53,15081,15083,5425,2,PERF
42255318380000,PI,IP,001,54,15147,15149,5425,2,PERF
42255318380000,PI,IP,001,55,15212,15214,5425,2,PERF
42255318380000,PI,IP,001,56,15297,15299,5425,2,PERF
42255318380000,PI,IP,001,57,15362,15364,5425,2,PERF
42255318380000,PI,IP,001,58,15428,15430,5425,2,PERF
42255318380000,PI,IP,001,59,15493,15495,5425,2,PERF
42255318380000,PI,IP,001,60,15577,15579,5425,2,PERF
42255318380000,PI,IP,001,61,15640,15641,5425,1,PERF
42255318380000,PI,IP,001,62,15702,15704,5425,2,PERF
42255318380000,PI,IP,001,63,15765,15766,5425,1,PERF
42255318390100,PI,IP,001,1,12689,17255,4874,4566,PERF
42255318400000,PI,IP,001,1,11855,17904,,6049,PERF
42255318410000,PI,IP,001,1,12666,17700,6237,5034,PERF
42255318420000,PI,IP,001,1,11480,11707,6313,227,PERF
42255318420000,PI,IP,001,2,11817,12078,6313,261,PERF
42255318420000,PI,IP,001,3,12188,12449,6313,261,PERF
42255318420000,PI,IP,001,4,12559,12820,6313,261,PERF
42255318420000,PI,IP,001,5,12930,13191,6313,261,PERF
42255318420000,PI,IP,001,6,13301,13562,6313,261,PERF
42255318420000,PI,IP,001,7,13672,13933,6313,261,PERF
42255318420000,PI,IP,001,8,14043,14304,6313,261,PERF
42255318420000,PI,IP,001,9,14414,14675,6313,261,PERF
42255318420000,PI,IP,001,10,14785,15046,6313,261,PERF
42255318420000,PI,IP,001,11,15156,15417,6313,261,PERF
42255318420000,PI,IP,001,12,15527,15788,6313,261,PERF
42255318420000,PI,IP,001,13,15898,16159,6313,261,PERF
42255318420000,PI,IP,001,14,16269,16530,6313,261,PERF
42255318430000,PI,IP,001,1,12286,14592,4555,2306,PERF
42255318450000,PI,IP,001,1,12568,16923,5356,4355,PERF
42255318460000,PI,IP,001,1,13400,18932,5945,5532,PERF
42255318470000,PI,IP,001,1,12906,17570,5310,4664,PERF
42255318480000,PI,IP,001,1,11119,16423,10889,5304,PERF
42255318490000,PI,IP,001,1,11011,11247,5635,236,PERF
42255318490000,PI,IP,001,2,11327,11536,5635,209,PERF
42255318490000,PI,IP,001,3,11643,11879,5635,236,PERF
42255318490000,PI,IP,001,4,11959,12195,5635,236,PERF
42255318490000,PI,IP,001,5,12275,12511,5635,236,PERF
42255318490000,PI,IP,001,6,12591,12827,5635,236,PERF
42255318490000,PI,IP,001,7,12907,13143,5635,236,PERF
42255318490000,PI,IP,001,8,13223,13460,5635,237,PERF
42255318490000,PI,IP,001,9,13540,13776,5635,236,PERF
42255318490000,PI,IP,001,10,13856,14092,5635,236,PERF
42255318490000,PI,IP,001,11,14172,14408,5635,236,PERF
42255318490000,PI,IP,001,12,14488,14724,5635,236,PERF
42255318490000,PI,IP,001,13,14804,15040,5635,236,PERF
42255318490000,PI,IP,001,14,15120,15356,5635,236,PERF
42255318490000,PI,IP,001,15,15436,15672,5635,236,PERF
42255318490000,PI,IP,001,16,15752,15988,5635,236,PERF
42255318500000,PI,IP,001,1,11235,11452,5647,217,PERF
42255318500000,PI,IP,001,2,11532,11749,5647,217,PERF
42255318500000,PI,IP,001,3,11829,12046,5647,217,PERF
42255318500000,PI,IP,001,4,12126,12343,5647,217,PERF
42255318500000,PI,IP,001,5,12423,12639,5647,216,PERF
42255318500000,PI,IP,001,6,12719,12936,5647,217,PERF
42255318500000,PI,IP,001,7,13016,13233,5647,217,PERF
42255318500000,PI,IP,001,8,13313,13530,5647,217,PERF
42255318500000,PI,IP,001,9,13610,13827,5647,217,PERF
42255318500000,PI,IP,001,10,13907,14124,5647,217,PERF
42255318500000,PI,IP,001,11,14204,14421,5647,217,PERF
42255318500000,PI,IP,001,12,14501,14718,5647,217,PERF
42255318500000,PI,IP,001,13,14798,15014,5647,216,PERF
42255318500000,PI,IP,001,14,15094,15311,5647,217,PERF
42255318500000,PI,IP,001,15,15391,15608,5647,217,PERF
42255318500000,PI,IP,001,16,15688,15905,5647,217,PERF
42255318530000,PI,IP,001,1,11200,11418,5538,218,PERF
42255318530000,PI,IP,001,2,11498,11717,5538,219,PERF
42255318530000,PI,IP,001,3,11797,12015,5538,218,PERF
42255318530000,PI,IP,001,4,12095,12314,5538,219,PERF
42255318530000,PI,IP,001,5,12394,12612,5538,218,PERF
42255318530000,PI,IP,001,6,12692,12911,5538,219,PERF
42255318530000,PI,IP,001,7,12991,13209,5538,218,PERF
42255318530000,PI,IP,001,8,13289,13508,5538,219,PERF
42255318530000,PI,IP,001,9,13588,13806,5538,218,PERF
42255318530000,PI,IP,001,10,13886,14104,5538,218,PERF
42255318530000,PI,IP,001,11,14184,14403,5538,219,PERF
42255318530000,PI,IP,001,12,14483,14701,5538,218,PERF
42255318530000,PI,IP,001,13,14781,15000,5538,219,PERF
42255318530000,PI,IP,001,14,15080,15298,5538,218,PERF
42255318530000,PI,IP,001,15,15378,15597,5538,219,PERF
42255318530000,PI,IP,001,16,15677,15895,5538,218,PERF
42255318540000,PI,IP,001,1,11200,14604,3856,3404,PERF
42255318550000,PI,IP,001,1,11763,15842,5108,4079,PERF
42255318560000,PI,IP,001,1,11535,13963,5124,2428,PERF
42255318570000,PI,IP,003,1,11840,16102,5496,4262,PERF
42255318570000,PI,PT,001,1,11840,16102,5496,4262,PERF
42255318570000,PI,PT,002,2,11840,16102,5496,4262,PERF
42255318580000,PI,IP,001,1,12777,17219,5171,4442,PERF
42255318590000,PI,IP,001,1,12668,17193,5363,4525,PERF
42255318600000,PI,IP,001,1,12545,17283,5668,4738,PERF
42255318610000,PI,IP,001,1,13288,17722,,4434,PERF
42255318630000,PI,IP,001,1,13120,18302,6087,5182,PERF
42255318640000,PI,IP,001,1,11275,11593,4851,318,PERF
42255318650000,PI,IP,001,1,11160,16599,5862,5439,PERF
42255318670000,PI,IP,001,1,12920,13196,6268,276,PERF
42255318670000,PI,IP,001,2,13295,13581,6268,286,PERF
42255318670000,PI,IP,001,3,13675,13951,6268,276,PERF
42255318670000,PI,IP,001,4,14045,14321,6268,276,PERF
42255318670000,PI,IP,001,5,14420,14691,6268,271,PERF
42255318670000,PI,IP,001,6,14780,15051,6268,271,PERF
42255318670000,PI,IP,001,7,15135,15381,6268,246,PERF
42255318670000,PI,IP,001,8,15465,15721,6268,256,PERF
42255318670000,PI,IP,001,9,15815,16061,6268,246,PERF
42255318670000,PI,IP,001,10,16155,16411,6268,256,PERF
42255318670000,PI,IP,001,11,16500,16771,6268,271,PERF
42255318670000,PI,IP,001,12,16865,17151,6268,286,PERF
42255318670000,PI,IP,001,13,17245,17531,6268,286,PERF
42255318670000,PI,IP,001,14,17625,17896,6268,271,PERF
42255318670000,PI,IP,001,15,17985,18246,6268,261,PERF
42255318670000,PI,IP,001,16,18350,18591,6268,241,PERF
42255318680000,PI,IP,001,1,13792,18078,5190,4286,PERF
42255318690100,PI,IP,001,1,10760,15207,5012,4447,PERF
42255318700000,PI,IP,001,1,11635,15667,5324,4032,PERF
42255318710000,PI,IP,001,1,13050,18722,6484,5672,PERF
42255318720000,PI,IP,001,1,10669,16303,6148,5634,PERF
42255318730000,PI,IP,001,1,10718,15123,4904,4405,PERF
42255318740000,PI,IP,001,1,10432,14560,4670,4128,PERF
42255318750000,PI,IP,001,1,10645,16472,6754,5827,PERF
42255318760000,PI,IP,003,1,12023,18021,6770,5998,PERF
42255318760000,PI,PT,001,1,12023,12277,6770,254,PERF
42255318760000,PI,PT,001,2,12328,12582,6770,254,PERF
42255318760000,PI,PT,001,3,12633,12887,6770,254,PERF
42255318760000,PI,PT,001,4,12938,13192,6770,254,PERF
42255318760000,PI,PT,001,5,13243,13497,6770,254,PERF
42255318760000,PI,PT,001,6,13548,13802,6770,254,PERF
42255318760000,PI,PT,001,7,13853,14107,6770,254,PERF
42255318760000,PI,PT,001,8,14158,14412,6770,254,PERF
42255318760000,PI,PT,001,9,14463,14717,6770,254,PERF
42255318760000,PI,PT,001,10,14768,15022,6770,254,PERF
42255318760000,PI,PT,001,11,15073,15327,6770,254,PERF
42255318760000,PI,PT,001,12,15378,15632,6770,254,PERF
42255318760000,PI,PT,001,13,15648,15937,6770,289,PERF
42255318760000,PI,PT,001,14,15988,16242,6770,254,PERF
42255318760000,PI,PT,001,15,16293,16547,6770,254,PERF
42255318760000,PI,PT,001,16,16598,16852,6770,254,PERF
42255318760000,PI,PT,001,17,16903,17157,6770,254,PERF
42255318760000,PI,PT,001,18,17208,17462,6770,254,PERF
42255318760000,PI,PT,001,19,17513,17767,6770,254,PERF
42255318760000,PI,PT,001,20,17870,18021,6770,151,PERF
42255318770000,PI,IP,001,1,11427,11660,6272,233,PERF
42255318770000,PI,IP,001,2,11740,11972,6272,232,PERF
42255318770000,PI,IP,001,3,12052,12285,6272,233,PERF
42255318770000,PI,IP,001,4,12365,12597,6272,232,PERF
42255318770000,PI,IP,001,5,12677,12910,6272,233,PERF
42255318770000,PI,IP,001,6,12990,13222,6272,232,PERF
42255318770000,PI,IP,001,7,13302,13535,6272,233,PERF
42255318770000,PI,IP,001,8,13838,14070,6272,232,PERF
42255318770000,PI,IP,001,9,14150,14383,6272,233,PERF
42255318770000,PI,IP,001,10,14463,14695,6272,232,PERF
42255318770000,PI,IP,001,11,14775,15008,6272,233,PERF
42255318770000,PI,IP,001,12,15088,15320,6272,232,PERF
42255318770000,PI,IP,001,13,15400,15633,6272,233,PERF
42255318770000,PI,IP,001,14,15713,15945,6272,232,PERF
42255318770000,PI,IP,001,15,16025,16258,6272,233,PERF
42255318790000,PI,IP,001,1,10898,16438,6138,5540,PERF
42255318800000,PI,IP,001,1,13389,18365,5319,4976,PERF
42255318810000,PI,IP,001,1,10577,13901,4095,3324,PERF
42255318820000,PI,IP,001,1,12805,13024,5836,219,PERF
42255318820000,PI,IP,001,2,13104,13325,5836,221,PERF
42255318820000,PI,IP,001,3,13402,13624,5836,222,PERF
42255318820000,PI,IP,001,4,13701,13918,5836,217,PERF
42255318820000,PI,IP,001,5,14000,14218,5836,218,PERF
42255318820000,PI,IP,001,6,14298,14450,5836,152,PERF
42255318820000,PI,IP,001,7,14597,14816,5836,219,PERF
42255318820000,PI,IP,001,8,14896,15117,5836,221,PERF
42255318820000,PI,IP,001,9,15194,15416,5836,222,PERF
42255318820000,PI,IP,001,10,15493,15715,5836,222,PERF
42255318820000,PI,IP,001,11,15792,16013,5836,221,PERF
42255318820000,PI,IP,001,12,16090,16312,5836,222,PERF
42255318820000,PI,IP,001,13,16389,16611,5836,222,PERF
42255318820000,PI,IP,001,14,16688,16909,5836,221,PERF
42255318820000,PI,IP,001,15,16986,17208,5836,222,PERF
42255318820000,PI,IP,001,16,17285,17506,5836,221,PERF
42255318820000,PI,IP,001,17,17584,17804,5836,220,PERF
42255318820000,PI,IP,001,18,17882,18101,5836,219,PERF
42255318830000,PI,IP,001,1,12919,13142,5057,223,PERF
42255318830000,PI,IP,001,2,13222,13446,5057,224,PERF
42255318830000,PI,IP,001,3,13526,13749,5057,223,PERF
42255318830000,PI,IP,001,4,13829,14052,5057,223,PERF
42255318830000,PI,IP,001,5,14082,14308,5057,226,PERF
42255318830000,PI,IP,001,6,14435,14662,5057,227,PERF
42255318830000,PI,IP,001,7,14739,14965,5057,226,PERF
42255318830000,PI,IP,001,8,15042,15268,5057,226,PERF
42255318830000,PI,IP,001,9,15345,15571,5057,226,PERF
42255318830000,PI,IP,001,10,15648,15872,5057,224,PERF
42255318830000,PI,IP,001,11,15954,16175,5057,221,PERF
42255318830000,PI,IP,001,12,16255,16478,5057,223,PERF
42255318830000,PI,IP,001,13,16558,16784,5057,226,PERF
42255318830000,PI,IP,001,14,16861,17087,5057,226,PERF
42255318830000,PI,IP,001,15,17165,17388,5057,223,PERF
42255318840100,PI,IP,001,1,12901,16696,4609,3795,PERF
42255318850100,PI,IP,001,1,12838,17280,4853,4442,PERF
42255318860000,PI,IP,001,1,10992,15858,5877,4866,PERF
42255318870000,PI,IP,001,1,11156,17194,6607,6038,PERF
42255318900000,PI,IP,003,1,11826,15738,4699,3912,PERF
42255318900000,PI,PT,001,1,11826,15738,4699,3912,PERF
42255318900000,PI,PT,002,2,11826,15738,4699,3912,PERF
42255318910000,PI,IP,005,1,11914,17044,6489,5130,PERF
42255318910000,PI,PT,001,1,11914,12166,6489,252,PERF
42255318910000,PI,PT,001,2,12219,12471,6489,252,PERF
42255318910000,PI,PT,001,3,12524,12776,6489,252,PERF
42255318910000,PI,PT,001,4,12829,13081,6489,252,PERF
42255318910000,PI,PT,001,5,13134,13386,6489,252,PERF
42255318910000,PI,PT,001,6,13439,13691,6489,252,PERF
42255318910000,PI,PT,001,7,13744,13996,6489,252,PERF
42255318910000,PI,PT,001,8,14049,14301,6489,252,PERF
42255318910000,PI,PT,001,9,14356,14606,6489,250,PERF
42255318910000,PI,PT,001,10,14659,14911,6489,252,PERF
42255318910000,PI,PT,001,11,14964,15216,6489,252,PERF
42255318910000,PI,PT,001,12,15269,15551,6489,282,PERF
42255318910000,PI,PT,001,13,15574,15826,6489,252,PERF
42255318910000,PI,PT,001,14,15879,16131,6489,252,PERF
42255318910000,PI,PT,001,15,16184,16436,6489,252,PERF
42255318910000,PI,PT,001,16,16489,16741,6489,252,PERF
42255318910000,PI,PT,001,17,16790,17044,6489,254,PERF
42255318910000,PI,PT,002,18,11914,17044,6489,5130,PERF
42255318910000,PI,PT,003,19,11914,17044,6489,5130,PERF
42255318910000,PI,PT,004,20,11914,17044,6489,5130,PERF
42255318920000,PI,IP,001,1,10839,15438,5171,4599,PERF
42255318930100,PI,IP,001,1,12043,17282,5930,5239,PERF
42255318950000,PI,IP,001,1,13423,17973,5885,4550,PERF
42255318960000,PI,IP,001,1,10884,11082,4829,198,PERF
42255318960000,PI,IP,001,2,11162,11408,4829,246,PERF
42255318960000,PI,IP,001,3,11488,11735,4829,247,PERF
42255318960000,PI,IP,001,4,11935,12150,4829,215,PERF
42255318960000,PI,IP,001,5,12190,12437,4829,247,PERF
42255318960000,PI,IP,001,6,12517,12764,4829,247,PERF
42255318960000,PI,IP,001,7,12844,13090,4829,246,PERF
42255318960000,PI,IP,001,8,13170,13417,4829,247,PERF
42255318960000,PI,IP,001,9,13497,13744,4829,247,PERF
42255318960000,PI,IP,001,10,13824,14070,4829,246,PERF
42255318960000,PI,IP,001,11,14150,14397,4829,247,PERF
42255318960000,PI,IP,001,12,14477,14723,4829,246,PERF
42255318960000,PI,IP,001,13,14825,15055,4829,230,PERF
42255318970000,PI,IP,001,1,10964,15670,5389,4706,PERF
42255318980000,PI,IP,001,1,10307,13300,3356,2993,PERF
42255318990000,PI,IP,001,1,11110,11350,5956,240,PERF
42255318990000,PI,IP,001,2,11639,11879,5956,240,PERF
42255318990000,PI,IP,001,3,11964,12204,5956,240,PERF
42255318990000,PI,IP,001,4,12289,12512,5956,223,PERF
42255318990000,PI,IP,001,5,12597,12734,5956,137,PERF
42255318990000,PI,IP,001,6,12819,13041,5956,222,PERF
42255318990000,PI,IP,001,7,13126,13349,5956,223,PERF
42255318990000,PI,IP,001,8,13434,13656,5956,222,PERF
42255318990000,PI,IP,001,9,13741,13963,5956,222,PERF
42255318990000,PI,IP,001,10,14048,14271,5956,223,PERF
42255318990000,PI,IP,001,11,14356,14578,5956,222,PERF
42255318990000,PI,IP,001,12,14663,14885,5956,222,PERF
42255318990000,PI,IP,001,13,14970,15193,5956,223,PERF
42255318990000,PI,IP,001,14,15299,15505,5956,206,PERF
42255319000000,PI,IP,001,1,12653,17683,5165,5030,PERF
42255319020000,PI,IP,001,1,12609,16791,5234,4182,PERF
42255319030100,PI,IP,001,1,12485,16139,4812,3654,PERF
42255319040000,PI,IP,001,1,11370,11625,5648,255,PERF
42255319040000,PI,IP,001,2,11800,12045,5648,245,PERF
42255319040000,PI,IP,001,3,12120,12375,5648,255,PERF
42255319040000,PI,IP,001,4,12455,12710,5648,255,PERF
42255319040000,PI,IP,001,5,12790,13045,5648,255,PERF
42255319040000,PI,IP,001,6,13125,13380,5648,255,PERF
42255319040000,PI,IP,001,7,13635,13890,5648,255,PERF
42255319040000,PI,IP,001,8,14073,14328,5648,255,PERF
42255319040000,PI,IP,001,9,14408,14663,5648,255,PERF
42255319040000,PI,IP,001,10,14743,14988,5648,245,PERF
42255319040000,PI,IP,001,11,15078,15333,5648,255,PERF
42255319040000,PI,IP,001,12,15413,15688,5648,275,PERF
42255319050000,PI,IP,001,1,12595,17216,5969,4621,PERF
42255319070000,PI,IP,001,1,13250,18375,,5125,PERF
42255319080000,PI,IP,001,1,12838,17462,4929,4624,PERF
42255319100000,PI,IP,001,1,12345,17516,6026,5171,PERF
42255319110000,PI,IP,001,1,12900,17367,4922,4467,PERF
42255319120000,PI,IP,001,1,12461,17638,6060,5177,PERF
42255319130000,PI,IP,001,1,12458,17351,5970,4893,PERF
42255319140000,PI,IP,001,1,12895,17502,5463,4607,PERF
42255319150000,PI,IP,001,1,12888,17451,5432,4563,PERF
42255319160000,PI,IP,001,1,11628,16852,5741,5224,PERF
42255319180000,PI,IP,001,1,10746,17693,7380,6947,PERF
42255319190000,PI,IP,001,1,12772,17190,5244,4418,PERF
42255319200000,PI,IP,001,1,10518,12888,3059,2370,PERF
42255319210000,PI,IP,001,1,13153,18179,6059,5026,PERF
42255319220000,PI,IP,001,1,13310,17302,4389,3992,PERF
42255319230000,PI,IP,001,1,13334,13588,4741,254,PERF
42255319230000,PI,IP,001,2,13639,13893,4741,254,PERF
42255319230000,PI,IP,001,3,13944,14144,4741,200,PERF
42255319230000,PI,IP,001,4,14249,14503,4741,254,PERF
42255319230000,PI,IP,001,5,14554,14808,4741,254,PERF
42255319230000,PI,IP,001,6,14859,15113,4741,254,PERF
42255319230000,PI,IP,001,7,15165,15418,4741,253,PERF
42255319230000,PI,IP,001,8,15469,15723,4741,254,PERF
42255319230000,PI,IP,001,9,15774,16028,4741,254,PERF
42255319230000,PI,IP,001,10,16079,16333,4741,254,PERF
42255319230000,PI,IP,001,11,16990,17192,4741,202,PERF
42255319240000,PI,IP,001,1,12042,12294,6647,252,PERF
42255319240000,PI,IP,001,2,12347,12599,6647,252,PERF
42255319240000,PI,IP,001,3,12652,12904,6647,252,PERF
42255319240000,PI,IP,001,4,12957,13209,6647,252,PERF
42255319240000,PI,IP,001,5,13262,13514,6647,252,PERF
42255319240000,PI,IP,001,6,13567,13819,6647,252,PERF
42255319240000,PI,IP,001,7,13872,14124,6647,252,PERF
42255319240000,PI,IP,001,8,14177,14429,6647,252,PERF
42255319240000,PI,IP,001,9,14482,14734,6647,252,PERF
42255319240000,PI,IP,001,10,14789,15039,6647,250,PERF
42255319240000,PI,IP,001,11,15092,15344,6647,252,PERF
42255319240000,PI,IP,001,12,15397,15649,6647,252,PERF
42255319240000,PI,IP,001,13,15702,15954,6647,252,PERF
42255319240000,PI,IP,001,14,16007,16259,6647,252,PERF
42255319240000,PI,IP,001,15,16312,16564,6647,252,PERF
42255319240000,PI,IP,001,16,16617,16819,6647,202,PERF
42255319240000,PI,IP,001,17,16922,17174,6647,252,PERF
42255319240000,PI,IP,001,18,17277,17479,6647,202,PERF
42255319240000,PI,IP,001,19,17532,17784,6647,252,PERF
42255319240000,PI,IP,001,20,17750,17952,6647,202,PERF
42255319250000,PI,IP,001,1,12984,13236,5392,252,PERF
42255319250000,PI,IP,001,2,13284,13536,5392,252,PERF
42255319250000,PI,IP,001,3,13584,13836,5392,252,PERF
42255319250000,PI,IP,001,4,13884,14136,5392,252,PERF
42255319250000,PI,IP,001,5,14184,14436,5392,252,PERF
42255319250000,PI,IP,001,6,14484,14736,5392,252,PERF
42255319250000,PI,IP,001,7,14784,15036,5392,252,PERF
42255319250000,PI,IP,001,8,15084,15211,5392,127,PERF
42255319250000,PI,IP,001,9,16484,16506,5392,22,PERF
42255319270000,PI,IP,001,1,10213,15449,5778,5236,PERF
42255319280000,PI,IP,001,1,11027,15783,5607,4756,PERF
42255319300000,PI,IP,001,1,12922,13137,5575,215,PERF
42255319300000,PI,IP,001,2,13217,13432,5575,215,PERF
42255319300000,PI,IP,001,3,13512,13727,5575,215,PERF
42255319300000,PI,IP,001,4,13807,14022,5575,215,PERF
42255319300000,PI,IP,001,5,14102,14317,5575,215,PERF
42255319300000,PI,IP,001,6,14397,14612,5575,215,PERF
42255319300000,PI,IP,001,7,14692,14907,5575,215,PERF
42255319300000,PI,IP,001,8,14987,15202,5575,215,PERF
42255319300000,PI,IP,001,9,15282,15496,5575,214,PERF
42255319300000,PI,IP,001,10,15576,15791,5575,215,PERF
42255319300000,PI,IP,001,11,15871,16086,5575,215,PERF
42255319300000,PI,IP,001,12,16166,16381,5575,215,PERF
42255319300000,PI,IP,001,13,16461,16676,5575,215,PERF
42255319300000,PI,IP,001,14,16756,16971,5575,215,PERF
42255319300000,PI,IP,001,15,17051,17266,5575,215,PERF
42255319300000,PI,IP,001,16,17346,17561,5575,215,PERF
42255319310000,PI,IP,001,1,13394,17984,5090,4590,PERF
42255319320000,PI,IP,001,1,12722,12933,5194,211,PERF
42255319320000,PI,IP,001,2,13013,13225,5194,212,PERF
42255319320000,PI,IP,001,3,13305,13516,5194,211,PERF
42255319320000,PI,IP,001,4,13596,13807,5194,211,PERF
42255319320000,PI,IP,001,5,13887,14099,5194,212,PERF
42255319320000,PI,IP,001,6,14179,14390,5194,211,PERF
42255319320000,PI,IP,001,7,14470,14681,5194,211,PERF
42255319320000,PI,IP,001,8,14761,14973,5194,212,PERF
42255319320000,PI,IP,001,9,15053,15264,5194,211,PERF
42255319320000,PI,IP,001,10,15344,15555,5194,211,PERF
42255319320000,PI,IP,001,11,15635,15846,5194,211,PERF
42255319320000,PI,IP,001,12,15926,16138,5194,212,PERF
42255319320000,PI,IP,001,13,16218,16429,5194,211,PERF
42255319320000,PI,IP,001,14,16509,16720,5194,211,PERF
42255319320000,PI,IP,001,15,16800,17012,5194,212,PERF
42255319320000,PI,IP,001,16,17092,17303,5194,211,PERF
42255319330000,PI,IP,001,1,12583,17239,5806,4656,PERF
42255319340100,PI,IP,001,1,12492,17075,5854,4583,PERF
42255319350000,PI,IP,001,1,12850,13060,5149,210,PERF
42255319350000,PI,IP,001,2,13140,13350,5149,210,PERF
42255319350000,PI,IP,001,3,13430,13640,5149,210,PERF
42255319350000,PI,IP,001,4,13720,13930,5149,210,PERF
42255319350000,PI,IP,001,5,14010,14220,5149,210,PERF
42255319350000,PI,IP,001,6,14300,14510,5149,210,PERF
42255319350000,PI,IP,001,7,14590,14800,5149,210,PERF
42255319350000,PI,IP,001,8,14880,15091,5149,211,PERF
42255319350000,PI,IP,001,9,15171,15381,5149,210,PERF
42255319350000,PI,IP,001,10,15461,15671,5149,210,PERF
42255319350000,PI,IP,001,11,15751,15961,5149,210,PERF
42255319350000,PI,IP,001,12,16041,16251,5149,210,PERF
42255319350000,PI,IP,001,13,16331,16541,5149,210,PERF
42255319350000,PI,IP,001,14,16621,16831,5149,210,PERF
42255319350000,PI,IP,001,15,16911,17121,5149,210,PERF
42255319350000,PI,IP,001,16,17201,17411,5149,210,PERF
42255319360000,PI,IP,001,1,12863,18028,5454,5165,PERF
42255319370000,PI,IP,001,1,13118,18374,6133,5256,PERF
42255319380000,PI,IP,001,1,12750,18117,5591,5367,PERF
42255319390000,PI,IP,001,1,10490,15000,4756,4510,PERF
42255319400000,PI,IP,001,1,10532,14647,4570,4115,PERF
42255319410000,PI,IP,001,1,10822,15506,5564,4684,PERF
42255319430000,PI,IP,001,1,9083,13254,4971,4171,PERF
42255319440000,PI,IP,001,1,9097,12873,4474,3776,PERF
42255319470000,PI,IP,001,1,10430,15657,6172,5227,PERF
42255319480000,PI,IP,001,1,13010,17382,4690,4372,PERF
42255319490000,PI,IP,001,1,13550,19953,6564,6403,PERF
42255319500000,PI,IP,001,1,13180,19330,6726,6150,PERF
42255319510000,PI,IP,001,1,10829,14370,4253,3541,PERF
42255319520000,PI,IP,001,1,9548,9763,5639,215,PERF
42255319520000,PI,IP,001,2,9843,10059,5639,216,PERF
42255319520000,PI,IP,001,3,10139,10354,5639,215,PERF
42255319520000,PI,IP,001,4,10434,10649,5639,215,PERF
42255319520000,PI,IP,001,5,10729,10944,5639,215,PERF
42255319520000,PI,IP,001,6,11024,11240,5639,216,PERF
42255319520000,PI,IP,001,7,11320,11535,5639,215,PERF
42255319520000,PI,IP,001,8,11615,11830,5639,215,PERF
42255319520000,PI,IP,001,9,11910,12125,5639,215,PERF
42255319520000,PI,IP,001,10,12205,12421,5639,216,PERF
42255319520000,PI,IP,001,11,12501,12716,5639,215,PERF
42255319520000,PI,IP,001,12,12796,13011,5639,215,PERF
42255319520000,PI,IP,001,13,13091,13306,5639,215,PERF
42255319520000,PI,IP,001,14,13386,13602,5639,216,PERF
42255319520000,PI,IP,001,15,13682,13897,5639,215,PERF
42255319520000,PI,IP,001,16,13977,14192,5639,215,PERF
42255319530000,PI,IP,001,1,13250,13441,5163,191,PERF
42255319530000,PI,IP,001,2,13521,13713,5163,192,PERF
42255319530000,PI,IP,001,3,13793,13984,5163,191,PERF
42255319530000,PI,IP,001,4,14064,14255,5163,191,PERF
42255319530000,PI,IP,001,5,14335,14526,5163,191,PERF
42255319530000,PI,IP,001,6,14606,14798,5163,192,PERF
42255319530000,PI,IP,001,7,14878,15069,5163,191,PERF
42255319530000,PI,IP,001,8,15149,15340,5163,191,PERF
42255319530000,PI,IP,001,9,15420,15611,5163,191,PERF
42255319530000,PI,IP,001,10,15691,15883,5163,192,PERF
42255319530000,PI,IP,001,11,15963,16154,5163,191,PERF
42255319530000,PI,IP,001,12,16234,16425,5163,191,PERF
42255319530000,PI,IP,001,13,16505,16696,5163,191,PERF
42255319530000,PI,IP,001,14,16776,16968,5163,192,PERF
42255319530000,PI,IP,001,15,17048,17239,5163,191,PERF
42255319530000,PI,IP,001,16,17319,17510,5163,191,PERF
42255319540000,PI,IP,001,1,13155,13352,6162,197,PERF
42255319540000,PI,IP,001,2,13427,13623,6162,196,PERF
42255319540000,PI,IP,001,3,13698,13895,6162,197,PERF
42255319540000,PI,IP,001,4,13970,14166,6162,196,PERF
42255319540000,PI,IP,001,5,14241,14438,6162,197,PERF
42255319540000,PI,IP,001,6,14513,14709,6162,196,PERF
42255319540000,PI,IP,001,7,14784,14981,6162,197,PERF
42255319540000,PI,IP,001,8,15056,15252,6162,196,PERF
42255319540000,PI,IP,001,9,15327,15524,6162,197,PERF
42255319540000,PI,IP,001,10,15599,15795,6162,196,PERF
42255319540000,PI,IP,001,11,15870,16067,6162,197,PERF
42255319540000,PI,IP,001,12,16142,16338,6162,196,PERF
42255319540000,PI,IP,001,13,16413,16610,6162,197,PERF
42255319540000,PI,IP,001,14,16685,16881,6162,196,PERF
42255319540000,PI,IP,001,15,16956,17153,6162,197,PERF
42255319540000,PI,IP,001,16,17228,17424,6162,196,PERF
42255319540000,PI,IP,001,17,17499,17696,6162,197,PERF
42255319540000,PI,IP,001,18,17771,17967,6162,196,PERF
42255319540000,PI,IP,001,19,18042,18239,6162,197,PERF
42255319540000,PI,IP,001,20,18314,18510,6162,196,PERF
42255319550000,PI,IP,001,1,10780,14028,3929,3248,PERF
42255319570000,PI,IP,001,1,13150,18822,6152,5672,PERF
42255319590000,PI,IP,001,1,12038,17641,6790,5603,PERF
42255319600000,PI,IP,004,1,12347,17176,5254,4829,PERF
42255319600000,PI,PT,001,1,12347,12599,5254,252,PERF
42255319600000,PI,PT,001,2,12652,12904,5254,252,PERF
42255319600000,PI,PT,001,3,12957,13209,5254,252,PERF
42255319600000,PI,PT,001,4,13262,13514,5254,252,PERF
42255319600000,PI,PT,001,5,13567,13819,5254,252,PERF
42255319600000,PI,PT,001,6,13872,14124,5254,252,PERF
42255319600000,PI,PT,001,7,14177,14429,5254,252,PERF
42255319600000,PI,PT,001,8,14482,14734,5254,252,PERF
42255319600000,PI,PT,001,9,14787,15039,5254,252,PERF
42255319600000,PI,PT,001,10,15092,15344,5254,252,PERF
42255319600000,PI,PT,001,11,15397,15649,5254,252,PERF
42255319600000,PI,PT,001,12,15702,15954,5254,252,PERF
42255319600000,PI,PT,001,13,16007,16259,5254,252,PERF
42255319600000,PI,PT,001,14,16312,16564,5254,252,PERF
42255319600000,PI,PT,001,15,16617,16869,5254,252,PERF
42255319600000,PI,PT,001,16,16924,17176,5254,252,PERF
42255319600000,PI,PT,002,17,12347,17176,5254,4829,PERF
42255319600000,PI,PT,003,18,12347,17176,5254,4829,PERF
42255319610000,PI,IP,001,1,12701,18507,6421,5806,PERF
42255319620000,PI,IP,001,1,13380,19052,5926,5672,PERF
42255319630000,PI,IP,001,1,11540,11748,6405,208,PERF
42255319630000,PI,IP,001,2,11855,12091,6405,236,PERF
42255319630000,PI,IP,001,3,12171,12406,6405,235,PERF
42255319630000,PI,IP,001,4,12643,12743,6405,100,PERF
42255319630000,PI,IP,001,5,12782,13032,6405,250,PERF
42255319630000,PI,IP,001,6,13117,13353,6405,236,PERF
42255319630000,PI,IP,001,7,13433,13668,6405,235,PERF
42255319630000,PI,IP,001,8,13748,13984,6405,236,PERF
42255319630000,PI,IP,001,9,14064,14229,6405,165,PERF
42255319630000,PI,IP,001,10,14379,14614,6405,235,PERF
42255319630000,PI,IP,001,11,14694,14930,6405,236,PERF
42255319630000,PI,IP,001,12,15010,15240,6405,230,PERF
42255319630000,PI,IP,001,13,15325,15561,6405,236,PERF
42255319630000,PI,IP,001,14,15641,15876,6405,235,PERF
42255319630000,PI,IP,001,15,15956,16192,6405,236,PERF
42255319630000,PI,IP,001,16,16272,16507,6405,235,PERF
42255319640000,PI,IP,001,1,11153,11364,3775,211,PERF
42255319640000,PI,IP,001,2,11439,11650,3775,211,PERF
42255319640000,PI,IP,001,3,11725,11936,3775,211,PERF
42255319640000,PI,IP,001,4,12011,12222,3775,211,PERF
42255319640000,PI,IP,001,5,12297,12508,3775,211,PERF
42255319640000,PI,IP,001,6,12583,12793,3775,210,PERF
42255319640000,PI,IP,001,7,12868,13079,3775,211,PERF
42255319640000,PI,IP,001,8,13154,13365,3775,211,PERF
42255319640000,PI,IP,001,9,13440,13651,3775,211,PERF
42255319640000,PI,IP,001,10,13726,13937,3775,211,PERF
42255319640000,PI,IP,001,11,14012,14223,3775,211,PERF
42255319650100,PI,IP,001,1,12960,13260,5870,300,PERF
42255319650100,PI,IP,001,2,13330,13630,5870,300,PERF
42255319650100,PI,IP,001,3,13700,14000,5870,300,PERF
42255319650100,PI,IP,001,4,14070,14370,5870,300,PERF
42255319650100,PI,IP,001,5,14440,14740,5870,300,PERF
42255319650100,PI,IP,001,6,14810,15110,5870,300,PERF
42255319650100,PI,IP,001,7,15180,15480,5870,300,PERF
42255319650100,PI,IP,001,8,15550,15850,5870,300,PERF
42255319650100,PI,IP,001,9,15920,16220,5870,300,PERF
42255319650100,PI,IP,001,10,16290,16590,5870,300,PERF
42255319650100,PI,IP,001,11,16660,16960,5870,300,PERF
42255319650100,PI,IP,001,12,17030,17330,5870,300,PERF
42255319650100,PI,IP,001,13,17400,17700,5870,300,PERF
42255319660000,PI,IP,001,1,12702,12992,5856,290,PERF
42255319660000,PI,IP,001,2,13062,13352,5856,290,PERF
42255319660000,PI,IP,001,3,13422,13712,5856,290,PERF
42255319660000,PI,IP,001,4,13782,14072,5856,290,PERF
42255319660000,PI,IP,001,5,14142,14432,5856,290,PERF
42255319660000,PI,IP,001,6,14502,14792,5856,290,PERF
42255319660000,PI,IP,001,7,14862,15152,5856,290,PERF
42255319660000,PI,IP,001,8,15222,15512,5856,290,PERF
42255319660000,PI,IP,001,9,15582,15872,5856,290,PERF
42255319660000,PI,IP,001,10,15942,16232,5856,290,PERF
42255319660000,PI,IP,001,11,16302,16592,5856,290,PERF
42255319660000,PI,IP,001,12,16662,16952,5856,290,PERF
42255319660000,PI,IP,001,13,17022,17312,5856,290,PERF
42255319660000,PI,IP,001,14,17382,17672,5856,290,PERF
42255319670100,PI,IP,001,1,11972,17317,6305,5345,PERF
42255319680000,PI,IP,001,1,11165,16247,5862,5082,PERF
42255319690000,PI,IP,001,1,11077,11288,4862,211,PERF
42255319690000,PI,IP,001,2,11368,11580,4862,212,PERF
42255319690000,PI,IP,001,3,11660,11871,4862,211,PERF
42255319690000,PI,IP,001,4,11951,12163,4862,212,PERF
42255319690000,PI,IP,001,5,12243,12454,4862,211,PERF
42255319690000,PI,IP,001,6,12534,12746,4862,212,PERF
42255319690000,PI,IP,001,7,12826,13037,4862,211,PERF
42255319690000,PI,IP,001,8,13117,13329,4862,212,PERF
42255319690000,PI,IP,001,9,13409,13620,4862,211,PERF
42255319690000,PI,IP,001,10,13700,13912,4862,212,PERF
42255319690000,PI,IP,001,11,13992,14203,4862,211,PERF
42255319690000,PI,IP,001,12,14283,14495,4862,212,PERF
42255319690000,PI,IP,001,13,14575,14786,4862,211,PERF
42255319690000,PI,IP,001,14,14866,15078,4862,212,PERF
42255319690000,PI,IP,001,15,15158,15369,4862,211,PERF
42255319700000,PI,IP,001,1,12765,17293,5554,4528,PERF
42255319720000,PI,IP,001,1,11115,16612,6653,5497,PERF
42255319730000,PI,IP,001,1,11130,11378,6093,248,PERF
42255319730000,PI,IP,001,2,11458,11706,6093,248,PERF
42255319730000,PI,IP,001,3,11786,12034,6093,248,PERF
42255319730000,PI,IP,001,4,12114,12361,6093,247,PERF
42255319730000,PI,IP,001,5,12441,12689,6093,248,PERF
42255319730000,PI,IP,001,6,12769,13017,6093,248,PERF
42255319730000,PI,IP,001,7,13097,13345,6093,248,PERF
42255319730000,PI,IP,001,8,13420,13620,6093,200,PERF
42255319730000,PI,IP,001,9,13695,13894,6093,199,PERF
42255319730000,PI,IP,001,10,14097,14346,6093,249,PERF
42255319730000,PI,IP,001,11,14244,14443,6093,199,REPERF
42255319730000,PI,IP,001,12,13969,14169,6093,200,REPERF
42255319730000,PI,IP,001,13,14426,14676,6093,250,PERF
42255319730000,PI,IP,001,14,15067,15267,6093,200,PERF
42255319730000,PI,IP,001,15,15342,15541,6093,199,PERF
42255319730000,PI,IP,001,16,15616,15816,6093,200,PERF
42255319730000,PI,IP,001,17,15891,16090,6093,199,PERF
42255319730000,PI,IP,001,18,16165,16365,6093,200,PERF
42255319740000,PI,IP,001,1,11125,11354,6258,229,PERF
42255319740000,PI,IP,001,2,11434,11663,6258,229,PERF
42255319740000,PI,IP,001,3,11743,11972,6258,229,PERF
42255319740000,PI,IP,001,4,12052,12281,6258,229,PERF
42255319740000,PI,IP,001,5,12361,12589,6258,228,PERF
42255319740000,PI,IP,001,6,12669,12898,6258,229,PERF
42255319740000,PI,IP,001,7,12978,13207,6258,229,PERF
42255319740000,PI,IP,001,8,13287,13516,6258,229,PERF
42255319740000,PI,IP,001,9,13596,13825,6258,229,PERF
42255319740000,PI,IP,001,10,13905,14134,6258,229,PERF
42255319740000,PI,IP,001,11,14214,14443,6258,229,PERF
42255319740000,PI,IP,001,12,14523,14752,6258,229,PERF
42255319740000,PI,IP,001,13,14832,15061,6258,229,PERF
42255319740000,PI,IP,001,14,15141,15369,6258,228,PERF
42255319740000,PI,IP,001,15,15449,15678,6258,229,PERF
42255319740000,PI,IP,001,16,15758,15987,6258,229,PERF
42255319740000,PI,IP,001,17,16067,16296,6258,229,PERF
42255319740000,PI,IP,001,18,16376,16605,6258,229,PERF
42255319750000,PI,IP,001,1,11080,11305,6252,225,PERF
42255319750000,PI,IP,001,2,11385,11610,6252,225,PERF
42255319750000,PI,IP,001,3,11690,11914,6252,224,PERF
42255319750000,PI,IP,001,4,11994,12219,6252,225,PERF
42255319750000,PI,IP,001,5,12299,12524,6252,225,PERF
42255319750000,PI,IP,001,6,12604,12829,6252,225,PERF
42255319750000,PI,IP,001,7,12909,13133,6252,224,PERF
42255319750000,PI,IP,001,8,13213,13438,6252,225,PERF
42255319750000,PI,IP,001,9,13518,13743,6252,225,PERF
42255319750000,PI,IP,001,10,13823,14048,6252,225,PERF
42255319750000,PI,IP,001,11,14128,14353,6252,225,PERF
42255319750000,PI,IP,001,12,14433,14657,6252,224,PERF
42255319750000,PI,IP,001,13,14737,14962,6252,225,PERF
42255319750000,PI,IP,001,14,15042,15267,6252,225,PERF
42255319750000,PI,IP,001,15,15347,15572,6252,225,PERF
42255319750000,PI,IP,001,16,15652,15876,6252,224,PERF
42255319750000,PI,IP,001,17,15956,16181,6252,225,PERF
42255319750000,PI,IP,001,18,16261,16486,6252,225,PERF
42255319760000,PI,IP,001,1,11110,11341,5529,231,PERF
42255319760000,PI,IP,001,2,11421,11652,5529,231,PERF
42255319760000,PI,IP,001,3,11732,11963,5529,231,PERF
42255319760000,PI,IP,001,4,12043,12275,5529,232,PERF
42255319760000,PI,IP,001,5,12355,12586,5529,231,PERF
42255319760000,PI,IP,001,6,12666,12987,5529,321,PERF
42255319760000,PI,IP,001,7,12977,13208,5529,231,PERF
42255319760000,PI,IP,001,8,13288,13519,5529,231,PERF
42255319760000,PI,IP,001,9,13599,13830,5529,231,PERF
42255319760000,PI,IP,001,10,13910,14141,5529,231,PERF
42255319760000,PI,IP,001,11,14221,14452,5529,231,PERF
42255319760000,PI,IP,001,12,14532,14764,5529,232,PERF
42255319760000,PI,IP,001,13,14844,15075,5529,231,PERF
42255319760000,PI,IP,001,14,15155,15386,5529,231,PERF
42255319760000,PI,IP,001,15,15466,15697,5529,231,PERF
42255319760000,PI,IP,001,16,15777,16008,5529,231,PERF
42255319770000,PI,IP,001,1,11372,15576,5020,4204,PERF
42255319780000,PI,IP,001,1,11200,11439,6156,239,PERF
42255319780000,PI,IP,001,2,11519,11759,6156,240,PERF
42255319780000,PI,IP,001,3,11839,12079,6156,240,PERF
42255319780000,PI,IP,001,4,12159,12398,6156,239,PERF
42255319780000,PI,IP,001,5,12478,12718,6156,240,PERF
42255319780000,PI,IP,001,6,12798,13037,6156,239,PERF
42255319780000,PI,IP,001,7,13117,13357,6156,240,PERF
42255319780000,PI,IP,001,8,13437,13677,6156,240,PERF
42255319780000,PI,IP,001,9,13757,13996,6156,239,PERF
42255319780000,PI,IP,001,10,14076,14316,6156,240,PERF
42255319780000,PI,IP,001,11,14396,14636,6156,240,PERF
42255319780000,PI,IP,001,12,14716,14955,6156,239,PERF
42255319780000,PI,IP,001,13,15035,15275,6156,240,PERF
42255319780000,PI,IP,001,14,15355,15594,6156,239,PERF
42255319780000,PI,IP,001,15,15674,15914,6156,240,PERF
42255319780000,PI,IP,001,16,15994,16234,6156,240,PERF
42255319780000,PI,IP,001,17,16314,16493,6156,179,PERF
42255319780000,PI,IP,001,18,16573,16753,6156,180,PERF
42255319790000,PI,IP,001,1,9035,14753,6459,5718,PERF
42255319810000,PI,IP,001,1,13550,13814,4200,264,PERF
42255319810000,PI,IP,001,2,13958,14156,4200,198,PERF
42255319810000,PI,IP,001,3,14234,14499,4200,265,PERF
42255319810000,PI,IP,001,4,14577,14841,4200,264,PERF
42255319810000,PI,IP,001,5,14919,15183,4200,264,PERF
42255319810000,PI,IP,001,6,15259,15525,4200,266,PERF
42255319810000,PI,IP,001,7,15603,15867,4200,264,PERF
42255319810000,PI,IP,001,8,15945,16209,4200,264,PERF
42255319810000,PI,IP,001,9,16287,16552,4200,265,PERF
42255319810000,PI,IP,001,10,16630,16894,4200,264,PERF
42255319810000,PI,IP,001,11,16972,17236,4200,264,PERF
42255319830000,PI,IP,002,1,11832,14998,4076,3166,PERF
42255319830000,PI,PT,001,1,11832,14998,4076,3166,PERF
42255319840000,PI,IP,001,1,11818,14771,4214,2953,PERF
42255319860000,PI,IP,001,1,11463,15300,4410,3837,PERF
42255319870000,PI,IP,001,1,11900,12105,5527,205,PERF
42255319870000,PI,IP,001,2,12185,12389,5527,204,PERF
42255319870000,PI,IP,001,3,12469,12674,5527,205,PERF
42255319870000,PI,IP,001,4,12754,12958,5527,204,PERF
42255319870000,PI,IP,001,5,13038,13243,5527,205,PERF
42255319870000,PI,IP,001,6,13323,13528,5527,205,PERF
42255319870000,PI,IP,001,7,13608,13812,5527,204,PERF
42255319870000,PI,IP,001,8,13892,14097,5527,205,PERF
42255319870000,PI,IP,001,9,14177,14381,5527,204,PERF
42255319870000,PI,IP,001,10,14461,14666,5527,205,PERF
42255319870000,PI,IP,001,11,14746,14950,5527,204,PERF
42255319870000,PI,IP,001,12,15030,15235,5527,205,PERF
42255319890000,PI,IP,001,1,11330,11543,5197,213,PERF
42255319890000,PI,IP,001,2,11623,11836,5197,213,PERF
42255319890000,PI,IP,001,3,11916,12129,5197,213,PERF
42255319890000,PI,IP,001,4,12209,12422,5197,213,PERF
42255319890000,PI,IP,001,5,12502,12715,5197,213,PERF
42255319890000,PI,IP,001,6,12795,13008,5197,213,PERF
42255319890000,PI,IP,001,7,13088,13300,5197,212,PERF
42255319890000,PI,IP,001,8,13380,13589,5197,209,PERF
42255319890000,PI,IP,001,9,13673,13886,5197,213,PERF
42255319890000,PI,IP,001,10,13966,14179,5197,213,PERF
42255319890000,PI,IP,001,11,14259,14472,5197,213,PERF
42255319890000,PI,IP,001,12,14552,14765,5197,213,PERF
42255319900000,PI,IP,001,1,12537,16379,6323,3842,PERF
42255319910000,PI,IP,001,1,12600,12838,5636,238,PERF
42255319910000,PI,IP,001,2,12918,13155,5636,237,PERF
42255319910000,PI,IP,001,3,13235,13473,5636,238,PERF
42255319910000,PI,IP,001,4,13553,13790,5636,237,PERF
42255319910000,PI,IP,001,5,13870,14108,5636,238,PERF
42255319910000,PI,IP,001,6,14188,14425,5636,237,PERF
42255319910000,PI,IP,001,7,14505,14743,5636,238,PERF
42255319910000,PI,IP,001,8,14823,15061,5636,238,PERF
42255319910000,PI,IP,001,9,15141,15378,5636,237,PERF
42255319910000,PI,IP,001,10,15458,15696,5636,238,PERF
42255319910000,PI,IP,001,11,15776,16013,5636,237,PERF
42255319910000,PI,IP,001,12,16093,16331,5636,238,PERF
42255319910000,PI,IP,001,13,16411,16648,5636,237,PERF
42255319910000,PI,IP,001,14,16728,16966,5636,238,PERF
42255319910000,PI,IP,001,15,17046,17283,5636,237,PERF
42255319910000,PI,IP,001,16,17363,17601,5636,238,PERF
42255319920000,PI,IP,001,1,11927,12179,5261,252,PERF
42255319920000,PI,IP,001,2,12232,12484,5261,252,PERF
42255319920000,PI,IP,001,3,12537,12789,5261,252,PERF
42255319920000,PI,IP,001,4,12842,13094,5261,252,PERF
42255319920000,PI,IP,001,5,13147,13399,5261,252,PERF
42255319920000,PI,IP,001,6,13452,13724,5261,272,PERF
42255319920000,PI,IP,001,7,13757,14009,5261,252,PERF
42255319920000,PI,IP,001,8,14062,14314,5261,252,PERF
42255319920000,PI,IP,001,9,14367,14619,5261,252,PERF
42255319920000,PI,IP,001,10,14672,14924,5261,252,PERF
42255319920000,PI,IP,001,11,15282,15334,5261,52,PERF
42255319920000,PI,IP,001,12,15587,15839,5261,252,PERF
42255319920000,PI,IP,001,13,15893,16144,5261,251,PERF
42255319920000,PI,IP,001,14,16197,16449,5261,252,PERF
42255319920000,PI,IP,001,15,16500,16752,5261,252,PERF
42255319930000,PI,IP,001,1,11801,15220,4345,3419,PERF
42255319940000,PI,IP,001,1,11728,16984,6083,5256,PERF
42255319950000,PI,IP,001,1,12875,18187,6134,5312,PERF
42255319960000,PI,IP,001,1,12945,17985,5773,5040,PERF
42255319980000,PI,IP,001,1,11463,11690,6161,227,PERF
42255319980000,PI,IP,001,2,11738,11965,6161,227,PERF
42255319980000,PI,IP,001,3,12013,12240,6161,227,PERF
42255319980000,PI,IP,001,4,12563,12790,6161,227,PERF
42255319980000,PI,IP,001,5,12838,13065,6161,227,PERF
42255319980000,PI,IP,001,6,13113,13340,6161,227,PERF
42255319980000,PI,IP,001,7,13388,13615,6161,227,PERF
42255319980000,PI,IP,001,8,13663,13890,6161,227,PERF
42255319980000,PI,IP,001,9,13938,14165,6161,227,PERF
42255319980000,PI,IP,001,10,14215,14395,6161,180,PERF
42255320000000,PI,IP,001,1,11708,16633,,4925,PERF
42255320010000,PI,IP,003,1,12399,18394,6797,5995,PERF
42255320010000,PI,PT,001,1,12399,12651,6797,252,PERF
42255320010000,PI,PT,001,2,12704,12956,6797,252,PERF
42255320010000,PI,PT,001,3,13009,13261,6797,252,PERF
42255320010000,PI,PT,001,4,13314,13566,6797,252,PERF
42255320010000,PI,PT,001,5,13619,13871,6797,252,PERF
42255320010000,PI,PT,001,6,13924,14176,6797,252,PERF
42255320010000,PI,PT,001,7,14229,14481,6797,252,PERF
42255320010000,PI,PT,001,8,14534,14786,6797,252,PERF
42255320010000,PI,PT,001,9,14839,15091,6797,252,PERF
42255320010000,PI,PT,001,10,15144,15396,6797,252,PERF
42255320010000,PI,PT,001,11,15449,15701,6797,252,PERF
42255320010000,PI,PT,001,12,15754,16006,6797,252,PERF
42255320010000,PI,PT,001,13,16059,16261,6797,202,PERF
42255320010000,PI,PT,001,14,16364,16616,6797,252,PERF
42255320010000,PI,PT,001,15,16669,16921,6797,252,PERF
42255320010000,PI,PT,001,16,16974,17226,6797,252,PERF
42255320010000,PI,PT,001,17,17584,17836,6797,252,PERF
42255320010000,PI,PT,001,18,17939,18167,6797,228,PERF
42255320010000,PI,PT,001,19,18194,18394,6797,200,PERF
42255320010000,PI,PT,002,20,12399,18394,6797,5995,PERF
42255320020000,PI,IP,001,1,11706,16593,5696,4887,PERF
42255320030000,PI,IP,001,1,10300,16629,6927,6329,PERF
42255320040000,PI,IP,001,1,10550,15450,5503,4900,PERF
42255320050000,PI,IP,001,1,11075,13940,3524,2865,PERF
42255320060000,PI,IP,001,1,11038,15670,5651,4632,PERF
42255320070000,PI,IP,001,1,11653,16761,5957,5108,PERF
42255320080000,PI,IP,001,1,11145,14650,4144,3505,PERF
42255320090000,PI,IP,001,1,11025,11251,6343,226,PERF
42255320090000,PI,IP,001,2,11296,11522,6343,226,PERF
42255320090000,PI,IP,001,3,11567,11793,6343,226,PERF
42255320090000,PI,IP,001,4,11838,12064,6343,226,PERF
42255320090000,PI,IP,001,5,12109,12335,6343,226,PERF
42255320090000,PI,IP,001,6,12380,12606,6343,226,PERF
42255320090000,PI,IP,001,7,12651,12877,6343,226,PERF
42255320090000,PI,IP,001,8,12922,13148,6343,226,PERF
42255320090000,PI,IP,001,9,13193,13419,6343,226,PERF
42255320090000,PI,IP,001,10,13464,13690,6343,226,PERF
42255320090000,PI,IP,001,11,13735,13961,6343,226,PERF
42255320090000,PI,IP,001,12,14006,14232,6343,226,PERF
42255320090000,PI,IP,001,13,14277,14503,6343,226,PERF
42255320090000,PI,IP,001,14,14548,14774,6343,226,PERF
42255320090000,PI,IP,001,15,14819,15045,6343,226,PERF
42255320090000,PI,IP,001,16,15090,15316,6343,226,PERF
42255320090000,PI,IP,001,17,15361,15587,6343,226,PERF
42255320090000,PI,IP,001,18,15632,15858,6343,226,PERF
42255320090000,PI,IP,001,19,15903,16129,6343,226,PERF
42255320090000,PI,IP,001,20,16174,16399,6343,225,PERF
42255320100000,PI,IP,001,1,11094,14683,4229,3589,PERF
42255320110000,PI,IP,001,1,11150,14728,4249,3578,PERF
42255320120000,PI,IP,001,1,11150,14963,4453,3813,PERF
42255320130000,PI,IP,001,1,12651,18648,,5997,PERF
42255320140000,PI,IP,001,1,11897,12118,6246,221,PERF
42255320140000,PI,IP,001,2,12164,12385,6246,221,PERF
42255320140000,PI,IP,001,3,12431,12652,6246,221,PERF
42255320140000,PI,IP,001,4,12698,12919,6246,221,PERF
42255320140000,PI,IP,001,5,12965,13186,6246,221,PERF
42255320140000,PI,IP,001,6,13232,13453,6246,221,PERF
42255320140000,PI,IP,001,7,13499,13720,6246,221,PERF
42255320140000,PI,IP,001,8,13766,13987,6246,221,PERF
42255320140000,PI,IP,001,9,14033,14254,6246,221,PERF
42255320140000,PI,IP,001,10,14300,14521,6246,221,PERF
42255320140000,PI,IP,001,11,14567,14788,6246,221,PERF
42255320140000,PI,IP,001,12,14834,15055,6246,221,PERF
42255320140000,PI,IP,001,13,15101,15322,6246,221,PERF
42255320140000,PI,IP,001,14,15368,15589,6246,221,PERF
42255320140000,PI,IP,001,15,15635,15856,6246,221,PERF
42255320150000,PI,IP,001,1,10742,14793,4615,4051,PERF
42255320160000,PI,IP,003,1,11992,16462,5146,4470,PERF
42255320160000,PI,PT,001,1,11992,12244,5146,252,PERF
42255320160000,PI,PT,001,2,12297,12549,5146,252,PERF
42255320160000,PI,PT,001,3,12602,12854,5146,252,PERF
42255320160000,PI,PT,001,4,12907,13159,5146,252,PERF
42255320160000,PI,PT,001,5,13212,13464,5146,252,PERF
42255320160000,PI,PT,001,6,13517,13769,5146,252,PERF
42255320160000,PI,PT,001,7,13822,14074,5146,252,PERF
42255320160000,PI,PT,001,8,14127,14379,5146,252,PERF
42255320160000,PI,PT,001,9,14432,14684,5146,252,PERF
42255320160000,PI,PT,001,10,14737,14989,5146,252,PERF
42255320160000,PI,PT,001,11,15042,15294,5146,252,PERF
42255320160000,PI,PT,001,12,15347,15599,5146,252,PERF
42255320160000,PI,PT,001,13,15652,15904,5146,252,PERF
42255320160000,PI,PT,001,14,16007,16209,5146,202,PERF
42255320160000,PI,PT,001,15,16410,16462,5146,52,PERF
42255320160000,PI,PT,002,16,11992,16462,5146,4470,PERF
42255320170000,PI,IP,001,1,12953,18313,5567,5360,PERF
42255320190000,PI,IP,001,1,12910,18197,5818,5287,PERF
42255320200000,PI,IP,001,1,12761,17930,5949,5169,PERF
42255320210000,PI,IP,001,1,13470,16903,4153,3433,PERF
42255320220000,PI,IP,003,1,12396,18393,6922,5997,PERF
42255320220000,PI,PT,001,1,12396,12648,6922,252,PERF
42255320220000,PI,PT,001,2,12701,12953,6922,252,PERF
42255320220000,PI,PT,001,3,13006,13258,6922,252,PERF
42255320220000,PI,PT,001,4,13311,13563,6922,252,PERF
42255320220000,PI,PT,001,5,13616,13868,6922,252,PERF
42255320220000,PI,PT,001,6,13921,14173,6922,252,PERF
42255320220000,PI,PT,001,7,14226,14478,6922,252,PERF
42255320220000,PI,PT,001,8,14531,14783,6922,252,PERF
42255320220000,PI,PT,001,9,14836,15088,6922,252,PERF
42255320220000,PI,PT,001,10,15141,15393,6922,252,PERF
42255320220000,PI,PT,001,11,15446,15698,6922,252,PERF
42255320220000,PI,PT,001,12,15751,16003,6922,252,PERF
42255320220000,PI,PT,001,13,16056,16308,6922,252,PERF
42255320220000,PI,PT,001,14,16361,16613,6922,252,PERF
42255320220000,PI,PT,001,15,16666,16918,6922,252,PERF
42255320220000,PI,PT,001,16,16971,17223,6922,252,PERF
42255320220000,PI,PT,001,17,17276,17528,6922,252,PERF
42255320220000,PI,PT,001,18,17581,17833,6922,252,PERF
42255320220000,PI,PT,001,19,18191,18393,6922,202,PERF
42255320220000,PI,PT,002,20,12396,18393,6922,5997,PERF
42255320230000,PI,IP,001,1,9415,9640,6484,225,PERF
42255320230000,PI,IP,001,2,9720,9946,6484,226,PERF
42255320230000,PI,IP,001,3,10026,10251,6484,225,PERF
42255320230000,PI,IP,001,4,10331,10556,6484,225,PERF
42255320230000,PI,IP,001,5,10636,10862,6484,226,PERF
42255320230000,PI,IP,001,6,10942,11167,6484,225,PERF
42255320230000,PI,IP,001,7,11247,11473,6484,226,PERF
42255320230000,PI,IP,001,8,11553,11778,6484,225,PERF
42255320230000,PI,IP,001,9,11858,12083,6484,225,PERF
42255320230000,PI,IP,001,10,12163,12389,6484,226,PERF
42255320230000,PI,IP,001,11,12469,12964,6484,495,PERF
42255320230000,PI,IP,001,12,12774,12999,6484,225,PERF
42255320230000,PI,IP,001,13,13079,13305,6484,226,PERF
42255320230000,PI,IP,001,14,13385,13610,6484,225,PERF
42255320230000,PI,IP,001,15,13690,13916,6484,226,PERF
42255320230000,PI,IP,001,16,13996,14221,6484,225,PERF
42255320230000,PI,IP,001,17,14301,14526,6484,225,PERF
42255320230000,PI,IP,001,18,14606,14832,6484,226,PERF
42255320230000,PI,IP,001,19,14912,15137,6484,225,PERF
42255320240000,PI,IP,001,1,9446,9673,6347,227,PERF
42255320240000,PI,IP,001,2,9748,9975,6347,227,PERF
42255320240000,PI,IP,001,3,10050,10277,6347,227,PERF
42255320240000,PI,IP,001,4,10352,10579,6347,227,PERF
42255320240000,PI,IP,001,5,10654,10880,6347,226,PERF
42255320240000,PI,IP,001,6,10955,11182,6347,227,PERF
42255320240000,PI,IP,001,7,11257,11484,6347,227,PERF
42255320240000,PI,IP,001,8,11559,11786,6347,227,PERF
42255320240000,PI,IP,001,9,11861,12088,6347,227,PERF
42255320240000,PI,IP,001,10,12163,12390,6347,227,PERF
42255320240000,PI,IP,001,11,12465,12692,6347,227,PERF
42255320240000,PI,IP,001,12,12767,12994,6347,227,PERF
42255320240000,PI,IP,001,13,13069,13296,6347,227,PERF
42255320240000,PI,IP,001,14,13371,13597,6347,226,PERF
42255320240000,PI,IP,001,15,13672,13899,6347,227,PERF
42255320240000,PI,IP,001,16,13974,14201,6347,227,PERF
42255320240000,PI,IP,001,17,14276,14503,6347,227,PERF
42255320240000,PI,IP,001,18,14578,14805,6347,227,PERF
42255320260000,PI,IP,001,1,8892,14930,6631,6038,PERF
42255320270000,PI,IP,001,1,13052,18206,5572,5154,PERF
42255320280000,PI,IP,001,1,11888,16610,5185,4722,PERF
42255320290000,PI,IP,001,1,11550,17475,6694,5925,PERF
42255320300000,PI,IP,001,1,11572,17635,6689,6063,PERF
42255320310000,PI,IP,001,1,13325,13517,5206,192,PERF
42255320310000,PI,IP,001,2,13592,13784,5206,192,PERF
42255320310000,PI,IP,001,3,13859,14051,5206,192,PERF
42255320310000,PI,IP,001,4,14126,14318,5206,192,PERF
42255320310000,PI,IP,001,5,14393,14585,5206,192,PERF
42255320310000,PI,IP,001,6,14660,14852,5206,192,PERF
42255320310000,PI,IP,001,7,14927,15119,5206,192,PERF
42255320310000,PI,IP,001,8,15194,15387,5206,193,PERF
42255320310000,PI,IP,001,9,15462,15654,5206,192,PERF
42255320310000,PI,IP,001,10,15729,15921,5206,192,PERF
42255320310000,PI,IP,001,11,15996,16188,5206,192,PERF
42255320310000,PI,IP,001,12,16263,16455,5206,192,PERF
42255320310000,PI,IP,001,13,16530,16722,5206,192,PERF
42255320310000,PI,IP,001,14,16797,16989,5206,192,PERF
42255320310000,PI,IP,001,15,17064,17256,5206,192,PERF
42255320310000,PI,IP,001,16,17331,17523,5206,192,PERF
42255320320000,PI,IP,001,1,13190,13391,5188,201,PERF
42255320320000,PI,IP,001,2,13466,13666,5188,200,PERF
42255320320000,PI,IP,001,3,13741,13942,5188,201,PERF
42255320320000,PI,IP,001,4,14017,14217,5188,200,PERF
42255320320000,PI,IP,001,5,14292,14493,5188,201,PERF
42255320320000,PI,IP,001,6,14568,14768,5188,200,PERF
42255320320000,PI,IP,001,7,14843,15044,5188,201,PERF
42255320320000,PI,IP,001,8,15119,15319,5188,200,PERF
42255320320000,PI,IP,001,9,15394,15595,5188,201,PERF
42255320320000,PI,IP,001,10,15670,15870,5188,200,PERF
42255320320000,PI,IP,001,11,15945,16146,5188,201,PERF
42255320320000,PI,IP,001,12,16221,16421,5188,200,PERF
42255320320000,PI,IP,001,13,16496,16697,5188,201,PERF
42255320320000,PI,IP,001,14,16772,16972,5188,200,PERF
42255320320000,PI,IP,001,15,17047,17248,5188,201,PERF
42255320320000,PI,IP,001,16,17323,17523,5188,200,PERF
42255320330000,PI,IP,001,1,11357,16013,5243,4656,PERF
42255320350000,PI,IP,001,1,10384,16911,6821,6527,PERF
42255320370000,PI,IP,001,1,10682,15383,5248,4701,PERF
42255320380000,PI,IP,001,1,13277,19439,6746,6162,PERF
42255320390000,PI,IP,001,1,11511,11732,5986,221,PERF
42255320390000,PI,IP,001,2,11812,12033,5986,221,PERF
42255320390000,PI,IP,001,3,12113,12334,5986,221,PERF
42255320390000,PI,IP,001,4,12414,12635,5986,221,PERF
42255320390000,PI,IP,001,5,12715,12936,5986,221,PERF
42255320390000,PI,IP,001,6,13016,13237,5986,221,PERF
42255320390000,PI,IP,001,7,13317,13538,5986,221,PERF
42255320390000,PI,IP,001,8,13618,13839,5986,221,PERF
42255320390000,PI,IP,001,9,13919,14139,5986,220,PERF
42255320390000,PI,IP,001,10,14219,14440,5986,221,PERF
42255320390000,PI,IP,001,11,14520,14741,5986,221,PERF
42255320390000,PI,IP,001,12,14821,15042,5986,221,PERF
42255320390000,PI,IP,001,13,15122,15343,5986,221,PERF
42255320390000,PI,IP,001,14,15423,15644,5986,221,PERF
42255320390000,PI,IP,001,15,15724,15945,5986,221,PERF
42255320390000,PI,IP,001,16,16025,16246,5986,221,PERF
42255320390000,PI,IP,001,17,16326,16547,5986,221,PERF
42255320400000,PI,IP,001,1,10710,16838,6521,6128,PERF
42255320410000,PI,IP,001,1,10725,15934,5799,5209,PERF
42255320420000,PI,IP,001,1,11884,17593,6042,5709,PERF
42255320430000,PI,IP,001,1,13520,17812,5380,4292,PERF
42255320440000,PI,IP,001,1,11149,17064,6905,5915,PERF
42255320450000,PI,IP,001,1,10726,16003,5742,5277,PERF
42255320460200,PI,IP,001,1,10755,14953,4747,4198,PERF
42255320470000,PI,IP,001,1,13330,15358,5105,2028,PERF
42255320480000,PI,IP,001,1,11073,17861,7066,6788,PERF
42255320490000,PI,IP,003,1,12358,16220,5163,3862,PERF
42255320490000,PI,PT,001,1,12358,12610,5163,252,PERF
42255320490000,PI,PT,001,2,12663,12915,5163,252,PERF
42255320490000,PI,PT,001,3,12968,13220,5163,252,PERF
42255320490000,PI,PT,001,4,13273,13525,5163,252,PERF
42255320490000,PI,PT,001,5,13578,13830,5163,252,PERF
42255320490000,PI,PT,001,6,14188,14440,5163,252,PERF
42255320490000,PI,PT,001,7,14445,14493,5163,48,PERF
42255320490000,PI,PT,001,8,14798,15050,5163,252,PERF
42255320490000,PI,PT,001,9,15103,15355,5163,252,PERF
42255320490000,PI,PT,001,10,15408,15660,5163,252,PERF
42255320490000,PI,PT,001,11,15713,15965,5163,252,PERF
42255320490000,PI,PT,001,12,16018,16220,5163,202,PERF
42255320490000,PI,PT,002,13,12358,16220,5163,3862,PERF
42255320500000,PI,IP,001,1,13198,16709,4432,3511,PERF
42255320510000,PI,IP,001,1,10864,15403,5271,4539,PERF
42255320520000,PI,IP,001,1,13080,13220,5084,140,PERF
42255320520000,PI,IP,001,2,13264,13468,5084,204,PERF
42255320520000,PI,IP,001,3,13548,13752,5084,204,PERF
42255320520000,PI,IP,001,4,13832,14036,5084,204,PERF
42255320520000,PI,IP,001,5,14116,14319,5084,203,PERF
42255320520000,PI,IP,001,6,14399,14603,5084,204,PERF
42255320520000,PI,IP,001,7,14683,14887,5084,204,PERF
42255320520000,PI,IP,001,8,14967,15171,5084,204,PERF
42255320520000,PI,IP,001,9,15251,15455,5084,204,PERF
42255320520000,PI,IP,001,10,15535,15739,5084,204,PERF
42255320520000,PI,IP,001,11,15819,16023,5084,204,PERF
42255320520000,PI,IP,001,12,16103,16307,5084,204,PERF
42255320520000,PI,IP,001,13,16387,16590,5084,203,PERF
42255320520000,PI,IP,001,14,16670,16874,5084,204,PERF
42255320520000,PI,IP,001,15,16954,17158,5084,204,PERF
42255320520000,PI,IP,001,16,17238,17442,5084,204,PERF
42255320530000,PI,IP,001,1,13090,13240,5080,150,PERF
42255320530000,PI,IP,001,2,13280,13450,5080,170,PERF
42255320530000,PI,IP,001,3,13530,13753,5080,223,PERF
42255320530000,PI,IP,001,4,13833,14055,5080,222,PERF
42255320530000,PI,IP,001,5,14135,14358,5080,223,PERF
42255320530000,PI,IP,001,6,14438,14460,5080,22,PERF
42255320530000,PI,IP,001,7,14740,14963,5080,223,PERF
42255320530000,PI,IP,001,8,15043,15265,5080,222,PERF
42255320530000,PI,IP,001,9,15345,15568,5080,223,PERF
42255320530000,PI,IP,001,10,15648,15870,5080,222,PERF
42255320530000,PI,IP,001,11,15950,16173,5080,223,PERF
42255320530000,PI,IP,001,12,16253,16475,5080,222,PERF
42255320530000,PI,IP,001,13,16555,16778,5080,223,PERF
42255320530000,PI,IP,001,14,16858,17080,5080,222,PERF
42255320530000,PI,IP,001,15,17160,17383,5080,223,PERF
42255320540000,PI,IP,003,1,11683,16152,5154,4469,PERF
42255320540000,PI,PT,001,1,11683,11935,5154,252,PERF
42255320540000,PI,PT,001,2,11988,12090,5154,102,PERF
42255320540000,PI,PT,001,3,12138,12240,5154,102,PERF
42255320540000,PI,PT,001,4,12293,12545,5154,252,PERF
42255320540000,PI,PT,001,5,12598,12850,5154,252,PERF
42255320540000,PI,PT,001,6,12903,13155,5154,252,PERF
42255320540000,PI,PT,001,7,13208,13460,5154,252,PERF
42255320540000,PI,PT,001,8,13513,13765,5154,252,PERF
42255320540000,PI,PT,001,9,13818,13920,5154,102,PERF
42255320540000,PI,PT,001,10,13968,14070,5154,102,PERF
42255320540000,PI,PT,001,11,14123,14375,5154,252,PERF
42255320540000,PI,PT,001,12,14428,14680,5154,252,PERF
42255320540000,PI,PT,001,13,14733,14985,5154,252,PERF
42255320540000,PI,PT,001,14,15038,15290,5154,252,PERF
42255320540000,PI,PT,001,15,15343,15595,5154,252,PERF
42255320540000,PI,PT,001,16,15648,15900,5154,252,PERF
42255320540000,PI,PT,001,17,15950,16152,5154,202,PERF
42255320540000,PI,PT,002,18,11683,16152,5154,4469,PERF
42255320550000,PI,IP,001,1,12711,16870,5265,4159,PERF
42255320560000,PI,IP,001,1,12850,17761,5721,4911,PERF
42255320570000,PI,IP,001,1,11023,11248,6408,225,PERF
42255320570000,PI,IP,001,2,11294,11519,6408,225,PERF
42255320570000,PI,IP,001,3,11565,11790,6408,225,PERF
42255320570000,PI,IP,001,4,11836,12061,6408,225,PERF
42255320570000,PI,IP,001,5,12107,12332,6408,225,PERF
42255320570000,PI,IP,001,6,12378,12603,6408,225,PERF
42255320570000,PI,IP,001,7,12649,12874,6408,225,PERF
42255320570000,PI,IP,001,8,12920,13145,6408,225,PERF
42255320570000,PI,IP,001,9,13191,13416,6408,225,PERF
42255320570000,PI,IP,001,10,13462,13687,6408,225,PERF
42255320570000,PI,IP,001,11,13733,13958,6408,225,PERF
42255320570000,PI,IP,001,12,14004,14229,6408,225,PERF
42255320570000,PI,IP,001,13,14275,14500,6408,225,PERF
42255320570000,PI,IP,001,14,14546,14771,6408,225,PERF
42255320570000,PI,IP,001,15,14817,15042,6408,225,PERF
42255320570000,PI,IP,001,16,15088,15313,6408,225,PERF
42255320570000,PI,IP,001,17,15359,15584,6408,225,PERF
42255320570000,PI,IP,001,18,15630,15855,6408,225,PERF
42255320570000,PI,IP,001,19,15901,16126,6408,225,PERF
42255320570000,PI,IP,001,20,16172,16396,6408,224,PERF
42255320580000,PI,IP,001,1,11160,16913,6363,5753,PERF
42255320590000,PI,IP,001,1,11218,18060,7568,6842,PERF
42255320600000,PI,IP,003,1,11900,16074,5541,4174,PERF
42255320600000,PI,PT,001,1,11900,12162,5541,262,PERF
42255320600000,PI,PT,001,2,12220,12472,5541,252,PERF
42255320600000,PI,PT,001,3,12570,12822,5541,252,PERF
42255320600000,PI,PT,001,4,12900,13234,5541,334,PERF
42255320600000,PI,PT,001,5,13340,13594,5541,254,PERF
42255320600000,PI,PT,001,6,13640,13894,5541,254,PERF
42255320600000,PI,PT,001,7,13951,14204,5541,253,PERF
42255320600000,PI,PT,001,8,14260,14514,5541,254,PERF
42255320600000,PI,PT,001,9,14560,14814,5541,254,PERF
42255320600000,PI,PT,001,10,14860,15114,5541,254,PERF
42255320600000,PI,PT,001,11,15160,15414,5541,254,PERF
42255320600000,PI,PT,001,12,15560,15824,5541,264,PERF
42255320600000,PI,PT,001,13,15870,16074,5541,204,PERF
42255320600000,PI,PT,002,14,11900,16074,5541,4174,PERF
42255320610000,PI,IP,001,1,13080,17702,5025,4622,PERF
42255320620000,PI,IP,003,1,11673,16667,5514,4994,PERF
42255320620000,PI,PT,001,1,11673,11927,5514,254,PERF
42255320620000,PI,PT,001,2,11973,12227,5514,254,PERF
42255320620000,PI,PT,001,3,12273,12527,5514,254,PERF
42255320620000,PI,PT,001,4,12573,12827,5514,254,PERF
42255320620000,PI,PT,001,5,12873,13127,5514,254,PERF
42255320620000,PI,PT,001,6,13173,13427,5514,254,PERF
42255320620000,PI,PT,001,7,13473,13727,5514,254,PERF
42255320620000,PI,PT,001,8,13773,14027,5514,254,PERF
42255320620000,PI,PT,001,9,14073,14327,5514,254,PERF
42255320620000,PI,PT,001,10,14373,14627,5514,254,PERF
42255320620000,PI,PT,001,11,14673,14927,5514,254,PERF
42255320620000,PI,PT,001,12,14973,15227,5514,254,PERF
42255320620000,PI,PT,001,13,15273,15425,5514,152,PERF
42255320620000,PI,PT,001,14,15573,15827,5514,254,PERF
42255320620000,PI,PT,001,15,15873,16127,5514,254,PERF
42255320620000,PI,PT,001,16,16173,16227,5514,54,PERF
42255320620000,PI,PT,001,17,16423,16667,5514,244,PERF
42255320620000,PI,PT,002,18,11673,16667,5514,4994,PERF
42255320650000,PI,IP,001,1,10500,16491,6666,5991,PERF
42255320660000,PI,IP,001,1,11678,16350,5518,4672,PERF
42255320670000,PI,IP,001,1,11686,16378,5605,4692,PERF
42255320680000,PI,IP,001,1,13420,17903,4978,4483,PERF
42255320690000,PI,IP,001,1,11849,16754,5604,4905,PERF
42255320700000,PI,IP,001,1,12096,16634,5623,4538,PERF
42255320710000,PI,IP,001,1,11929,16688,5620,4759,PERF
42255320720100,PI,IP,001,1,12033,16655,5553,4622,PERF
42255320730000,PI,IP,001,1,10856,14336,4003,3480,PERF
42255320740000,PI,IP,001,1,13100,17161,4685,4061,PERF
42255320750000,PI,IP,001,1,11149,11297,5965,148,PERF
42255320750000,PI,IP,001,2,11372,11519,5965,147,PERF
42255320750000,PI,IP,001,3,11594,11741,5965,147,PERF
42255320750000,PI,IP,001,4,11816,11964,5965,148,PERF
42255320750000,PI,IP,001,5,12039,12186,5965,147,PERF
42255320750000,PI,IP,001,6,12261,12409,5965,148,PERF
42255320750000,PI,IP,001,7,12484,12631,5965,147,PERF
42255320750000,PI,IP,001,8,12706,12854,5965,148,PERF
42255320750000,PI,IP,001,9,12929,13076,5965,147,PERF
42255320750000,PI,IP,001,10,13151,13298,5965,147,PERF
42255320750000,PI,IP,001,11,13373,13521,5965,148,PERF
42255320750000,PI,IP,001,12,13596,13743,5965,147,PERF
42255320750000,PI,IP,001,13,13818,13966,5965,148,PERF
42255320750000,PI,IP,001,14,14041,14188,5965,147,PERF
42255320750000,PI,IP,001,15,14263,14410,5965,147,PERF
42255320750000,PI,IP,001,16,14485,14633,5965,148,PERF
42255320750000,PI,IP,001,17,14708,14855,5965,147,PERF
42255320750000,PI,IP,001,18,14930,15078,5965,148,PERF
42255320750000,PI,IP,001,19,15153,15300,5965,147,PERF
42255320750000,PI,IP,001,20,15674,15900,5965,226,PERF
42255320770000,PI,IP,001,1,10425,14834,4613,4409,PERF
42255320780100,PI,IP,001,1,12710,12903,5151,193,PERF
42255320780100,PI,IP,001,2,12983,13175,5151,192,PERF
42255320780100,PI,IP,001,3,13255,13448,5151,193,PERF
42255320780100,PI,IP,001,4,13528,13721,5151,193,PERF
42255320780100,PI,IP,001,5,13801,13993,5151,192,PERF
42255320780100,PI,IP,001,6,14073,14266,5151,193,PERF
42255320780100,PI,IP,001,7,14346,14538,5151,192,PERF
42255320780100,PI,IP,001,8,14618,14811,5151,193,PERF
42255320780100,PI,IP,001,9,14891,15084,5151,193,PERF
42255320780100,PI,IP,001,10,15164,15356,5151,192,PERF
42255320780100,PI,IP,001,11,15436,15629,5151,193,PERF
42255320780100,PI,IP,001,12,15709,15902,5151,193,PERF
42255320780100,PI,IP,001,13,15982,16174,5151,192,PERF
42255320780100,PI,IP,001,14,16254,16477,5151,223,PERF
42255320780100,PI,IP,001,15,16527,16719,5151,192,PERF
42255320780100,PI,IP,001,16,16799,16992,5151,193,PERF
42255320790000,PI,IP,001,1,11408,16064,5216,4656,PERF
42255320800000,PI,IP,001,1,13500,19892,6778,6392,PERF
42255320820000,PI,IP,001,1,12710,12921,5178,211,PERF
42255320820000,PI,IP,001,2,13001,13212,5178,211,PERF
42255320820000,PI,IP,001,3,13292,13502,5178,210,PERF
42255320820000,PI,IP,001,4,13582,13793,5178,211,PERF
42255320820000,PI,IP,001,5,13873,14084,5178,211,PERF
42255320820000,PI,IP,001,6,14164,14375,5178,211,PERF
42255320820000,PI,IP,001,7,14455,14666,5178,211,PERF
42255320820000,PI,IP,001,8,14746,14956,5178,210,PERF
42255320820000,PI,IP,001,9,15036,15247,5178,211,PERF
42255320820000,PI,IP,001,10,15327,15538,5178,211,PERF
42255320820000,PI,IP,001,11,15618,15829,5178,211,PERF
42255320820000,PI,IP,001,12,15909,16120,5178,211,PERF
42255320820000,PI,IP,001,13,16200,16410,5178,210,PERF
42255320820000,PI,IP,001,14,16490,16701,5178,211,PERF
42255320820000,PI,IP,001,15,16781,16992,5178,211,PERF
42255320840000,PI,IP,001,1,13458,15223,5151,1765,PERF
42255320850000,PI,IP,001,1,11800,17017,5552,5217,PERF
42255320860000,PI,IP,001,1,11240,15291,4833,4051,PERF
42255320870000,PI,IP,001,1,11882,17765,6797,5883,PERF
42255320880000,PI,IP,001,1,11660,13117,3179,1457,PERF
42255320890000,PI,IP,001,1,12500,12718,5978,218,PERF
42255320890000,PI,IP,001,2,12798,13015,5978,217,PERF
42255320890000,PI,IP,001,3,13095,13313,5978,218,PERF
42255320890000,PI,IP,001,4,13393,13611,5978,218,PERF
42255320890000,PI,IP,001,5,13691,13909,5978,218,PERF
42255320890000,PI,IP,001,6,13989,14206,5978,217,PERF
42255320890000,PI,IP,001,7,14286,14504,5978,218,PERF
42255320890000,PI,IP,001,8,14584,14802,5978,218,PERF
42255320890000,PI,IP,001,9,14882,15100,5978,218,PERF
42255320890000,PI,IP,001,10,15180,15397,5978,217,PERF
42255320890000,PI,IP,001,11,15477,15695,5978,218,PERF
42255320890000,PI,IP,001,12,15775,15993,5978,218,PERF
42255320890000,PI,IP,001,13,16073,16290,5978,217,PERF
42255320890000,PI,IP,001,14,16370,16588,5978,218,PERF
42255320890000,PI,IP,001,15,16668,16886,5978,218,PERF
42255320890000,PI,IP,001,16,16966,17184,5978,218,PERF
42255320890000,PI,IP,001,17,17264,17481,5978,217,PERF
42255320890000,PI,IP,001,18,17561,17779,5978,218,PERF
42255320900000,PI,IP,001,1,10902,15890,5472,4988,PERF
42255320910000,PI,IP,001,1,10855,16573,6279,5718,PERF
42255320920000,PI,IP,001,1,10283,15983,6160,5700,PERF
42255320930000,PI,IP,001,1,13565,17610,4544,4045,PERF
42255320950000,PI,IP,001,1,12570,12781,5878,211,PERF
42255320950000,PI,IP,001,2,12861,13071,5878,210,PERF
42255320950000,PI,IP,001,3,13151,13362,5878,211,PERF
42255320950000,PI,IP,001,4,13442,13653,5878,211,PERF
42255320950000,PI,IP,001,5,13733,13943,5878,210,PERF
42255320950000,PI,IP,001,6,14023,14234,5878,211,PERF
42255320950000,PI,IP,001,7,14314,14525,5878,211,PERF
42255320950000,PI,IP,001,8,14605,14815,5878,210,PERF
42255320950000,PI,IP,001,9,14895,15106,5878,211,PERF
42255320950000,PI,IP,001,10,15186,15397,5878,211,PERF
42255320950000,PI,IP,001,11,15477,15687,5878,210,PERF
42255320950000,PI,IP,001,12,15767,15978,5878,211,PERF
42255320950000,PI,IP,001,13,16058,16269,5878,211,PERF
42255320950000,PI,IP,001,14,16349,16559,5878,210,PERF
42255320950000,PI,IP,001,15,16639,16850,5878,211,PERF
42255320950000,PI,IP,001,16,16930,17141,5878,211,PERF
42255320950000,PI,IP,001,17,17221,17431,5878,210,PERF
42255320950000,PI,IP,001,18,17511,17722,5878,211,PERF
42255320960000,PI,IP,002,1,11459,16095,5537,4636,PERF
42255320960000,PI,PT,001,1,11459,11611,5537,152,PERF
42255320960000,PI,PT,001,2,11651,11711,5537,60,PERF
42255320960000,PI,PT,001,3,11759,12011,5537,252,PERF
42255320960000,PI,PT,001,4,12059,12311,5537,252,PERF
42255320960000,PI,PT,001,5,13259,13511,5537,252,PERF
42255320960000,PI,PT,001,6,13659,13811,5537,152,PERF
42255320960000,PI,PT,001,7,13859,14111,5537,252,PERF
42255320960000,PI,PT,001,8,14159,14411,5537,252,PERF
42255320960000,PI,PT,001,9,14459,14711,5537,252,PERF
42255320960000,PI,PT,001,10,14759,15011,5537,252,PERF
42255320960000,PI,PT,001,11,15059,15311,5537,252,PERF
42255320960000,PI,PT,001,12,15359,15611,5537,252,PERF
42255320960000,PI,PT,001,13,15659,15861,5537,202,PERF
42255320960000,PI,PT,001,14,15893,16095,5537,202,PERF
42255320970000,PI,IP,001,1,10388,12800,3043,2412,PERF
42255320980000,PI,IP,001,1,11480,16081,5892,4601,PERF
42255320990000,PI,IP,001,1,12069,17239,5985,5170,PERF
42255321010000,PI,IP,001,1,12672,12899,4937,227,PERF
42255321010000,PI,IP,001,2,12967,13194,4937,227,PERF
42255321010000,PI,IP,001,3,13262,13489,4937,227,PERF
42255321010000,PI,IP,001,4,13557,13776,4937,219,PERF
42255321010000,PI,IP,001,5,13852,14079,4937,227,PERF
42255321010000,PI,IP,001,6,14152,14368,4937,216,PERF
42255321010000,PI,IP,001,7,14442,14669,4937,227,PERF
42255321010000,PI,IP,001,8,14737,14964,4937,227,PERF
42255321010000,PI,IP,001,9,15032,15259,4937,227,PERF
42255321010000,PI,IP,001,10,15327,15554,4937,227,PERF
42255321010000,PI,IP,001,11,15622,15849,4937,227,PERF
42255321010000,PI,IP,001,12,15917,16144,4937,227,PERF
42255321010000,PI,IP,001,13,16212,16439,4937,227,PERF
42255321010000,PI,IP,001,14,16507,16749,4937,242,PERF
42255321020000,PI,IP,001,1,13550,16836,4095,3286,PERF
42255321030000,PI,IP,001,1,11032,17300,7014,6268,PERF
42255321040000,PI,IP,001,1,11380,17362,6864,5982,PERF
42255321050000,PI,IP,001,1,11610,16862,6540,5252,PERF
42255321060000,PI,IP,001,1,9298,9506,6360,208,PERF
42255321060000,PI,IP,001,2,9581,9789,6360,208,PERF
42255321060000,PI,IP,001,3,9864,10072,6360,208,PERF
42255321060000,PI,IP,001,4,10147,10356,6360,209,PERF
42255321060000,PI,IP,001,5,10431,10639,6360,208,PERF
42255321060000,PI,IP,001,6,10714,10922,6360,208,PERF
42255321060000,PI,IP,001,7,10997,11205,6360,208,PERF
42255321060000,PI,IP,001,8,11280,11488,6360,208,PERF
42255321060000,PI,IP,001,9,11563,11771,6360,208,PERF
42255321060000,PI,IP,001,10,11846,12054,6360,208,PERF
42255321060000,PI,IP,001,11,12129,12310,6360,181,PERF
42255321060000,PI,IP,001,12,12385,12593,6360,208,PERF
42255321060000,PI,IP,001,13,12668,12876,6360,208,PERF
42255321060000,PI,IP,001,14,12951,13159,6360,208,PERF
42255321060000,PI,IP,001,15,13234,13442,6360,208,PERF
42255321060000,PI,IP,001,16,13517,13725,6360,208,PERF
42255321060000,PI,IP,001,17,13800,14009,6360,209,PERF
42255321060000,PI,IP,001,18,14084,14292,6360,208,PERF
42255321060000,PI,IP,001,19,14367,14575,6360,208,PERF
42255321060000,PI,IP,001,20,14650,14858,6360,208,PERF
42255321070000,PI,IP,001,1,9297,9477,5783,180,PERF
42255321070000,PI,IP,001,2,9552,9732,5783,180,PERF
42255321070000,PI,IP,001,3,9807,9988,5783,181,PERF
42255321070000,PI,IP,001,4,10063,10243,5783,180,PERF
42255321070000,PI,IP,001,5,10318,10498,5783,180,PERF
42255321070000,PI,IP,001,6,10573,10754,5783,181,PERF
42255321070000,PI,IP,001,7,10829,11009,5783,180,PERF
42255321070000,PI,IP,001,8,11084,11264,5783,180,PERF
42255321070000,PI,IP,001,9,11339,11519,5783,180,PERF
42255321070000,PI,IP,001,10,11594,11775,5783,181,PERF
42255321070000,PI,IP,001,11,11850,12030,5783,180,PERF
42255321070000,PI,IP,001,12,12105,12285,5783,180,PERF
42255321070000,PI,IP,001,13,12360,12540,5783,180,PERF
42255321070000,PI,IP,001,14,12615,12796,5783,181,PERF
42255321070000,PI,IP,001,15,12871,13051,5783,180,PERF
42255321070000,PI,IP,001,16,13126,13306,5783,180,PERF
42255321070000,PI,IP,001,17,13381,13561,5783,180,PERF
42255321070000,PI,IP,001,18,13636,13817,5783,181,PERF
42255321070000,PI,IP,001,19,13892,14072,5783,180,PERF
42255321070000,PI,IP,001,20,14147,14327,5783,180,PERF
42255321080000,PI,IP,001,1,10153,15883,6090,5730,PERF
42255321090000,PI,IP,001,1,13135,18662,6224,5527,PERF
42255321100000,PI,IP,001,1,13150,19115,6666,5965,PERF
42255321110000,PI,IP,001,1,12240,12488,7010,248,PERF
42255321110000,PI,IP,001,2,12570,12807,7010,237,PERF
42255321110000,PI,IP,001,3,12890,13132,7010,242,PERF
42255321110000,PI,IP,001,4,13212,13454,7010,242,PERF
42255321110000,PI,IP,001,5,13534,13776,7010,242,PERF
42255321110000,PI,IP,001,6,13856,14101,7010,245,PERF
42255321110000,PI,IP,001,7,14178,14420,7010,242,PERF
42255321110000,PI,IP,001,8,14500,14742,7010,242,PERF
42255321110000,PI,IP,001,9,14822,15064,7010,242,PERF
42255321110000,PI,IP,001,10,15144,15386,7010,242,PERF
42255321110000,PI,IP,001,11,15468,15708,7010,240,PERF
42255321110000,PI,IP,001,12,15788,16030,7010,242,PERF
42255321110000,PI,IP,001,13,16110,16352,7010,242,PERF
42255321110000,PI,IP,001,14,16432,16674,7010,242,PERF
42255321110000,PI,IP,001,15,16754,16996,7010,242,PERF
42255321110000,PI,IP,001,16,17076,17318,7010,242,PERF
42255321110000,PI,IP,001,17,17390,17640,7010,250,PERF
42255321110000,PI,IP,001,18,17720,17962,7010,242,PERF
42255321130000,PI,IP,004,1,13060,19281,6639,6221,PERF
42255321130000,PI,PT,001,1,14975,14976,6639,1,PERF
42255321130000,PI,PT,001,2,15040,15041,6639,1,PERF
42255321130000,PI,PT,001,3,15110,15111,6639,1,PERF
42255321130000,PI,PT,001,4,15180,15181,6639,1,PERF
42255321130000,PI,PT,001,5,15250,15251,6639,1,PERF
42255321130000,PI,PT,001,6,15320,15321,6639,1,PERF
42255321130000,PI,PT,001,7,15610,15611,6639,1,PERF
42255321130000,PI,PT,001,8,15670,15671,6639,1,PERF
42255321130000,PI,PT,001,9,15730,15731,6639,1,PERF
42255321130000,PI,PT,001,10,15790,15791,6639,1,PERF
42255321130000,PI,PT,001,11,15850,15851,6639,1,PERF
42255321130000,PI,PT,001,12,15910,15911,6639,1,PERF
42255321130000,PI,PT,001,13,15985,15986,6639,1,PERF
42255321130000,PI,PT,001,14,16045,16046,6639,1,PERF
42255321130000,PI,PT,001,15,16111,16112,6639,1,PERF
42255321130000,PI,PT,001,16,16171,16172,6639,1,PERF
42255321130000,PI,PT,001,17,16231,16232,6639,1,PERF
42255321130000,PI,PT,001,18,16291,16292,6639,1,PERF
42255321130000,PI,PT,001,19,16366,16367,6639,1,PERF
42255321130000,PI,PT,001,20,16426,16427,6639,1,PERF
42255321130000,PI,PT,001,21,16486,16487,6639,1,PERF
42255321130000,PI,PT,001,22,16546,16547,6639,1,PERF
42255321130000,PI,PT,001,23,16606,16607,6639,1,PERF
42255321130000,PI,PT,001,24,16666,16667,6639,1,PERF
42255321130000,PI,PT,001,25,16736,16737,6639,1,PERF
42255321130000,PI,PT,001,26,16796,16797,6639,1,PERF
42255321130000,PI,PT,001,27,16856,16857,6639,1,PERF
42255321130000,PI,PT,001,28,16916,16917,6639,1,PERF
42255321130000,PI,PT,001,29,16984,16985,6639,1,PERF
42255321130000,PI,PT,001,30,17044,17045,6639,1,PERF
42255321130000,PI,PT,001,31,17119,17120,6639,1,PERF
42255321130000,PI,PT,001,32,17179,17180,6639,1,PERF
42255321130000,PI,PT,001,33,17246,17247,6639,1,PERF
42255321130000,PI,PT,001,34,17306,17307,6639,1,PERF
42255321130000,PI,PT,001,35,17371,17372,6639,1,PERF
42255321130000,PI,PT,001,36,17436,17437,6639,1,PERF
42255321130000,PI,PT,001,37,17506,17507,6639,1,PERF
42255321130000,PI,PT,001,38,17571,17572,6639,1,PERF
42255321130000,PI,PT,001,39,17631,17632,6639,1,PERF
42255321130000,PI,PT,001,40,17691,17692,6639,1,PERF
42255321130000,PI,PT,001,41,17751,17752,6639,1,PERF
42255321130000,PI,PT,001,42,17811,17812,6639,1,PERF
42255321130000,PI,PT,001,43,17881,17882,6639,1,PERF
42255321130000,PI,PT,001,44,17941,17942,6639,1,PERF
42255321130000,PI,PT,001,45,18007,18008,6639,1,PERF
42255321130000,PI,PT,001,46,18067,18068,6639,1,PERF
42255321130000,PI,PT,001,47,18127,18128,6639,1,PERF
42255321130000,PI,PT,001,48,18185,18186,6639,1,PERF
42255321130000,PI,PT,001,49,18250,18251,6639,1,PERF
42255321130000,PI,PT,001,50,18315,18316,6639,1,PERF
42255321130000,PI,PT,001,51,18375,18376,6639,1,PERF
42255321130000,PI,PT,001,52,18435,18436,6639,1,PERF
42255321130000,PI,PT,001,53,18490,18491,6639,1,PERF
42255321130000,PI,PT,001,54,18550,18551,6639,1,PERF
42255321130000,PI,PT,001,55,18620,18621,6639,1,PERF
42255321130000,PI,PT,001,56,18680,18681,6639,1,PERF
42255321130000,PI,PT,001,57,18740,18741,6639,1,PERF
42255321130000,PI,PT,001,58,18795,18796,6639,1,PERF
42255321130000,PI,PT,001,59,18855,18856,6639,1,PERF
42255321130000,PI,PT,001,60,18915,18916,6639,1,PERF
42255321130000,PI,PT,001,61,18980,18981,6639,1,PERF
42255321130000,PI,PT,001,62,19040,19041,6639,1,PERF
42255321130000,PI,PT,001,63,19100,19101,6639,1,PERF
42255321130000,PI,PT,001,64,19160,19161,6639,1,PERF
42255321130000,PI,PT,001,65,19220,19221,6639,1,PERF
42255321130000,PI,PT,001,66,19280,19281,6639,1,PERF
42255321130000,PI,PT,002,67,14820,14821,6639,1,REPERF
42255321130000,PI,PT,002,68,14885,14886,6639,1,REPERF
42255321130000,PI,PT,002,69,14950,14951,6639,1,REPERF
42255321130000,PI,PT,002,70,15015,15016,6639,1,REPERF
42255321130000,PI,PT,002,71,15080,15081,6639,1,REPERF
42255321130000,PI,PT,002,72,15140,15141,6639,1,REPERF
42255321130000,PI,PT,003,73,13060,13061,6639,1,PERF
42255321130000,PI,PT,003,74,13135,13136,6639,1,PERF
42255321130000,PI,PT,003,75,13210,13211,6639,1,PERF
42255321130000,PI,PT,003,76,13285,13286,6639,1,PERF
42255321130000,PI,PT,003,77,13360,13361,6639,1,PERF
42255321130000,PI,PT,003,78,13435,13436,6639,1,PERF
42255321130000,PI,PT,003,79,13520,13521,6639,1,PERF
42255321130000,PI,PT,003,80,13595,13596,6639,1,PERF
42255321130000,PI,PT,003,81,13670,13671,6639,1,PERF
42255321130000,PI,PT,003,82,13745,13746,6639,1,PERF
42255321130000,PI,PT,003,83,13820,13821,6639,1,PERF
42255321130000,PI,PT,003,84,13895,13896,6639,1,PERF
42255321130000,PI,PT,003,85,13980,13981,6639,1,PERF
42255321130000,PI,PT,003,86,14055,14056,6639,1,PERF
42255321130000,PI,PT,003,87,14130,14131,6639,1,PERF
42255321130000,PI,PT,003,88,14205,14206,6639,1,PERF
42255321130000,PI,PT,003,89,14278,14279,6639,1,PERF
42255321130000,PI,PT,003,90,14348,14349,6639,1,PERF
42255321130000,PI,PT,003,91,14423,14424,6639,1,PERF
42255321130000,PI,PT,003,92,14488,14489,6639,1,PERF
42255321130000,PI,PT,003,93,14553,14554,6639,1,PERF
42255321130000,PI,PT,003,94,14618,14619,6639,1,PERF
42255321130000,PI,PT,003,95,14683,14684,6639,1,PERF
42255321130000,PI,PT,003,96,14745,14746,6639,1,PERF
42255321140000,PI,IP,001,1,13160,13161,6650,1,PERF
42255321140000,PI,IP,001,2,13238,13239,6650,1,PERF
42255321140000,PI,IP,001,3,13323,13324,6650,1,PERF
42255321140000,PI,IP,001,4,13408,13409,6650,1,PERF
42255321140000,PI,IP,001,5,13488,13489,6650,1,PERF
42255321140000,PI,IP,001,6,13563,13564,6650,1,PERF
42255321140000,PI,IP,001,7,13648,13649,6650,1,PERF
42255321140000,PI,IP,001,8,13730,13731,6650,1,PERF
42255321140000,PI,IP,001,9,13805,13806,6650,1,PERF
42255321140000,PI,IP,001,10,13880,13881,6650,1,PERF
42255321140000,PI,IP,001,11,13955,13956,6650,1,PERF
42255321140000,PI,IP,001,12,14025,14026,6650,1,PERF
42255321140000,PI,IP,001,13,14110,14111,6650,1,PERF
42255321140000,PI,IP,001,14,14180,14181,6650,1,PERF
42255321140000,PI,IP,001,15,14250,14251,6650,1,PERF
42255321140000,PI,IP,001,16,14320,14321,6650,1,PERF
42255321140000,PI,IP,001,17,14390,14391,6650,1,PERF
42255321140000,PI,IP,001,18,14460,14461,6650,1,PERF
42255321140000,PI,IP,001,19,14540,14541,6650,1,PERF
42255321140000,PI,IP,001,20,14610,14611,6650,1,PERF
42255321140000,PI,IP,001,21,14685,14686,6650,1,PERF
42255321140000,PI,IP,001,22,14755,14756,6650,1,PERF
42255321140000,PI,IP,001,23,14825,14826,6650,1,PERF
42255321140000,PI,IP,001,24,14895,14896,6650,1,PERF
42255321140000,PI,IP,001,25,14975,14976,6650,1,PERF
42255321140000,PI,IP,001,26,15040,15041,6650,1,PERF
42255321140000,PI,IP,001,27,15110,15111,6650,1,PERF
42255321140000,PI,IP,001,28,15180,15181,6650,1,PERF
42255321140000,PI,IP,001,29,15250,15251,6650,1,PERF
42255321140000,PI,IP,001,30,15320,15321,6650,1,PERF
42255321140000,PI,IP,001,31,15610,15611,6650,1,PERF
42255321140000,PI,IP,001,32,15670,15671,6650,1,PERF
42255321140000,PI,IP,001,33,15730,15731,6650,1,PERF
42255321140000,PI,IP,001,34,15790,15791,6650,1,PERF
42255321140000,PI,IP,001,35,15850,15851,6650,1,PERF
42255321140000,PI,IP,001,36,15910,15911,6650,1,PERF
42255321140000,PI,IP,001,37,15920,15921,6650,1,PERF
42255321140000,PI,IP,001,38,15960,15961,6650,1,PERF
42255321140000,PI,IP,001,39,15995,15996,6650,1,PERF
42255321140000,PI,IP,001,40,16030,16031,6650,1,PERF
42255321140000,PI,IP,001,41,16095,16096,6650,1,PERF
42255321140000,PI,IP,001,42,16160,16161,6650,1,PERF
42255321140000,PI,IP,001,43,16240,16241,6650,1,PERF
42255321140000,PI,IP,001,44,16305,16306,6650,1,PERF
42255321140000,PI,IP,001,45,16365,16366,6650,1,PERF
42255321140000,PI,IP,001,46,16425,16426,6650,1,PERF
42255321140000,PI,IP,001,47,16490,16491,6650,1,PERF
42255321140000,PI,IP,001,48,16555,16556,6650,1,PERF
42255321140000,PI,IP,001,49,16630,16631,6650,1,PERF
42255321140000,PI,IP,001,50,16690,16691,6650,1,PERF
42255321140000,PI,IP,001,51,16750,16751,6650,1,PERF
42255321140000,PI,IP,001,52,16815,16816,6650,1,PERF
42255321140000,PI,IP,001,53,16880,16881,6650,1,PERF
42255321140000,PI,IP,001,54,16940,16941,6650,1,PERF
42255321140000,PI,IP,001,55,17015,17016,6650,1,PERF
42255321140000,PI,IP,001,56,17075,17076,6650,1,PERF
42255321140000,PI,IP,001,57,17140,17141,6650,1,PERF
42255321140000,PI,IP,001,58,17200,17201,6650,1,PERF
42255321140000,PI,IP,001,59,17265,17266,6650,1,PERF
42255321140000,PI,IP,001,60,17330,17331,6650,1,PERF
42255321140000,PI,IP,001,61,17405,17406,6650,1,PERF
42255321140000,PI,IP,001,62,17470,17471,6650,1,PERF
42255321140000,PI,IP,001,63,17535,17536,6650,1,PERF
42255321140000,PI,IP,001,64,17595,17596,6650,1,PERF
42255321140000,PI,IP,001,65,17655,17656,6650,1,PERF
42255321140000,PI,IP,001,66,17715,17716,6650,1,PERF
42255321140000,PI,IP,001,67,17790,17791,6650,1,PERF
42255321140000,PI,IP,001,68,17855,17856,6650,1,PERF
42255321140000,PI,IP,001,69,17915,17916,6650,1,PERF
42255321140000,PI,IP,001,70,17975,17976,6650,1,PERF
42255321140000,PI,IP,001,71,18043,18044,6650,1,PERF
42255321140000,PI,IP,001,72,18103,18104,6650,1,PERF
42255321140000,PI,IP,001,73,18168,18169,6650,1,PERF
42255321140000,PI,IP,001,74,18228,18229,6650,1,PERF
42255321140000,PI,IP,001,75,18288,18289,6650,1,PERF
42255321140000,PI,IP,001,76,18348,18349,6650,1,PERF
42255321140000,PI,IP,001,77,18408,18409,6650,1,PERF
42255321140000,PI,IP,001,78,18468,18469,6650,1,PERF
42255321140000,PI,IP,001,79,18538,18539,6650,1,PERF
42255321140000,PI,IP,001,80,18598,18599,6650,1,PERF
42255321140000,PI,IP,001,81,18663,18664,6650,1,PERF
42255321140000,PI,IP,001,82,18723,18724,6650,1,PERF
42255321140000,PI,IP,001,83,18783,18784,6650,1,PERF
42255321140000,PI,IP,001,84,18851,18852,6650,1,PERF
42255321140000,PI,IP,001,85,18916,18917,6650,1,PERF
42255321140000,PI,IP,001,86,18976,18977,6650,1,PERF
42255321140000,PI,IP,001,87,19036,19037,6650,1,PERF
42255321140000,PI,IP,001,88,19096,19097,6650,1,PERF
42255321140000,PI,IP,001,89,19161,19162,6650,1,PERF
42255321140000,PI,IP,001,90,19221,19222,6650,1,PERF
42255321150000,PI,IP,001,1,11150,15800,4974,4650,PERF
42255321160000,PI,IP,001,1,10920,11136,5354,216,PERF
42255321160000,PI,IP,001,2,11210,11430,5354,220,PERF
42255321160000,PI,IP,001,3,11500,11715,5354,215,PERF
42255321160000,PI,IP,001,4,11790,12010,5354,220,PERF
42255321160000,PI,IP,001,5,12290,12507,5354,217,PERF
42255321160000,PI,IP,001,6,12575,12787,5354,212,PERF
42255321160000,PI,IP,001,7,12860,13077,5354,217,PERF
42255321160000,PI,IP,001,8,13146,13362,5354,216,PERF
42255321160000,PI,IP,001,9,13431,13651,5354,220,PERF
42255321160000,PI,IP,001,10,13716,13933,5354,217,PERF
42255321160000,PI,IP,001,11,14001,14218,5354,217,PERF
42255321160000,PI,IP,001,12,14284,14503,5354,219,PERF
42255321160000,PI,IP,001,13,14570,14783,5354,213,PERF
42255321160000,PI,IP,001,14,14857,15074,5354,217,PERF
42255321160000,PI,IP,001,15,15139,15359,5354,220,PERF
42255321160000,PI,IP,001,16,15427,15655,5354,228,PERF
42255321170000,PI,IP,001,1,15423,15675,5447,252,PERF
42255321170000,PI,IP,001,2,15828,15980,5447,152,PERF
42255321170000,PI,IP,001,3,16033,16283,5447,250,PERF
42255321170000,PI,IP,001,4,16340,16542,5447,202,PERF
42255321180000,PI,IP,001,1,12067,16960,5522,4893,PERF
42255321190000,PI,IP,001,1,10671,10901,5187,230,PERF
42255321190000,PI,IP,001,2,10974,11197,5187,223,PERF
42255321190000,PI,IP,001,3,11277,11498,5187,221,PERF
42255321190000,PI,IP,001,4,11580,11810,5187,230,PERF
42255321190000,PI,IP,001,5,12312,12528,5187,216,PERF
42255321190000,PI,IP,001,6,12597,12815,5187,218,PERF
42255321190000,PI,IP,001,7,12884,13103,5187,219,PERF
42255321190000,PI,IP,001,8,13171,13383,5187,212,PERF
42255321190000,PI,IP,001,9,13458,13676,5187,218,PERF
42255321190000,PI,IP,001,10,13745,13963,5187,218,PERF
42255321190000,PI,IP,001,11,14038,14250,5187,212,PERF
42255321190000,PI,IP,001,12,14318,14536,5187,218,PERF
42255321190000,PI,IP,001,13,14601,14823,5187,222,PERF
42255321190000,PI,IP,001,14,14892,15110,5187,218,PERF
42255321190000,PI,IP,001,15,15179,15407,5187,228,PERF
42255321200000,PI,IP,001,1,12143,16833,5605,4690,PERF
42255321210000,PI,IP,001,1,12171,16709,5605,4538,PERF
42255321220000,PI,IP,001,1,12701,16693,5645,3992,PERF
42255321230100,PI,IP,001,1,13000,13200,6297,200,PERF
42255321230100,PI,IP,001,2,13275,13476,6297,201,PERF
42255321230100,PI,IP,001,3,13551,13751,6297,200,PERF
42255321230100,PI,IP,001,4,13826,14026,6297,200,PERF
42255321230100,PI,IP,001,5,14101,14302,6297,201,PERF
42255321230100,PI,IP,001,6,14377,14577,6297,200,PERF
42255321230100,PI,IP,001,7,14652,14852,6297,200,PERF
42255321230100,PI,IP,001,8,14927,15127,6297,200,PERF
42255321230100,PI,IP,001,9,15202,15403,6297,201,PERF
42255321230100,PI,IP,001,10,15478,15678,6297,200,PERF
42255321230100,PI,IP,001,11,15753,15953,6297,200,PERF
42255321230100,PI,IP,001,12,16028,16229,6297,201,PERF
42255321230100,PI,IP,001,13,16304,16504,6297,200,PERF
42255321230100,PI,IP,001,14,16579,16779,6297,200,PERF
42255321230100,PI,IP,001,15,16854,17055,6297,201,PERF
42255321230100,PI,IP,001,16,17130,17330,6297,200,PERF
42255321230100,PI,IP,001,17,17405,17605,6297,200,PERF
42255321230100,PI,IP,001,18,17680,17880,6297,200,PERF
42255321230100,PI,IP,001,19,17955,18156,6297,201,PERF
42255321230100,PI,IP,001,20,18231,18431,6297,200,PERF
42255321240000,PI,IP,001,1,11374,16950,6568,5576,PERF
42255321250000,PI,IP,001,1,13496,18928,5661,5432,PERF
42255321260000,PI,IP,001,1,11036,11188,5849,152,PERF
42255321260000,PI,IP,001,2,11264,11416,5849,152,PERF
42255321260000,PI,IP,001,3,11492,11644,5849,152,PERF
42255321260000,PI,IP,001,4,11720,11872,5849,152,PERF
42255321260000,PI,IP,001,5,11948,12100,5849,152,PERF
42255321260000,PI,IP,001,6,12328,12480,5849,152,PERF
42255321260000,PI,IP,001,7,12556,12708,5849,152,PERF
42255321260000,PI,IP,001,8,12784,12936,5849,152,PERF
42255321260000,PI,IP,001,9,13012,13164,5849,152,PERF
42255321260000,PI,IP,001,10,13240,13392,5849,152,PERF
42255321260000,PI,IP,001,11,13468,13620,5849,152,PERF
42255321260000,PI,IP,001,12,13696,13848,5849,152,PERF
42255321260000,PI,IP,001,13,13924,14076,5849,152,PERF
42255321260000,PI,IP,001,14,14152,14304,5849,152,PERF
42255321260000,PI,IP,001,15,14380,14532,5849,152,PERF
42255321260000,PI,IP,001,16,14608,14760,5849,152,PERF
42255321260000,PI,IP,001,17,14836,14988,5849,152,PERF
42255321260000,PI,IP,001,18,15064,15216,5849,152,PERF
42255321260000,PI,IP,001,19,15292,15444,5849,152,PERF
42255321260000,PI,IP,001,20,15520,15672,5849,152,PERF
42255321260000,PI,IP,001,21,15748,15900,5849,152,PERF
42255321270000,PI,IP,001,1,12367,15718,3698,3351,PERF
42255321280000,PI,IP,001,1,12070,16841,4851,4771,PERF
42255321290000,PI,IP,002,1,11055,16045,6407,4990,PERF
42255321290000,PI,PT,001,1,11055,11286,6407,231,PERF
42255321290000,PI,PT,001,2,11335,11566,6407,231,PERF
42255321290000,PI,PT,001,3,11615,11846,6407,231,PERF
42255321290000,PI,PT,001,4,11895,12126,6407,231,PERF
42255321290000,PI,PT,001,5,12175,12406,6407,231,PERF
42255321290000,PI,PT,001,6,12455,12686,6407,231,PERF
42255321290000,PI,PT,001,7,12735,12966,6407,231,PERF
42255321290000,PI,PT,001,8,13015,13246,6407,231,PERF
42255321290000,PI,PT,001,9,13295,13526,6407,231,PERF
42255321290000,PI,PT,001,10,13575,13806,6407,231,PERF
42255321290000,PI,PT,001,11,13855,14086,6407,231,PERF
42255321290000,PI,PT,001,12,14135,14366,6407,231,PERF
42255321290000,PI,PT,001,13,14415,14646,6407,231,PERF
42255321290000,PI,PT,001,14,14695,14926,6407,231,PERF
42255321290000,PI,PT,001,15,14975,15206,6407,231,PERF
42255321290000,PI,PT,001,16,15255,15486,6407,231,PERF
42255321290000,PI,PT,001,17,15535,15766,6407,231,PERF
42255321290000,PI,PT,001,18,15815,16045,6407,230,PERF
42255321300000,PI,IP,002,1,11065,15650,6288,4585,PERF
42255321300000,PI,PT,001,1,11065,15650,6288,4585,PERF
42255321310000,PI,IP,001,1,13050,17332,5039,4282,PERF
42255321320000,PI,IP,001,1,10370,13655,3608,3285,PERF
42255321330000,PI,IP,001,1,11560,11818,5924,258,PERF
42255321330000,PI,IP,001,2,11890,12148,5924,258,PERF
42255321330000,PI,IP,001,3,12220,12478,5924,258,PERF
42255321330000,PI,IP,001,4,12550,12808,5924,258,PERF
42255321330000,PI,IP,001,5,12880,13123,5924,243,PERF
42255321330000,PI,IP,001,6,13190,13433,5924,243,PERF
42255321330000,PI,IP,001,7,13500,13743,5924,243,PERF
42255321330000,PI,IP,001,8,13810,14053,5924,243,PERF
42255321330000,PI,IP,001,9,14120,14363,5924,243,PERF
42255321330000,PI,IP,001,10,14430,14673,5924,243,PERF
42255321330000,PI,IP,001,11,14740,14983,5924,243,PERF
42255321330000,PI,IP,001,12,15050,15293,5924,243,PERF
42255321330000,PI,IP,001,13,15360,15603,5924,243,PERF
42255321330000,PI,IP,001,14,15670,15913,5924,243,PERF
42255321330000,PI,IP,001,15,15980,16223,5924,243,PERF
42255321330000,PI,IP,001,16,16226,16377,5924,151,PERF
42255321340000,PI,IP,001,1,11206,11358,5703,152,PERF
42255321340000,PI,IP,001,2,11434,11586,5703,152,PERF
42255321340000,PI,IP,001,3,11662,11814,5703,152,PERF
42255321340000,PI,IP,001,4,11890,12042,5703,152,PERF
42255321340000,PI,IP,001,5,12118,12270,5703,152,PERF
42255321340000,PI,IP,001,6,12428,12580,5703,152,PERF
42255321340000,PI,IP,001,7,12656,12808,5703,152,PERF
42255321340000,PI,IP,001,8,12884,13036,5703,152,PERF
42255321340000,PI,IP,001,9,13112,13264,5703,152,PERF
42255321340000,PI,IP,001,10,13340,13492,5703,152,PERF
42255321340000,PI,IP,001,11,13568,13720,5703,152,PERF
42255321340000,PI,IP,001,12,13796,13948,5703,152,PERF
42255321340000,PI,IP,001,13,14024,14176,5703,152,PERF
42255321340000,PI,IP,001,14,14252,14404,5703,152,PERF
42255321340000,PI,IP,001,15,14480,14632,5703,152,PERF
42255321340000,PI,IP,001,16,14708,14860,5703,152,PERF
42255321340000,PI,IP,001,17,14936,15088,5703,152,PERF
42255321340000,PI,IP,001,18,15164,15316,5703,152,PERF
42255321340000,PI,IP,001,19,15392,15544,5703,152,PERF
42255321340000,PI,IP,001,20,15620,15772,5703,152,PERF
42255321340000,PI,IP,001,21,15848,16000,5703,152,PERF
42255321350000,PI,IP,001,1,12380,17078,4998,4698,PERF
42255321360000,PI,IP,001,1,10820,11015,6137,195,PERF
42255321360000,PI,IP,001,2,11090,11285,6137,195,PERF
42255321360000,PI,IP,001,3,11360,11555,6137,195,PERF
42255321360000,PI,IP,001,4,11630,11853,6137,223,PERF
42255321360000,PI,IP,001,5,11928,12151,6137,223,PERF
42255321360000,PI,IP,001,6,12226,12449,6137,223,PERF
42255321360000,PI,IP,001,7,12524,12748,6137,224,PERF
42255321360000,PI,IP,001,8,12823,13046,6137,223,PERF
42255321360000,PI,IP,001,9,13121,13344,6137,223,PERF
42255321360000,PI,IP,001,10,13419,13642,6137,223,PERF
42255321360000,PI,IP,001,11,13717,13940,6137,223,PERF
42255321360000,PI,IP,001,12,14015,14238,6137,223,PERF
42255321360000,PI,IP,001,13,14313,14536,6137,223,PERF
42255321360000,PI,IP,001,14,14611,14834,6137,223,PERF
42255321360000,PI,IP,001,15,14909,15132,6137,223,PERF
42255321360000,PI,IP,001,16,15207,15430,6137,223,PERF
42255321360000,PI,IP,001,17,15630,15852,6137,222,PERF
42255321360000,PI,IP,001,18,15927,16150,6137,223,PERF
42255321370000,PI,IP,001,1,11533,11776,6108,243,PERF
42255321370000,PI,IP,001,2,11853,12089,6108,236,PERF
42255321370000,PI,IP,001,3,12170,12416,6108,246,PERF
42255321370000,PI,IP,001,4,12493,12736,6108,243,PERF
42255321370000,PI,IP,001,5,12813,13056,6108,243,PERF
42255321370000,PI,IP,001,6,13133,13376,6108,243,PERF
42255321370000,PI,IP,001,7,13453,13696,6108,243,PERF
42255321370000,PI,IP,001,8,13773,14016,6108,243,PERF
42255321370000,PI,IP,001,9,14093,14336,6108,243,PERF
42255321370000,PI,IP,001,10,14413,14656,6108,243,PERF
42255321370000,PI,IP,001,11,14733,14976,6108,243,PERF
42255321370000,PI,IP,001,12,15053,15296,6108,243,PERF
42255321370000,PI,IP,001,13,15373,15616,6108,243,PERF
42255321370000,PI,IP,001,14,15693,15936,6108,243,PERF
42255321370000,PI,IP,001,15,16013,16256,6108,243,PERF
42255321370000,PI,IP,001,16,16333,16576,6108,243,PERF
42255321370000,PI,IP,001,17,16653,16895,6108,242,PERF
42255321380000,PI,IP,001,1,10870,11068,5822,198,PERF
42255321380000,PI,IP,001,2,11143,11340,5822,197,PERF
42255321380000,PI,IP,001,3,11415,11613,5822,198,PERF
42255321380000,PI,IP,001,4,11688,11885,5822,197,PERF
42255321380000,PI,IP,001,5,11960,12158,5822,198,PERF
42255321380000,PI,IP,001,6,12233,12430,5822,197,PERF
42255321380000,PI,IP,001,7,12505,12703,5822,198,PERF
42255321380000,PI,IP,001,8,12778,12975,5822,197,PERF
42255321380000,PI,IP,001,9,13050,13248,5822,198,PERF
42255321380000,PI,IP,001,10,13323,13520,5822,197,PERF
42255321380000,PI,IP,001,11,13595,13793,5822,198,PERF
42255321380000,PI,IP,001,12,13868,14065,5822,197,PERF
42255321380000,PI,IP,001,13,14140,14338,5822,198,PERF
42255321380000,PI,IP,001,14,14413,14610,5822,197,PERF
42255321380000,PI,IP,001,15,14685,14883,5822,198,PERF
42255321380000,PI,IP,001,16,14958,15155,5822,197,PERF
42255321380000,PI,IP,001,17,15230,15428,5822,198,PERF
42255321380000,PI,IP,001,18,15503,15700,5822,197,PERF
42255321390000,PI,IP,001,1,10702,14153,4118,3451,PERF
42255321400000,PI,IP,001,1,10567,14763,4757,4196,PERF
42255321410000,PI,IP,001,1,15270,15508,7270,238,PERF
42255321410000,PI,IP,001,2,15580,15827,7270,247,PERF
42255321410000,PI,IP,001,3,15890,16167,7270,277,PERF
42255321410000,PI,IP,001,4,16186,16442,7270,256,PERF
42255321410000,PI,IP,001,5,16510,16752,7270,242,PERF
42255321410000,PI,IP,001,6,16820,17062,7270,242,PERF
42255321410000,PI,IP,001,7,17130,17372,7270,242,PERF
42255321410000,PI,IP,001,8,17442,17682,7270,240,PERF
42255321420000,PI,IP,001,1,10592,13797,3635,3205,PERF
42255321430000,PI,IP,001,1,11789,12030,5850,241,PERF
42255321430000,PI,IP,001,2,12109,12352,5850,243,PERF
42255321430000,PI,IP,001,3,12429,12672,5850,243,PERF
42255321430000,PI,IP,001,4,12749,12992,5850,243,PERF
42255321430000,PI,IP,001,5,13074,13307,5850,233,PERF
42255321430000,PI,IP,001,6,13389,13632,5850,243,PERF
42255321430000,PI,IP,001,7,13709,13953,5850,244,PERF
42255321430000,PI,IP,001,8,14035,14267,5850,232,PERF
42255321430000,PI,IP,001,9,14349,14592,5850,243,PERF
42255321430000,PI,IP,001,10,14669,14912,5850,243,PERF
42255321430000,PI,IP,001,11,14989,15232,5850,243,PERF
42255321430000,PI,IP,001,12,15309,15552,5850,243,PERF
42255321430000,PI,IP,001,13,15629,15872,5850,243,PERF
42255321430000,PI,IP,001,14,15941,16122,5850,181,PERF
42255321430000,PI,IP,001,15,16169,16325,5850,156,PERF
42255321430000,PI,IP,001,16,16597,16834,5850,237,PERF
42255321440000,PI,IP,001,1,9775,9945,6117,170,PERF
42255321440000,PI,IP,001,2,10020,10200,6117,180,PERF
42255321440000,PI,IP,001,3,11348,11573,6117,225,PERF
42255321440000,PI,IP,001,4,11653,11878,6117,225,PERF
42255321440000,PI,IP,001,5,11958,12183,6117,225,PERF
42255321440000,PI,IP,001,6,12263,12488,6117,225,PERF
42255321440000,PI,IP,001,7,12568,12793,6117,225,PERF
42255321440000,PI,IP,001,8,12873,13098,6117,225,PERF
42255321440000,PI,IP,001,9,13178,13403,6117,225,PERF
42255321440000,PI,IP,001,10,13483,13708,6117,225,PERF
42255321440000,PI,IP,001,11,13788,14013,6117,225,PERF
42255321440000,PI,IP,001,12,14093,14318,6117,225,PERF
42255321440000,PI,IP,001,13,14398,14623,6117,225,PERF
42255321440000,PI,IP,001,14,14703,14928,6117,225,PERF
42255321440000,PI,IP,001,15,15008,15223,6117,215,PERF
42255321450000,PI,IP,001,1,9690,9900,6086,210,PERF
42255321450000,PI,IP,001,2,9975,10200,6086,225,PERF
42255321450000,PI,IP,001,3,10275,10500,6086,225,PERF
42255321450000,PI,IP,001,4,11247,11472,6086,225,PERF
42255321450000,PI,IP,001,5,11552,11777,6086,225,PERF
42255321450000,PI,IP,001,6,11857,12082,6086,225,PERF
42255321450000,PI,IP,001,7,12162,12387,6086,225,PERF
42255321450000,PI,IP,001,8,12467,12692,6086,225,PERF
42255321450000,PI,IP,001,9,12772,12997,6086,225,PERF
42255321450000,PI,IP,001,10,13077,13302,6086,225,PERF
42255321450000,PI,IP,001,11,13382,13607,6086,225,PERF
42255321450000,PI,IP,001,12,13687,13912,6086,225,PERF
42255321450000,PI,IP,001,13,13992,14217,6086,225,PERF
42255321450000,PI,IP,001,14,14297,14522,6086,225,PERF
42255321450000,PI,IP,001,15,14602,14827,6086,225,PERF
42255321450000,PI,IP,001,16,14907,15132,6086,225,PERF
42255321460000,PI,IP,001,1,11752,11993,5659,241,PERF
42255321460000,PI,IP,001,2,12063,12303,5659,240,PERF
42255321460000,PI,IP,001,3,12373,12613,5659,240,PERF
42255321460000,PI,IP,001,4,12683,12923,5659,240,PERF
42255321460000,PI,IP,001,5,12993,13233,5659,240,PERF
42255321460000,PI,IP,001,6,13303,13543,5659,240,PERF
42255321460000,PI,IP,001,7,13613,13853,5659,240,PERF
42255321460000,PI,IP,001,8,13923,14163,5659,240,PERF
42255321460000,PI,IP,001,9,14233,14473,5659,240,PERF
42255321460000,PI,IP,001,10,14543,14783,5659,240,PERF
42255321460000,PI,IP,001,11,14853,15093,5659,240,PERF
42255321460000,PI,IP,001,12,15163,15403,5659,240,PERF
42255321460000,PI,IP,001,13,15473,15713,5659,240,PERF
42255321460000,PI,IP,001,14,15783,16023,5659,240,PERF
42255321460000,PI,IP,001,15,16093,16333,5659,240,PERF
42255321460000,PI,IP,001,16,16403,16646,5659,243,PERF
42255321460000,PI,IP,001,17,16728,16954,5659,226,PERF
42255321470000,PI,IP,001,1,13019,17537,4582,4518,PERF
42255321480000,PI,IP,001,1,12930,17326,5124,4396,PERF
42255321490000,PI,IP,001,1,10547,13863,3783,3316,PERF
42255321500000,PI,IP,001,1,10707,15257,4818,4550,PERF
42255321520000,PI,IP,001,1,12014,12241,5749,227,PERF
42255321520000,PI,IP,001,2,12309,12536,5749,227,PERF
42255321520000,PI,IP,001,3,12610,12827,5749,217,PERF
42255321520000,PI,IP,001,4,12899,13126,5749,227,PERF
42255321520000,PI,IP,001,5,13194,13421,5749,227,PERF
42255321520000,PI,IP,001,6,13489,13716,5749,227,PERF
42255321520000,PI,IP,001,7,13784,14011,5749,227,PERF
42255321520000,PI,IP,001,8,14079,14304,5749,225,PERF
42255321520000,PI,IP,001,9,14374,14599,5749,225,PERF
42255321520000,PI,IP,001,10,14669,14894,5749,225,PERF
42255321520000,PI,IP,001,11,14964,15189,5749,225,PERF
42255321520000,PI,IP,001,12,15259,15484,5749,225,PERF
42255321520000,PI,IP,001,13,15554,15779,5749,225,PERF
42255321520000,PI,IP,001,14,15849,16074,5749,225,PERF
42255321520000,PI,IP,001,15,16144,16369,5749,225,PERF
42255321520000,PI,IP,001,16,16439,16664,5749,225,PERF
42255321520000,PI,IP,001,17,16749,16975,5749,226,PERF
42255321530000,PI,IP,001,1,13205,19122,6818,5917,PERF
42255321540000,PI,IP,001,1,11253,15931,5268,4678,PERF
42255321550000,PI,IP,001,1,11195,15582,5053,4387,PERF
42255321560000,PI,IP,001,1,11204,15017,4479,3813,PERF
42255321570000,PI,IP,001,1,10643,15171,4831,4528,PERF
42255321580000,PI,IP,001,1,11501,11737,6081,236,PERF
42255321580000,PI,IP,001,2,11826,12064,6081,238,PERF
42255321580000,PI,IP,001,3,12141,12384,6081,243,PERF
42255321580000,PI,IP,001,4,12461,12704,6081,243,PERF
42255321580000,PI,IP,001,5,12781,13024,6081,243,PERF
42255321580000,PI,IP,001,6,13105,13338,6081,233,PERF
42255321580000,PI,IP,001,7,13421,13664,6081,243,PERF
42255321580000,PI,IP,001,8,13741,13981,6081,240,PERF
42255321580000,PI,IP,001,9,14061,14324,6081,263,PERF
42255321580000,PI,IP,001,10,14381,14624,6081,243,PERF
42255321580000,PI,IP,001,11,14701,14944,6081,243,PERF
42255321580000,PI,IP,001,12,15021,15264,6081,243,PERF
42255321580000,PI,IP,001,13,15341,15574,6081,233,PERF
42255321580000,PI,IP,001,14,15658,15904,6081,246,PERF
42255321580000,PI,IP,001,15,15981,16224,6081,243,PERF
42255321580000,PI,IP,001,16,16301,16381,6081,80,PERF
42255321590000,PI,IP,001,1,9285,9420,5568,135,PERF
42255321590000,PI,IP,001,2,9495,9630,5568,135,PERF
42255321590000,PI,IP,001,3,9705,9840,5568,135,PERF
42255321590000,PI,IP,001,4,9915,10050,5568,135,PERF
42255321590000,PI,IP,001,5,10125,10260,5568,135,PERF
42255321590000,PI,IP,001,6,10335,10470,5568,135,PERF
42255321590000,PI,IP,001,7,10545,10680,5568,135,PERF
42255321590000,PI,IP,001,8,10755,10890,5568,135,PERF
42255321590000,PI,IP,001,9,10965,11100,5568,135,PERF
42255321590000,PI,IP,001,10,11175,11310,5568,135,PERF
42255321590000,PI,IP,001,11,11385,11520,5568,135,PERF
42255321590000,PI,IP,001,12,11595,11730,5568,135,PERF
42255321590000,PI,IP,001,13,11805,11940,5568,135,PERF
42255321590000,PI,IP,001,14,12015,12150,5568,135,PERF
42255321590000,PI,IP,001,15,12225,12375,5568,150,PERF
42255321590000,PI,IP,001,16,12450,12600,5568,150,PERF
42255321590000,PI,IP,001,17,12675,12825,5568,150,PERF
42255321590000,PI,IP,001,18,12900,13050,5568,150,PERF
42255321590000,PI,IP,001,19,13125,13275,5568,150,PERF
42255321590000,PI,IP,001,20,13350,13500,5568,150,PERF
42255321590000,PI,IP,001,21,13575,13725,5568,150,PERF
42255321590000,PI,IP,001,22,13800,13950,5568,150,PERF
42255321590000,PI,IP,001,23,14025,14250,5568,225,PERF
42255321600000,PI,IP,001,1,12079,12321,6260,242,PERF
42255321600000,PI,IP,001,2,12399,12641,6260,242,PERF
42255321600000,PI,IP,001,3,12719,12961,6260,242,PERF
42255321600000,PI,IP,001,4,13039,13281,6260,242,PERF
42255321600000,PI,IP,001,5,13359,13601,6260,242,PERF
42255321600000,PI,IP,001,6,13679,13921,6260,242,PERF
42255321600000,PI,IP,001,7,13999,14241,6260,242,PERF
42255321600000,PI,IP,001,8,14316,14558,6260,242,PERF
42255321600000,PI,IP,001,9,14639,14881,6260,242,PERF
42255321600000,PI,IP,001,10,14959,15201,6260,242,PERF
42255321600000,PI,IP,001,11,15281,15521,6260,240,PERF
42255321600000,PI,IP,001,12,15601,15841,6260,240,PERF
42255321600000,PI,IP,001,13,15917,16161,6260,244,PERF
42255321600000,PI,IP,001,14,16239,16481,6260,242,PERF
42255321600000,PI,IP,001,15,16563,16801,6260,238,PERF
42255321600000,PI,IP,001,16,16879,17123,6260,244,PERF
42255321600000,PI,IP,001,17,17199,17361,6260,162,PERF
42255321600000,PI,IP,001,18,17519,17761,6260,242,PERF
42255321610000,PI,IP,001,1,12015,12265,5505,250,PERF
42255321610000,PI,IP,001,2,12345,12587,5505,242,PERF
42255321610000,PI,IP,001,3,12671,12905,5505,234,PERF
42255321610000,PI,IP,001,4,12985,13227,5505,242,PERF
42255321610000,PI,IP,001,5,13305,13547,5505,242,PERF
42255321610000,PI,IP,001,6,13625,13867,5505,242,PERF
42255321610000,PI,IP,001,7,13945,14187,5505,242,PERF
42255321610000,PI,IP,001,8,14265,14507,5505,242,PERF
42255321610000,PI,IP,001,9,14585,14832,5505,247,PERF
42255321610000,PI,IP,001,10,14905,15147,5505,242,PERF
42255321610000,PI,IP,001,11,15225,15467,5505,242,PERF
42255321610000,PI,IP,001,12,15545,15787,5505,242,PERF
42255321610000,PI,IP,001,13,15865,16107,5505,242,PERF
42255321610000,PI,IP,001,14,16185,16427,5505,242,PERF
42255321610000,PI,IP,001,15,16505,16747,5505,242,PERF
42255321610000,PI,IP,001,16,16826,17068,5505,242,PERF
42255321620000,PI,IP,001,1,9268,9406,5361,138,PERF
42255321620000,PI,IP,001,2,9481,9619,5361,138,PERF
42255321620000,PI,IP,001,3,9694,9832,5361,138,PERF
42255321620000,PI,IP,001,4,9907,10045,5361,138,PERF
42255321620000,PI,IP,001,5,10120,10259,5361,139,PERF
42255321620000,PI,IP,001,6,10334,10473,5361,139,PERF
42255321620000,PI,IP,001,7,10548,10687,5361,139,PERF
42255321620000,PI,IP,001,8,10762,10902,5361,140,PERF
42255321620000,PI,IP,001,9,10977,11116,5361,139,PERF
42255321620000,PI,IP,001,10,11191,11330,5361,139,PERF
42255321620000,PI,IP,001,11,11405,11544,5361,139,PERF
42255321620000,PI,IP,001,12,11619,11759,5361,140,PERF
42255321620000,PI,IP,001,13,11834,11973,5361,139,PERF
42255321620000,PI,IP,001,14,12048,12187,5361,139,PERF
42255321620000,PI,IP,001,15,12262,12401,5361,139,PERF
42255321620000,PI,IP,001,16,12476,12616,5361,140,PERF
42255321620000,PI,IP,001,17,12691,12830,5361,139,PERF
42255321620000,PI,IP,001,18,12905,13044,5361,139,PERF
42255321620000,PI,IP,001,19,13119,13258,5361,139,PERF
42255321620000,PI,IP,001,20,13333,13473,5361,140,PERF
42255321620000,PI,IP,001,21,13548,13687,5361,139,PERF
42255321620000,PI,IP,001,22,13762,13901,5361,139,PERF
42255321620000,PI,IP,001,23,13976,14185,5361,209,PERF
42255321630000,PI,IP,001,1,13650,19802,6569,6152,PERF
42255321640000,PI,IP,001,1,11475,11687,5017,212,PERF
42255321640000,PI,IP,001,2,11783,12023,5017,240,PERF
42255321640000,PI,IP,001,3,12093,12333,5017,240,PERF
42255321640000,PI,IP,001,4,12403,12643,5017,240,PERF
42255321640000,PI,IP,001,5,12713,12953,5017,240,PERF
42255321640000,PI,IP,001,6,13023,13263,5017,240,PERF
42255321640000,PI,IP,001,7,13333,13573,5017,240,PERF
42255321640000,PI,IP,001,8,13643,13883,5017,240,PERF
42255321640000,PI,IP,001,9,13953,14193,5017,240,PERF
42255321640000,PI,IP,001,10,14263,14503,5017,240,PERF
42255321640000,PI,IP,001,11,14573,14813,5017,240,PERF
42255321640000,PI,IP,001,12,14883,15123,5017,240,PERF
42255321640000,PI,IP,001,13,15193,15433,5017,240,PERF
42255321640000,PI,IP,001,14,15503,15743,5017,240,PERF
42255321650000,PI,IP,001,1,11522,11762,4491,240,PERF
42255321650000,PI,IP,001,2,11832,12072,4491,240,PERF
42255321650000,PI,IP,001,3,12142,12382,4491,240,PERF
42255321650000,PI,IP,001,4,12452,12692,4491,240,PERF
42255321650000,PI,IP,001,5,12762,13002,4491,240,PERF
42255321650000,PI,IP,001,6,13072,13312,4491,240,PERF
42255321650000,PI,IP,001,7,13382,13622,4491,240,PERF
42255321650000,PI,IP,001,8,13692,13932,4491,240,PERF
42255321650000,PI,IP,001,9,14002,14242,4491,240,PERF
42255321650000,PI,IP,001,10,14312,14452,4491,140,PERF
42255321650000,PI,IP,001,11,14622,14862,4491,240,PERF
42255321650000,PI,IP,001,12,14932,15174,4491,242,PERF
42255321660000,PI,IP,001,1,11360,11579,5568,219,PERF
42255321660000,PI,IP,001,2,11657,11869,5568,212,PERF
42255321660000,PI,IP,001,3,11947,12129,5568,182,PERF
42255321660000,PI,IP,001,4,12204,12389,5568,185,PERF
42255321660000,PI,IP,001,5,12467,12649,5568,182,PERF
42255321660000,PI,IP,001,6,12727,12909,5568,182,PERF
42255321660000,PI,IP,001,7,12985,13161,5568,176,PERF
42255321660000,PI,IP,001,8,13247,13429,5568,182,PERF
42255321660000,PI,IP,001,9,13507,13689,5568,182,PERF
42255321660000,PI,IP,001,10,13767,13949,5568,182,PERF
42255321660000,PI,IP,001,11,14027,14209,5568,182,PERF
42255321660000,PI,IP,001,12,14287,14469,5568,182,PERF
42255321660000,PI,IP,001,13,14547,14669,5568,122,PERF
42255321660000,PI,IP,001,14,14747,14929,5568,182,PERF
42255321660000,PI,IP,001,15,15007,15189,5568,182,PERF
42255321660000,PI,IP,001,16,15267,15449,5568,182,PERF
42255321660000,PI,IP,001,17,15527,15709,5568,182,PERF
42255321660000,PI,IP,001,18,15787,15969,5568,182,PERF
42255321660000,PI,IP,001,19,16047,16229,5568,182,PERF
42255321660000,PI,IP,001,20,16307,16484,5568,177,PERF
42255321670000,PI,IP,001,1,10738,14347,4587,3609,PERF
42255321680000,PI,IP,001,1,10788,14350,4282,3562,PERF
42255321690000,PI,IP,001,1,12555,12752,6066,197,PERF
42255321690000,PI,IP,001,2,12815,13027,6066,212,PERF
42255321690000,PI,IP,001,3,13090,13302,6066,212,PERF
42255321690000,PI,IP,001,4,13365,13577,6066,212,PERF
42255321690000,PI,IP,001,5,13640,13852,6066,212,PERF
42255321690000,PI,IP,001,6,13915,14127,6066,212,PERF
42255321690000,PI,IP,001,7,14190,14402,6066,212,PERF
42255321690000,PI,IP,001,8,14465,14677,6066,212,PERF
42255321690000,PI,IP,001,9,14740,14952,6066,212,PERF
42255321690000,PI,IP,001,10,15015,15227,6066,212,PERF
42255321690000,PI,IP,001,11,15290,15502,6066,212,PERF
42255321690000,PI,IP,001,12,15565,15777,6066,212,PERF
42255321690000,PI,IP,001,13,15840,16052,6066,212,PERF
42255321690000,PI,IP,001,14,16115,16327,6066,212,PERF
42255321690000,PI,IP,001,15,16390,16602,6066,212,PERF
42255321690000,PI,IP,001,16,16665,16877,6066,212,PERF
42255321690000,PI,IP,001,17,16940,17152,6066,212,PERF
42255321690000,PI,IP,001,18,17215,17427,6066,212,PERF
42255321690000,PI,IP,001,19,17490,17492,6066,2,PERF
42255321700000,PI,IP,001,1,11795,12032,5540,237,PERF
42255321700000,PI,IP,001,2,12105,12342,5540,237,PERF
42255321700000,PI,IP,001,3,12415,12652,5540,237,PERF
42255321700000,PI,IP,001,4,12725,12967,5540,242,PERF
42255321700000,PI,IP,001,5,13035,13277,5540,242,PERF
42255321700000,PI,IP,001,6,13345,13587,5540,242,PERF
42255321700000,PI,IP,001,7,13655,13897,5540,242,PERF
42255321700000,PI,IP,001,8,13965,14207,5540,242,PERF
42255321700000,PI,IP,001,9,14442,14492,5540,50,PERF
42255321700000,PI,IP,001,10,14585,14827,5540,242,PERF
42255321700000,PI,IP,001,11,14895,15137,5540,242,PERF
42255321700000,PI,IP,001,12,15205,15447,5540,242,PERF
42255321700000,PI,IP,001,13,15515,15740,5540,225,PERF
42255321700000,PI,IP,001,14,15825,16067,5540,242,PERF
42255321700000,PI,IP,001,15,16135,16377,5540,242,PERF
42255321710000,PI,IP,001,1,13727,18376,5469,4649,PERF
42255321720000,PI,IP,001,1,12841,13033,4095,192,PERF
42255321720000,PI,IP,001,2,13113,13305,4095,192,PERF
42255321720000,PI,IP,001,3,13385,13577,4095,192,PERF
42255321720000,PI,IP,001,4,13657,13850,4095,193,PERF
42255321720000,PI,IP,001,5,13930,14122,4095,192,PERF
42255321720000,PI,IP,001,6,14202,14394,4095,192,PERF
42255321720000,PI,IP,001,7,14474,14666,4095,192,PERF
42255321720000,PI,IP,001,8,14746,14938,4095,192,PERF
42255321720000,PI,IP,001,9,15018,15210,4095,192,PERF
42255321720000,PI,IP,001,10,15290,15482,4095,192,PERF
42255321720000,PI,IP,001,11,15562,15755,4095,193,PERF
42255321720000,PI,IP,001,12,15835,16027,4095,192,PERF
42255321720000,PI,IP,001,13,16107,16299,4095,192,PERF
42255321720000,PI,IP,001,14,16313,16500,4095,187,PERF
42255321740000,PI,IP,001,1,11915,12157,6321,242,PERF
42255321740000,PI,IP,001,2,12230,12472,6321,242,PERF
42255321740000,PI,IP,001,3,12545,12787,6321,242,PERF
42255321740000,PI,IP,001,4,12860,13102,6321,242,PERF
42255321740000,PI,IP,001,5,13175,13417,6321,242,PERF
42255321740000,PI,IP,001,6,13805,14047,6321,242,PERF
42255321740000,PI,IP,001,7,14120,14362,6321,242,PERF
42255321740000,PI,IP,001,8,14435,14677,6321,242,PERF
42255321740000,PI,IP,001,9,14750,14992,6321,242,PERF
42255321740000,PI,IP,001,10,15065,15308,6321,243,PERF
42255321740000,PI,IP,001,11,15380,15617,6321,237,PERF
42255321740000,PI,IP,001,12,15695,15937,6321,242,PERF
42255321740000,PI,IP,001,13,16010,16252,6321,242,PERF
42255321740000,PI,IP,001,14,16322,16567,6321,245,PERF
42255321740000,PI,IP,001,15,16640,16882,6321,242,PERF
42255321740000,PI,IP,001,16,16955,17197,6321,242,PERF
42255321750000,PI,IP,001,1,12008,12235,6950,227,PERF
42255321750000,PI,IP,001,2,12303,12534,6950,231,PERF
42255321750000,PI,IP,001,3,12598,12825,6950,227,PERF
42255321750000,PI,IP,001,4,12893,13120,6950,227,PERF
42255321750000,PI,IP,001,5,13188,13415,6950,227,PERF
42255321750000,PI,IP,001,6,13488,13710,6950,222,PERF
42255321750000,PI,IP,001,7,13776,14005,6950,229,PERF
42255321750000,PI,IP,001,8,14073,14300,6950,227,PERF
42255321750000,PI,IP,001,9,14368,14595,6950,227,PERF
42255321750000,PI,IP,001,10,14663,14887,6950,224,PERF
42255321750000,PI,IP,001,11,14958,15185,6950,227,PERF
42255321750000,PI,IP,001,12,15253,15480,6950,227,PERF
42255321750000,PI,IP,001,13,15548,15775,6950,227,PERF
42255321750000,PI,IP,001,14,15843,16070,6950,227,PERF
42255321750000,PI,IP,001,15,16138,16365,6950,227,PERF
42255321750000,PI,IP,001,16,16433,16660,6950,227,PERF
42255321750000,PI,IP,001,17,16728,16955,6950,227,PERF
42255321750000,PI,IP,001,18,17023,17265,6950,242,PERF
42255321760000,PI,IP,001,1,12251,16762,4850,4511,PERF
42255321780000,PI,IP,001,1,13449,17871,5079,4422,PERF
42255321790000,PI,IP,001,1,12126,16334,4565,4208,PERF
42255321800000,PI,IP,001,1,11567,16523,5585,4956,PERF
42255321820000,PI,IP,001,1,11002,11233,6306,231,PERF
42255321820000,PI,IP,001,2,11282,11513,6306,231,PERF
42255321820000,PI,IP,001,3,11562,11793,6306,231,PERF
42255321820000,PI,IP,001,4,11842,12073,6306,231,PERF
42255321820000,PI,IP,001,5,12122,12353,6306,231,PERF
42255321820000,PI,IP,001,6,12402,12633,6306,231,PERF
42255321820000,PI,IP,001,7,12682,12913,6306,231,PERF
42255321820000,PI,IP,001,8,12962,13193,6306,231,PERF
42255321820000,PI,IP,001,9,13242,13473,6306,231,PERF
42255321820000,PI,IP,001,10,13522,13753,6306,231,PERF
42255321820000,PI,IP,001,11,13802,14033,6306,231,PERF
42255321820000,PI,IP,001,12,14082,14313,6306,231,PERF
42255321820000,PI,IP,001,13,14362,14593,6306,231,PERF
42255321820000,PI,IP,001,14,14642,14873,6306,231,PERF
42255321820000,PI,IP,001,15,14922,15153,6306,231,PERF
42255321820000,PI,IP,001,16,15202,15433,6306,231,PERF
42255321820000,PI,IP,001,17,15482,15713,6306,231,PERF
42255321820000,PI,IP,001,18,15762,15993,6306,231,PERF
42255321820000,PI,IP,001,19,16042,16272,6306,230,PERF
42255321840000,PI,IP,001,1,11007,15200,4750,4193,PERF
42255321850000,PI,IP,001,1,11131,15282,4665,4151,PERF
42255321860000,PI,IP,001,1,11112,15305,4793,4193,PERF
42255321870000,PI,IP,001,1,10700,10944,6078,244,PERF
42255321870000,PI,IP,001,2,11026,11273,6078,247,PERF
42255321870000,PI,IP,001,3,11353,11599,6078,246,PERF
42255321870000,PI,IP,001,4,11678,11925,6078,247,PERF
42255321870000,PI,IP,001,5,12125,12363,6078,238,PERF
42255321870000,PI,IP,001,6,12438,12676,6078,238,PERF
42255321870000,PI,IP,001,7,12751,12988,6078,237,PERF
42255321870000,PI,IP,001,8,13066,13302,6078,236,PERF
42255321870000,PI,IP,001,9,13377,13609,6078,232,PERF
42255321870000,PI,IP,001,10,13691,13924,6078,233,PERF
42255321870000,PI,IP,001,11,14002,14240,6078,238,PERF
42255321870000,PI,IP,001,12,14315,14553,6078,238,PERF
42255321870000,PI,IP,001,13,14628,14824,6078,196,PERF
42255321880000,PI,IP,001,1,10680,14540,4460,3860,PERF
42255321890000,PI,IP,001,1,11339,16289,5673,4950,PERF
42255321900000,PI,IP,001,1,10620,10842,6190,222,PERF
42255321900000,PI,IP,001,2,10912,11133,6190,221,PERF
42255321900000,PI,IP,001,3,11207,11425,6190,218,PERF
42255321900000,PI,IP,001,4,11625,11859,6190,234,PERF
42255321900000,PI,IP,001,5,11933,12165,6190,232,PERF
42255321900000,PI,IP,001,6,12231,12474,6190,243,PERF
42255321900000,PI,IP,001,7,12548,12778,6190,230,PERF
42255321900000,PI,IP,001,8,12856,13089,6190,233,PERF
42255321900000,PI,IP,001,9,13163,13384,6190,221,PERF
42255321900000,PI,IP,001,10,13471,13705,6190,234,PERF
42255321900000,PI,IP,001,11,13781,14007,6190,226,PERF
42255321900000,PI,IP,001,12,14088,14317,6190,229,PERF
42255321900000,PI,IP,001,13,14394,14631,6190,237,PERF
42255321900000,PI,IP,001,14,14701,14935,6190,234,PERF
42255321900000,PI,IP,001,15,15009,15243,6190,234,PERF
42255321900000,PI,IP,001,16,15317,15550,6190,233,PERF
42255321900000,PI,IP,001,17,15624,15858,6190,234,PERF
42255321900000,PI,IP,001,18,15932,16160,6190,228,PERF
42255321940000,PI,IP,001,1,9240,9381,4452,141,PERF
42255321940000,PI,IP,001,2,9456,9597,4452,141,PERF
42255321940000,PI,IP,001,3,9672,9813,4452,141,PERF
42255321940000,PI,IP,001,4,9888,10028,4452,140,PERF
42255321940000,PI,IP,001,5,10103,10244,4452,141,PERF
42255321940000,PI,IP,001,6,10319,10460,4452,141,PERF
42255321940000,PI,IP,001,7,10535,10676,4452,141,PERF
42255321940000,PI,IP,001,8,10751,10881,4452,130,PERF
42255321940000,PI,IP,001,9,10956,11097,4452,141,PERF
42255321940000,PI,IP,001,10,11172,11313,4452,141,PERF
42255321940000,PI,IP,001,11,11388,11528,4452,140,PERF
42255321940000,PI,IP,001,12,11603,11744,4452,141,PERF
42255321940000,PI,IP,001,13,11819,11960,4452,141,PERF
42255321940000,PI,IP,001,14,12035,12165,4452,130,PERF
42255321940000,PI,IP,001,15,12240,12370,4452,130,PERF
42255321940000,PI,IP,001,16,12445,12555,4452,110,PERF
42255321940000,PI,IP,001,17,12630,12740,4452,110,PERF
42255321940000,PI,IP,001,18,12815,12925,4452,110,PERF
42255321940000,PI,IP,001,19,13000,13110,4452,110,PERF
42255321940000,PI,IP,001,20,13185,13350,4452,165,PERF
42255321950000,PI,IP,001,1,9324,9456,4734,132,PERF
42255321950000,PI,IP,001,2,9531,9664,4734,133,PERF
42255321950000,PI,IP,001,3,9739,9872,4734,133,PERF
42255321950000,PI,IP,001,4,9947,10079,4734,132,PERF
42255321950000,PI,IP,001,5,10154,10287,4734,133,PERF
42255321950000,PI,IP,001,6,10362,10495,4734,133,PERF
42255321950000,PI,IP,001,7,10570,10702,4734,132,PERF
42255321950000,PI,IP,001,8,10777,10910,4734,133,PERF
42255321950000,PI,IP,001,9,10985,11118,4734,133,PERF
42255321950000,PI,IP,001,10,11193,11325,4734,132,PERF
42255321950000,PI,IP,001,11,11400,11533,4734,133,PERF
42255321950000,PI,IP,001,12,11608,11741,4734,133,PERF
42255321950000,PI,IP,001,13,11816,11948,4734,132,PERF
42255321950000,PI,IP,001,14,12023,12156,4734,133,PERF
42255321950000,PI,IP,001,15,12231,12363,4734,132,PERF
42255321950000,PI,IP,001,16,12438,12571,4734,133,PERF
42255321950000,PI,IP,001,17,12646,12779,4734,133,PERF
42255321950000,PI,IP,001,18,12854,12986,4734,132,PERF
42255321950000,PI,IP,001,19,13061,13194,4734,133,PERF
42255321950000,PI,IP,001,20,13269,13468,4734,199,PERF
42255321970000,PI,IP,001,1,13203,17096,4603,3893,PERF
42255321980000,PI,IP,001,1,10899,14878,4546,3979,PERF
42255321990000,PI,IP,001,1,10825,14725,4368,3900,PERF
42255322000000,PI,IP,001,1,14985,18000,5741,3015,PERF
42255322010000,PI,IP,001,1,9955,14708,5321,4753,PERF
42255322030000,PI,IP,001,1,10285,14566,4887,4281,PERF
42255322060000,PI,IP,001,1,12675,12872,5043,197,PERF
42255322060000,PI,IP,001,2,12947,13144,5043,197,PERF
42255322060000,PI,IP,001,3,13219,13416,5043,197,PERF
42255322060000,PI,IP,001,4,13491,13688,5043,197,PERF
42255322060000,PI,IP,001,5,13763,13959,5043,196,PERF
42255322060000,PI,IP,001,6,14034,14231,5043,197,PERF
42255322060000,PI,IP,001,7,14306,14503,5043,197,PERF
42255322060000,PI,IP,001,8,14578,14775,5043,197,PERF
42255322060000,PI,IP,001,9,14850,15047,5043,197,PERF
42255322060000,PI,IP,001,10,15122,15319,5043,197,PERF
42255322060000,PI,IP,001,11,15394,15591,5043,197,PERF
42255322060000,PI,IP,001,12,15666,15863,5043,197,PERF
42255322060000,PI,IP,001,13,15938,16134,5043,196,PERF
42255322060000,PI,IP,001,14,16209,16406,5043,197,PERF
42255322060000,PI,IP,001,15,16481,16678,5043,197,PERF
42255322060000,PI,IP,001,16,16753,16950,5043,197,PERF
42255322070100,PI,IP,001,1,12113,16299,5873,4186,PERF
42255322080000,PI,IP,001,1,12542,16822,5387,4280,PERF
42255322090000,PI,IP,001,1,12428,16913,5507,4485,PERF
42255322100000,PI,IP,001,1,11397,16219,5865,4822,PERF
42255322110100,PI,IP,001,1,13340,18541,6323,5201,PERF
42255322120000,PI,IP,001,1,10550,15210,5034,4660,PERF
42255322140000,PI,IP,001,1,10775,15582,5270,4807,PERF
42255322150000,PI,IP,001,1,10800,15111,4813,4311,PERF
42255322160000,PI,IP,001,1,13590,17902,4955,4312,PERF
42255322170100,PI,IP,001,1,12795,13001,4600,206,PERF
42255322170100,PI,IP,001,2,13076,13282,4600,206,PERF
42255322170100,PI,IP,001,3,13357,13563,4600,206,PERF
42255322170100,PI,IP,001,4,13638,13845,4600,207,PERF
42255322170100,PI,IP,001,5,13920,14126,4600,206,PERF
42255322170100,PI,IP,001,6,14201,14407,4600,206,PERF
42255322170100,PI,IP,001,7,14482,14688,4600,206,PERF
42255322170100,PI,IP,001,8,14763,14969,4600,206,PERF
42255322170100,PI,IP,001,9,15044,15250,4600,206,PERF
42255322170100,PI,IP,001,10,15325,15531,4600,206,PERF
42255322170100,PI,IP,001,11,15606,15813,4600,207,PERF
42255322170100,PI,IP,001,12,15888,16094,4600,206,PERF
42255322170100,PI,IP,001,13,16169,16375,4600,206,PERF
42255322170100,PI,IP,001,14,16450,16656,4600,206,PERF
42255322190000,PI,IP,001,1,11084,11326,5090,242,PERF
42255322190000,PI,IP,001,2,11394,11636,5090,242,PERF
42255322190000,PI,IP,001,3,11704,11946,5090,242,PERF
42255322190000,PI,IP,001,4,12014,12250,5090,236,PERF
42255322190000,PI,IP,001,5,12324,12566,5090,242,PERF
42255322190000,PI,IP,001,6,12634,12874,5090,240,PERF
42255322190000,PI,IP,001,7,12944,13186,5090,242,PERF
42255322190000,PI,IP,001,8,13254,13496,5090,242,PERF
42255322190000,PI,IP,001,9,13564,13806,5090,242,PERF
42255322190000,PI,IP,001,10,13874,14116,5090,242,PERF
42255322190000,PI,IP,001,11,14184,14426,5090,242,PERF
42255322190000,PI,IP,001,12,14494,14733,5090,239,PERF
42255322190000,PI,IP,001,13,14806,15044,5090,238,PERF
42255322190000,PI,IP,001,14,15114,15356,5090,242,PERF
42255322200000,PI,IP,001,1,11183,11418,6688,235,PERF
42255322200000,PI,IP,001,2,11491,11718,6688,227,PERF
42255322200000,PI,IP,001,3,11786,12048,6688,262,PERF
42255322200000,PI,IP,001,4,12081,12302,6688,221,PERF
42255322200000,PI,IP,001,5,12376,12603,6688,227,PERF
42255322200000,PI,IP,001,6,12671,12898,6688,227,PERF
42255322200000,PI,IP,001,7,12966,13193,6688,227,PERF
42255322200000,PI,IP,001,8,13261,13488,6688,227,PERF
42255322200000,PI,IP,001,9,13631,13783,6688,152,PERF
42255322200000,PI,IP,001,10,13851,14078,6688,227,PERF
42255322200000,PI,IP,001,11,14146,14373,6688,227,PERF
42255322200000,PI,IP,001,12,14441,14668,6688,227,PERF
42255322200000,PI,IP,001,13,14736,14963,6688,227,PERF
42255322200000,PI,IP,001,14,15033,15256,6688,223,PERF
42255322200000,PI,IP,001,15,15326,15553,6688,227,PERF
42255322200000,PI,IP,001,16,15625,15848,6688,223,PERF
42255322200000,PI,IP,001,17,15916,16143,6688,227,PERF
42255322200000,PI,IP,001,18,16211,16438,6688,227,PERF
42255322200000,PI,IP,001,19,16506,16733,6688,227,PERF
42255322200000,PI,IP,001,20,16801,17043,6688,242,PERF
42255322210000,PI,IP,001,1,11030,11252,5072,222,PERF
42255322210000,PI,IP,001,2,11298,11519,5072,221,PERF
42255322210000,PI,IP,001,3,11565,11786,5072,221,PERF
42255322210000,PI,IP,001,4,11832,12053,5072,221,PERF
42255322210000,PI,IP,001,5,12099,12320,5072,221,PERF
42255322210000,PI,IP,001,6,12366,12587,5072,221,PERF
42255322210000,PI,IP,001,7,12633,12854,5072,221,PERF
42255322210000,PI,IP,001,8,12900,13121,5072,221,PERF
42255322210000,PI,IP,001,9,13167,13388,5072,221,PERF
42255322210000,PI,IP,001,10,13434,13655,5072,221,PERF
42255322210000,PI,IP,001,11,13701,13922,5072,221,PERF
42255322210000,PI,IP,001,12,13968,14189,5072,221,PERF
42255322210000,PI,IP,001,13,14235,14456,5072,221,PERF
42255322210000,PI,IP,001,14,14502,14723,5072,221,PERF
42255322210000,PI,IP,001,15,14769,14990,5072,221,PERF
42255322210000,PI,IP,001,16,15036,15257,5072,221,PERF
42255322210000,PI,IP,001,17,15303,15523,5072,220,PERF
42255322220000,PI,IP,001,1,12638,12880,5051,242,PERF
42255322220000,PI,IP,001,2,12948,13190,5051,242,PERF
42255322220000,PI,IP,001,3,13258,13500,5051,242,PERF
42255322220000,PI,IP,001,4,13568,13812,5051,244,PERF
42255322220000,PI,IP,001,5,13878,14117,5051,239,PERF
42255322220000,PI,IP,001,6,14188,14430,5051,242,PERF
42255322220000,PI,IP,001,7,14498,14740,5051,242,PERF
42255322220000,PI,IP,001,8,14806,15050,5051,244,PERF
42255322220000,PI,IP,001,9,15118,15360,5051,242,PERF
42255322220000,PI,IP,001,10,15428,15670,5051,242,PERF
42255322220000,PI,IP,001,11,15675,15887,5051,212,PERF
42255322220000,PI,IP,001,12,16048,16290,5051,242,PERF
42255322220000,PI,IP,001,13,16360,16600,5051,240,PERF
42255322220000,PI,IP,001,14,16710,16910,5051,200,PERF
42255322230000,PI,IP,001,1,13416,19808,6633,6392,PERF
42255322240000,PI,IP,001,1,13198,18161,5285,4963,PERF
42255322250000,PI,IP,001,1,13352,17632,4919,4280,PERF
42255322260000,PI,IP,001,1,12355,12557,5617,202,PERF
42255322260000,PI,IP,001,2,12635,12837,5617,202,PERF
42255322260000,PI,IP,001,3,12915,13112,5617,197,PERF
42255322260000,PI,IP,001,4,13195,13407,5617,212,PERF
42255322260000,PI,IP,001,5,13475,13672,5617,197,PERF
42255322260000,PI,IP,001,6,13755,13967,5617,212,PERF
42255322260000,PI,IP,001,7,14039,14247,5617,208,PERF
42255322260000,PI,IP,001,8,14315,14527,5617,212,PERF
42255322260000,PI,IP,001,9,14595,14807,5617,212,PERF
42255322260000,PI,IP,001,10,14875,15072,5617,197,PERF
42255322260000,PI,IP,001,11,15155,15157,5617,2,PERF
42255322260000,PI,IP,001,12,15430,15647,5617,217,PERF
42255322260000,PI,IP,001,13,15720,15927,5617,207,PERF
42255322260000,PI,IP,001,14,15995,16207,5617,212,PERF
42255322260000,PI,IP,001,15,16275,16487,5617,212,PERF
42255322260000,PI,IP,001,16,16555,16767,5617,212,PERF
42255322260000,PI,IP,001,17,16835,17047,5617,212,PERF
42255322270000,PI,IP,001,1,10431,13620,3889,3189,PERF
42255322290000,PI,IP,001,1,9849,13845,4651,3996,PERF
42255322300000,PI,IP,001,1,12317,16181,6092,3864,PERF
42255322310000,PI,IP,001,1,11543,11785,6884,242,PERF
42255322310000,PI,IP,001,2,11863,12105,6884,242,PERF
42255322310000,PI,IP,001,3,12183,12425,6884,242,PERF
42255322310000,PI,IP,001,4,12503,12745,6884,242,PERF
42255322310000,PI,IP,001,5,12823,13062,6884,239,PERF
42255322310000,PI,IP,001,6,13297,13383,6884,86,PERF
42255322310000,PI,IP,001,7,13462,13705,6884,243,PERF
42255322310000,PI,IP,001,8,13783,14022,6884,239,PERF
42255322310000,PI,IP,001,9,14106,14345,6884,239,PERF
42255322310000,PI,IP,001,10,14423,14662,6884,239,PERF
42255322310000,PI,IP,001,11,14743,14985,6884,242,PERF
42255322310000,PI,IP,001,12,15063,15305,6884,242,PERF
42255322310000,PI,IP,001,13,15383,15625,6884,242,PERF
42255322310000,PI,IP,001,14,15703,15945,6884,242,PERF
42255322310000,PI,IP,001,15,16023,16265,6884,242,PERF
42255322310000,PI,IP,001,16,16343,16585,6884,242,PERF
42255322310000,PI,IP,001,17,16663,16910,6884,247,PERF
42255322310000,PI,IP,001,18,17063,17225,6884,162,PERF
42255322310000,PI,IP,001,19,17303,17545,6884,242,PERF
42255322320000,PI,IP,001,1,10897,16609,6405,5712,PERF
42255322360000,PI,IP,001,1,10430,14113,4344,3683,PERF
42255322370000,PI,IP,001,1,10504,13870,4102,3366,PERF
42255322380000,PI,IP,001,1,9670,9880,6116,210,PERF
42255322380000,PI,IP,001,2,9955,10165,6116,210,PERF
42255322380000,PI,IP,001,3,10240,10450,6116,210,PERF
42255322380000,PI,IP,001,4,11287,11467,6116,180,PERF
42255322380000,PI,IP,001,5,11542,11720,6116,178,PERF
42255322380000,PI,IP,001,6,11795,12005,6116,210,PERF
42255322380000,PI,IP,001,7,12080,12290,6116,210,PERF
42255322380000,PI,IP,001,8,12365,12575,6116,210,PERF
42255322380000,PI,IP,001,9,12650,12860,6116,210,PERF
42255322380000,PI,IP,001,10,12935,13145,6116,210,PERF
42255322380000,PI,IP,001,11,13220,13430,6116,210,PERF
42255322380000,PI,IP,001,12,13505,13715,6116,210,PERF
42255322380000,PI,IP,001,13,13891,14101,6116,210,PERF
42255322380000,PI,IP,001,14,14176,14386,6116,210,PERF
42255322380000,PI,IP,001,15,14461,14671,6116,210,PERF
42255322380000,PI,IP,001,16,14746,14956,6116,210,PERF
42255322380000,PI,IP,001,17,15031,15241,6116,210,PERF
42255322390000,PI,IP,001,1,12783,18396,6233,5613,PERF
42255322400000,PI,IP,001,1,10475,14734,4659,4259,PERF
42255322420000,PI,IP,001,1,11650,11892,6530,242,PERF
42255322420000,PI,IP,001,2,11970,12212,6530,242,PERF
42255322420000,PI,IP,001,3,12290,12532,6530,242,PERF
42255322420000,PI,IP,001,4,12606,12852,6530,246,PERF
42255322420000,PI,IP,001,5,12930,13172,6530,242,PERF
42255322420000,PI,IP,001,6,13250,13496,6530,246,PERF
42255322420000,PI,IP,001,7,13570,13812,6530,242,PERF
42255322420000,PI,IP,001,8,13890,14126,6530,236,PERF
42255322420000,PI,IP,001,9,14210,14452,6530,242,PERF
42255322420000,PI,IP,001,10,14530,14774,6530,244,PERF
42255322420000,PI,IP,001,11,14850,15093,6530,243,PERF
42255322420000,PI,IP,001,12,15170,15412,6530,242,PERF
42255322420000,PI,IP,001,13,15488,15730,6530,242,PERF
42255322420000,PI,IP,001,14,15810,16052,6530,242,PERF
42255322420000,PI,IP,001,15,16135,16372,6530,237,PERF
42255322420000,PI,IP,001,16,16452,16692,6530,240,PERF
42255322420000,PI,IP,001,17,16770,16932,6530,162,PERF
42255322420000,PI,IP,001,18,17010,17312,6530,302,PERF
42255322430000,PI,IP,001,1,13425,17160,4859,3735,PERF
42255322450000,PI,IP,001,1,12120,12332,7762,212,PERF
42255322450000,PI,IP,001,2,12395,12607,7762,212,PERF
42255322450000,PI,IP,001,3,12670,12882,7762,212,PERF
42255322450000,PI,IP,001,4,12945,13157,7762,212,PERF
42255322450000,PI,IP,001,5,13220,13422,7762,202,PERF
42255322450000,PI,IP,001,6,13495,13697,7762,202,PERF
42255322450000,PI,IP,001,7,13770,13982,7762,212,PERF
42255322450000,PI,IP,001,8,14045,14257,7762,212,PERF
42255322450000,PI,IP,001,9,14320,14532,7762,212,PERF
42255322450000,PI,IP,001,10,14595,14792,7762,197,PERF
42255322450000,PI,IP,001,11,14870,15082,7762,212,PERF
42255322450000,PI,IP,001,12,15145,15357,7762,212,PERF
42255322450000,PI,IP,001,13,15420,15622,7762,202,PERF
42255322450000,PI,IP,001,14,15695,15902,7762,207,PERF
42255322450000,PI,IP,001,15,15970,16172,7762,202,PERF
42255322450000,PI,IP,001,16,16245,16447,7762,202,PERF
42255322450000,PI,IP,001,17,16520,16730,7762,210,PERF
42255322450000,PI,IP,001,18,16795,17007,7762,212,PERF
42255322450000,PI,IP,001,19,17070,17272,7762,202,PERF
42255322450000,PI,IP,001,20,17347,17545,7762,198,PERF
42255322450000,PI,IP,001,21,17620,17822,7762,202,PERF
42255322450000,PI,IP,001,22,17895,18107,7762,212,PERF
42255322450000,PI,IP,001,23,18170,18410,7762,240,PERF
42255322460000,PI,IP,001,1,12040,12250,6074,210,PERF
42255322460000,PI,IP,001,2,12280,12520,6074,240,PERF
42255322460000,PI,IP,001,3,12550,12790,6074,240,PERF
42255322460000,PI,IP,001,4,12820,13060,6074,240,PERF
42255322460000,PI,IP,001,5,13090,13330,6074,240,PERF
42255322460000,PI,IP,001,6,13360,13600,6074,240,PERF
42255322460000,PI,IP,001,7,13630,13900,6074,270,PERF
42255322460000,PI,IP,001,8,13900,14140,6074,240,PERF
42255322460000,PI,IP,001,9,14170,14410,6074,240,PERF
42255322460000,PI,IP,001,10,14440,14680,6074,240,PERF
42255322460000,PI,IP,001,11,14710,14950,6074,240,PERF
42255322460000,PI,IP,001,12,14980,15220,6074,240,PERF
42255322460000,PI,IP,001,13,15250,15490,6074,240,PERF
42255322460000,PI,IP,001,14,15520,15760,6074,240,PERF
42255322460000,PI,IP,001,15,15790,16030,6074,240,PERF
42255322460000,PI,IP,001,16,16060,16300,6074,240,PERF
42255322460000,PI,IP,001,17,16330,16570,6074,240,PERF
42255322460000,PI,IP,001,18,16600,16840,6074,240,PERF
42255322460000,PI,IP,001,19,16870,17110,6074,240,PERF
42255322460000,PI,IP,001,20,17140,17410,6074,270,PERF
42255322470000,PI,IP,001,1,13230,18916,5949,5686,PERF
42255322480000,PI,IP,001,1,11484,11702,6650,218,PERF
42255322480000,PI,IP,001,2,11780,12022,6650,242,PERF
42255322480000,PI,IP,001,3,12100,12342,6650,242,PERF
42255322480000,PI,IP,001,4,12420,12662,6650,242,PERF
42255322480000,PI,IP,001,5,12740,12982,6650,242,PERF
42255322480000,PI,IP,001,6,13066,13302,6650,236,PERF
42255322480000,PI,IP,001,7,13384,13622,6650,238,PERF
42255322480000,PI,IP,001,8,13704,13942,6650,238,PERF
42255322480000,PI,IP,001,9,14100,14342,6650,242,PERF
42255322480000,PI,IP,001,10,14420,14662,6650,242,PERF
42255322480000,PI,IP,001,11,14740,14982,6650,242,PERF
42255322480000,PI,IP,001,12,15062,15302,6650,240,PERF
42255322480000,PI,IP,001,13,15383,15622,6650,239,PERF
42255322480000,PI,IP,001,14,15706,15942,6650,236,PERF
42255322480000,PI,IP,001,15,16020,16262,6650,242,PERF
42255322480000,PI,IP,001,16,16349,16582,6650,233,PERF
42255322480000,PI,IP,001,17,17300,17542,6650,242,PERF
42255322490000,PI,IP,001,1,12240,12512,6882,272,PERF
42255322490000,PI,IP,001,2,12590,12862,6882,272,PERF
42255322490000,PI,IP,001,3,12940,13212,6882,272,PERF
42255322490000,PI,IP,001,4,13290,13532,6882,242,PERF
42255322490000,PI,IP,001,5,13612,13830,6882,218,PERF
42255322490000,PI,IP,001,6,13960,14232,6882,272,PERF
42255322490000,PI,IP,001,7,14310,14582,6882,272,PERF
42255322490000,PI,IP,001,8,14660,14932,6882,272,PERF
42255322490000,PI,IP,001,9,15010,15282,6882,272,PERF
42255322490000,PI,IP,001,10,15362,15632,6882,270,PERF
42255322490000,PI,IP,001,11,15714,15982,6882,268,PERF
42255322490000,PI,IP,001,12,16062,16332,6882,270,PERF
42255322490000,PI,IP,001,13,16414,16682,6882,268,PERF
42255322490000,PI,IP,001,14,16762,17032,6882,270,PERF
42255322490000,PI,IP,001,15,17108,17382,6882,274,PERF
42255322490000,PI,IP,001,16,17458,17732,6882,274,PERF
42255322490000,PI,IP,001,17,17810,18082,6882,272,PERF
42255322490000,PI,IP,001,18,18196,18438,6882,242,PERF
42255322500000,PI,IP,001,1,12255,12527,6234,272,PERF
42255322500000,PI,IP,001,2,12605,12877,6234,272,PERF
42255322500000,PI,IP,001,3,12955,13227,6234,272,PERF
42255322500000,PI,IP,001,4,13305,13577,6234,272,PERF
42255322500000,PI,IP,001,5,13655,13927,6234,272,PERF
42255322500000,PI,IP,001,6,14005,14277,6234,272,PERF
42255322500000,PI,IP,001,7,14355,14627,6234,272,PERF
42255322500000,PI,IP,001,8,14705,14977,6234,272,PERF
42255322500000,PI,IP,001,9,15055,15327,6234,272,PERF
42255322500000,PI,IP,001,10,15405,15677,6234,272,PERF
42255322500000,PI,IP,001,11,15755,16027,6234,272,PERF
42255322500000,PI,IP,001,12,16105,16377,6234,272,PERF
42255322500000,PI,IP,001,13,16455,16742,6234,287,PERF
42255322500000,PI,IP,001,14,16820,17107,6234,287,PERF
42255322500000,PI,IP,001,15,17185,17457,6234,272,PERF
42255322510000,PI,IP,001,1,10667,15329,5257,4662,PERF
42255322520000,PI,IP,001,1,11426,11637,4439,211,PERF
42255322520000,PI,IP,001,2,11682,11893,4439,211,PERF
42255322520000,PI,IP,001,3,11938,12149,4439,211,PERF
42255322520000,PI,IP,001,4,12194,12405,4439,211,PERF
42255322520000,PI,IP,001,5,12450,12661,4439,211,PERF
42255322520000,PI,IP,001,6,12706,12917,4439,211,PERF
42255322520000,PI,IP,001,7,12962,13173,4439,211,PERF
42255322520000,PI,IP,001,8,13218,13429,4439,211,PERF
42255322520000,PI,IP,001,9,13474,13685,4439,211,PERF
42255322520000,PI,IP,001,10,13730,13941,4439,211,PERF
42255322520000,PI,IP,001,11,13986,14197,4439,211,PERF
42255322520000,PI,IP,001,12,14242,14453,4439,211,PERF
42255322520000,PI,IP,001,13,14498,14709,4439,211,PERF
42255322520000,PI,IP,001,14,14754,14964,4439,210,PERF
42255322530000,PI,IP,001,1,10119,15821,6130,5702,PERF
42255322540000,PI,IP,001,1,13152,17050,4529,3898,PERF
42255322550000,PI,IP,001,1,12893,12894,5948,1,PERF
42255322550000,PI,IP,001,2,12953,12954,5948,1,PERF
42255322550000,PI,IP,001,3,13013,13014,5948,1,PERF
42255322550000,PI,IP,001,4,13073,13074,5948,1,PERF
42255322550000,PI,IP,001,5,13133,13134,5948,1,PERF
42255322550000,PI,IP,001,6,13203,13204,5948,1,PERF
42255322550000,PI,IP,001,7,13263,13264,5948,1,PERF
42255322550000,PI,IP,001,8,13323,13324,5948,1,PERF
42255322550000,PI,IP,001,9,13383,13384,5948,1,PERF
42255322550000,PI,IP,001,10,13443,13444,5948,1,PERF
42255322550000,PI,IP,001,11,13503,13504,5948,1,PERF
42255322550000,PI,IP,001,12,13573,13574,5948,1,PERF
42255322550000,PI,IP,001,13,13633,13634,5948,1,PERF
42255322550000,PI,IP,001,14,13693,13694,5948,1,PERF
42255322550000,PI,IP,001,15,13753,13754,5948,1,PERF
42255322550000,PI,IP,001,16,13813,13814,5948,1,PERF
42255322550000,PI,IP,001,17,13873,13874,5948,1,PERF
42255322550000,PI,IP,001,18,13943,13944,5948,1,PERF
42255322550000,PI,IP,001,19,14006,14007,5948,1,PERF
42255322550000,PI,IP,001,20,14066,14067,5948,1,PERF
42255322550000,PI,IP,001,21,14126,14127,5948,1,PERF
42255322550000,PI,IP,001,22,14186,14187,5948,1,PERF
42255322550000,PI,IP,001,23,14246,14247,5948,1,PERF
42255322550000,PI,IP,001,24,14316,14317,5948,1,PERF
42255322550000,PI,IP,001,25,14380,14381,5948,1,PERF
42255322550000,PI,IP,001,26,14440,14441,5948,1,PERF
42255322550000,PI,IP,001,27,14500,14501,5948,1,PERF
42255322550000,PI,IP,001,28,14560,14561,5948,1,PERF
42255322550000,PI,IP,001,29,14620,14621,5948,1,PERF
42255322550000,PI,IP,001,30,14688,14689,5948,1,PERF
42255322550000,PI,IP,001,31,14748,14749,5948,1,PERF
42255322550000,PI,IP,001,32,14808,14809,5948,1,PERF
42255322550000,PI,IP,001,33,14868,14869,5948,1,PERF
42255322550000,PI,IP,001,34,14928,14929,5948,1,PERF
42255322550000,PI,IP,001,35,14988,14989,5948,1,PERF
42255322550000,PI,IP,001,36,15058,15059,5948,1,PERF
42255322550000,PI,IP,001,37,15118,15119,5948,1,PERF
42255322550000,PI,IP,001,38,15182,15183,5948,1,PERF
42255322550000,PI,IP,001,39,15242,15243,5948,1,PERF
42255322550000,PI,IP,001,40,15302,15303,5948,1,PERF
42255322550000,PI,IP,001,41,15362,15363,5948,1,PERF
42255322550000,PI,IP,001,42,15432,15433,5948,1,PERF
42255322550000,PI,IP,001,43,15492,15493,5948,1,PERF
42255322550000,PI,IP,001,44,15555,15556,5948,1,PERF
42255322550000,PI,IP,001,45,15615,15616,5948,1,PERF
42255322550000,PI,IP,001,46,15675,15676,5948,1,PERF
42255322550000,PI,IP,001,47,15738,15739,5948,1,PERF
42255322550000,PI,IP,001,48,15805,15806,5948,1,PERF
42255322550000,PI,IP,001,49,15865,15866,5948,1,PERF
42255322550000,PI,IP,001,50,15925,15926,5948,1,PERF
42255322550000,PI,IP,001,51,15985,15986,5948,1,PERF
42255322550000,PI,IP,001,52,16047,16048,5948,1,PERF
42255322550000,PI,IP,001,53,16107,16108,5948,1,PERF
42255322550000,PI,IP,001,54,16177,16178,5948,1,PERF
42255322550000,PI,IP,001,55,16237,16238,5948,1,PERF
42255322550000,PI,IP,001,56,16297,16298,5948,1,PERF
42255322550000,PI,IP,001,57,16357,16358,5948,1,PERF
42255322550000,PI,IP,001,58,16417,16418,5948,1,PERF
42255322550000,PI,IP,001,59,16477,16478,5948,1,PERF
42255322550000,PI,IP,001,60,16545,16546,5948,1,PERF
42255322550000,PI,IP,001,61,16665,16666,5948,1,PERF
42255322550000,PI,IP,001,62,16669,16670,5948,1,PERF
42255322550000,PI,IP,001,63,16729,16730,5948,1,PERF
42255322550000,PI,IP,001,64,16789,16790,5948,1,PERF
42255322550000,PI,IP,001,65,16849,16850,5948,1,PERF
42255322550000,PI,IP,001,66,16914,16915,5948,1,PERF
42255322550000,PI,IP,001,67,16974,16975,5948,1,PERF
42255322550000,PI,IP,001,68,17037,17038,5948,1,PERF
42255322550000,PI,IP,001,69,17097,17098,5948,1,PERF
42255322550000,PI,IP,001,70,17157,17158,5948,1,PERF
42255322550000,PI,IP,001,71,17217,17218,5948,1,PERF
42255322550000,PI,IP,001,72,17282,17283,5948,1,PERF
42255322550000,PI,IP,001,73,17342,17343,5948,1,PERF
42255322550000,PI,IP,001,74,17402,17403,5948,1,PERF
42255322550000,PI,IP,001,75,17459,17460,5948,1,PERF
42255322550000,PI,IP,001,76,17561,17562,5948,1,PERF
42255322550000,PI,IP,001,77,17569,17570,5948,1,PERF
42255322550000,PI,IP,001,78,17644,17645,5948,1,PERF
42255322550000,PI,IP,001,79,17704,17705,5948,1,PERF
42255322550000,PI,IP,001,80,17764,17765,5948,1,PERF
42255322550000,PI,IP,001,81,17830,17831,5948,1,PERF
42255322550000,PI,IP,001,82,17890,17891,5948,1,PERF
42255322550000,PI,IP,001,83,17950,17951,5948,1,PERF
42255322550000,PI,IP,001,84,18011,18012,5948,1,PERF
42255322550000,PI,IP,001,85,18069,18070,5948,1,PERF
42255322550000,PI,IP,001,86,18127,18128,5948,1,PERF
42255322550000,PI,IP,001,87,18183,18184,5948,1,PERF
42255322550000,PI,IP,001,88,18238,18239,5948,1,PERF
42255322550000,PI,IP,001,89,18293,18294,5948,1,PERF
42255322560000,PI,IP,001,1,10900,15610,5519,4710,PERF
42255322570000,PI,IP,001,1,10740,15568,5124,4828,PERF
42255322580000,PI,IP,001,1,10900,15420,5260,4520,PERF
42255322590000,PI,IP,001,1,10852,15314,5034,4462,PERF
42255322600000,PI,IP,001,1,12535,12807,6301,272,PERF
42255322600000,PI,IP,001,2,12880,13152,6301,272,PERF
42255322600000,PI,IP,001,3,13225,13497,6301,272,PERF
42255322600000,PI,IP,001,4,13570,13842,6301,272,PERF
42255322600000,PI,IP,001,5,13915,14187,6301,272,PERF
42255322600000,PI,IP,001,6,14260,14532,6301,272,PERF
42255322600000,PI,IP,001,7,14605,14850,6301,245,PERF
42255322600000,PI,IP,001,8,14877,15222,6301,345,PERF
42255322600000,PI,IP,001,9,15295,15567,6301,272,PERF
42255322600000,PI,IP,001,10,15640,15906,6301,266,PERF
42255322600000,PI,IP,001,11,15985,16257,6301,272,PERF
42255322600000,PI,IP,001,12,16330,16662,6301,332,PERF
42255322600000,PI,IP,001,13,16675,16945,6301,270,PERF
42255322600000,PI,IP,001,14,17022,17290,6301,268,PERF
42255322600000,PI,IP,001,15,17368,17640,6301,272,PERF
42255322610000,PI,IP,001,1,9641,9788,6640,147,PERF
42255322610000,PI,IP,001,2,9858,10008,6640,150,PERF
42255322610000,PI,IP,001,3,10078,10228,6640,150,PERF
42255322610000,PI,IP,001,4,10298,10448,6640,150,PERF
42255322610000,PI,IP,001,5,10518,10668,6640,150,PERF
42255322610000,PI,IP,001,6,10738,10888,6640,150,PERF
42255322610000,PI,IP,001,7,10958,11108,6640,150,PERF
42255322610000,PI,IP,001,8,11974,12163,6640,189,PERF
42255322610000,PI,IP,001,9,12238,12427,6640,189,PERF
42255322610000,PI,IP,001,10,12502,12691,6640,189,PERF
42255322610000,PI,IP,001,11,12766,12955,6640,189,PERF
42255322610000,PI,IP,001,12,13030,13222,6640,192,PERF
42255322610000,PI,IP,001,13,13297,13489,6640,192,PERF
42255322610000,PI,IP,001,14,13654,13756,6640,102,PERF
42255322610000,PI,IP,001,15,13831,14023,6640,192,PERF
42255322610000,PI,IP,001,16,14098,14290,6640,192,PERF
42255322610000,PI,IP,001,17,14365,14557,6640,192,PERF
42255322610000,PI,IP,001,18,14632,14824,6640,192,PERF
42255322610000,PI,IP,001,19,14899,15091,6640,192,PERF
42255322610000,PI,IP,001,20,15166,15358,6640,192,PERF
42255322620000,PI,IP,001,1,9758,9981,6709,223,PERF
42255322620000,PI,IP,001,2,10049,10265,6709,216,PERF
42255322620000,PI,IP,001,3,10362,10581,6709,219,PERF
42255322620000,PI,IP,001,4,10656,10881,6709,225,PERF
42255322620000,PI,IP,001,5,10949,11154,6709,205,PERF
42255322620000,PI,IP,001,6,11256,11481,6709,225,PERF
42255322620000,PI,IP,001,7,11556,11781,6709,225,PERF
42255322620000,PI,IP,001,8,11856,12081,6709,225,PERF
42255322620000,PI,IP,001,9,12825,13035,6709,210,PERF
42255322620000,PI,IP,001,10,13107,13304,6709,197,PERF
42255322620000,PI,IP,001,11,13396,13589,6709,193,PERF
42255322620000,PI,IP,001,12,13680,13890,6709,210,PERF
42255322620000,PI,IP,001,13,13968,14175,6709,207,PERF
42255322620000,PI,IP,001,14,14247,14434,6709,187,PERF
42255322620000,PI,IP,001,15,14532,14729,6709,197,PERF
42255322620000,PI,IP,001,16,14817,15014,6709,197,PERF
42255322620000,PI,IP,001,17,15102,15299,6709,197,PERF
42255322620000,PI,IP,001,18,15390,15600,6709,210,PERF
42255322630000,PI,IP,001,1,11765,15720,4663,3955,PERF
42255322640000,PI,IP,001,1,14052,18907,5535,4855,PERF
42255322680000,PI,IP,001,1,10742,15408,5032,4666,PERF
42255322700000,PI,IP,001,1,10790,15280,4968,4490,PERF
42255322710000,PI,IP,001,1,12350,12622,6041,272,PERF
42255322710000,PI,IP,001,2,12700,12970,6041,270,PERF
42255322710000,PI,IP,001,3,13050,13322,6041,272,PERF
42255322710000,PI,IP,001,4,13400,13672,6041,272,PERF
42255322710000,PI,IP,001,5,13740,14012,6041,272,PERF
42255322710000,PI,IP,001,6,14080,14352,6041,272,PERF
42255322710000,PI,IP,001,7,14420,14692,6041,272,PERF
42255322710000,PI,IP,001,8,14760,15032,6041,272,PERF
42255322710000,PI,IP,001,9,15100,15372,6041,272,PERF
42255322710000,PI,IP,001,10,15440,15712,6041,272,PERF
42255322710000,PI,IP,001,11,15780,16052,6041,272,PERF
42255322710000,PI,IP,001,12,16120,16392,6041,272,PERF
42255322710000,PI,IP,001,13,16458,16732,6041,274,PERF
42255322710000,PI,IP,001,14,16800,17072,6041,272,PERF
42255322710000,PI,IP,001,15,17140,17412,6041,272,PERF
42255322720100,PI,IP,001,1,12460,12650,5659,190,PERF
42255322720100,PI,IP,001,2,12725,12915,5659,190,PERF
42255322720100,PI,IP,001,3,12990,13180,5659,190,PERF
42255322720100,PI,IP,001,4,13255,13445,5659,190,PERF
42255322720100,PI,IP,001,5,13520,13711,5659,191,PERF
42255322720100,PI,IP,001,6,13786,13976,5659,190,PERF
42255322720100,PI,IP,001,7,14051,14241,5659,190,PERF
42255322720100,PI,IP,001,8,14316,14506,5659,190,PERF
42255322720100,PI,IP,001,9,14581,14771,5659,190,PERF
42255322720100,PI,IP,001,10,14846,15036,5659,190,PERF
42255322720100,PI,IP,001,11,15111,15301,5659,190,PERF
42255322720100,PI,IP,001,12,15376,15566,5659,190,PERF
42255322720100,PI,IP,001,13,15641,15831,5659,190,PERF
42255322720100,PI,IP,001,14,15906,16096,5659,190,PERF
42255322720100,PI,IP,001,15,16171,16362,5659,191,PERF
42255322720100,PI,IP,001,16,16437,16627,5659,190,PERF
42255322720100,PI,IP,001,17,16702,16892,5659,190,PERF
42255322720100,PI,IP,001,18,16967,17157,5659,190,PERF
42255322720100,PI,IP,001,19,17232,17422,5659,190,PERF
42255322720100,PI,IP,001,20,17497,17687,5659,190,PERF
42255322730000,PI,IP,001,1,12532,12734,6035,202,PERF
42255322730000,PI,IP,001,2,12809,13011,6035,202,PERF
42255322730000,PI,IP,001,3,13086,13288,6035,202,PERF
42255322730000,PI,IP,001,4,13363,13565,6035,202,PERF
42255322730000,PI,IP,001,5,13640,13842,6035,202,PERF
42255322730000,PI,IP,001,6,13917,14119,6035,202,PERF
42255322730000,PI,IP,001,7,14194,14396,6035,202,PERF
42255322730000,PI,IP,001,8,14471,14673,6035,202,PERF
42255322730000,PI,IP,001,9,14748,14950,6035,202,PERF
42255322730000,PI,IP,001,10,15025,15227,6035,202,PERF
42255322730000,PI,IP,001,11,15320,15504,6035,184,PERF
42255322730000,PI,IP,001,12,15579,15781,6035,202,PERF
42255322730000,PI,IP,001,13,15856,16058,6035,202,PERF
42255322730000,PI,IP,001,14,16133,16355,6035,222,PERF
42255322730000,PI,IP,001,15,16410,16612,6035,202,PERF
42255322730000,PI,IP,001,16,16687,16889,6035,202,PERF
42255322730000,PI,IP,001,17,16964,17166,6035,202,PERF
42255322730000,PI,IP,001,18,17241,17443,6035,202,PERF
42255322730000,PI,IP,001,19,17518,17720,6035,202,PERF
42255322730000,PI,IP,001,20,17795,17997,6035,202,PERF
42255322740000,PI,IP,001,1,12497,12707,6094,210,PERF
42255322740000,PI,IP,001,2,12782,12991,6094,209,PERF
42255322740000,PI,IP,001,3,13066,13276,6094,210,PERF
42255322740000,PI,IP,001,4,13351,13560,6094,209,PERF
42255322740000,PI,IP,001,5,13635,13845,6094,210,PERF
42255322740000,PI,IP,001,6,13920,14129,6094,209,PERF
42255322740000,PI,IP,001,7,14204,14414,6094,210,PERF
42255322740000,PI,IP,001,8,14489,14698,6094,209,PERF
42255322740000,PI,IP,001,9,14773,14983,6094,210,PERF
42255322740000,PI,IP,001,10,15058,15267,6094,209,PERF
42255322740000,PI,IP,001,11,15342,15552,6094,210,PERF
42255322740000,PI,IP,001,12,15627,15836,6094,209,PERF
42255322740000,PI,IP,001,13,15911,16121,6094,210,PERF
42255322740000,PI,IP,001,14,16196,16405,6094,209,PERF
42255322740000,PI,IP,001,15,16480,16690,6094,210,PERF
42255322740000,PI,IP,001,16,16765,16974,6094,209,PERF
42255322740000,PI,IP,001,17,17049,17259,6094,210,PERF
42255322740000,PI,IP,001,18,17334,17543,6094,209,PERF
42255322740000,PI,IP,001,19,17618,17828,6094,210,PERF
42255322740000,PI,IP,001,20,17903,18112,6094,209,PERF
42255322750000,PI,IP,001,1,12633,12811,4433,178,PERF
42255322750000,PI,IP,001,2,12868,13045,4433,177,PERF
42255322750000,PI,IP,001,3,13104,13281,4433,177,PERF
42255322750000,PI,IP,001,4,13340,13517,4433,177,PERF
42255322750000,PI,IP,001,5,13576,13753,4433,177,PERF
42255322750000,PI,IP,001,6,13812,13993,4433,181,PERF
42255322750000,PI,IP,001,7,14048,14229,4433,181,PERF
42255322750000,PI,IP,001,8,14284,14455,4433,171,PERF
42255322750000,PI,IP,001,9,14520,14685,4433,165,PERF
42255322750000,PI,IP,001,10,14756,14907,4433,151,PERF
42255322750000,PI,IP,001,11,14987,15149,4433,162,PERF
42255322750000,PI,IP,001,12,15225,15404,4433,179,PERF
42255322750000,PI,IP,001,13,15733,15929,4433,196,PERF
42255322750000,PI,IP,001,14,16012,16220,4433,208,PERF
42255322760000,PI,IP,001,1,12914,13121,7338,207,PERF
42255322760000,PI,IP,001,2,13189,13401,7338,212,PERF
42255322760000,PI,IP,001,3,13469,13681,7338,212,PERF
42255322760000,PI,IP,001,4,13749,13891,7338,142,PERF
42255322760000,PI,IP,001,5,14029,14241,7338,212,PERF
42255322760000,PI,IP,001,6,14309,14521,7338,212,PERF
42255322760000,PI,IP,001,7,14589,14801,7338,212,PERF
42255322760000,PI,IP,001,8,14869,15081,7338,212,PERF
42255322760000,PI,IP,001,9,15149,15361,7338,212,PERF
42255322760000,PI,IP,001,10,15429,15641,7338,212,PERF
42255322760000,PI,IP,001,11,15709,15921,7338,212,PERF
42255322760000,PI,IP,001,12,15989,16201,7338,212,PERF
42255322760000,PI,IP,001,13,16268,16481,7338,213,PERF
42255322760000,PI,IP,001,14,16549,16761,7338,212,PERF
42255322760000,PI,IP,001,15,16829,17041,7338,212,PERF
42255322760000,PI,IP,001,16,17109,17321,7338,212,PERF
42255322760000,PI,IP,001,17,17389,17559,7338,170,PERF
42255322760000,PI,IP,001,18,17669,17881,7338,212,PERF
42255322760000,PI,IP,001,19,17951,18161,7338,210,PERF
42255322760000,PI,IP,001,20,18229,18441,7338,212,PERF
42255322760000,PI,IP,001,21,18509,18751,7338,242,PERF
42255322780000,PI,IP,001,1,12734,12926,4422,192,PERF
42255322780000,PI,IP,001,2,13001,13193,4422,192,PERF
42255322780000,PI,IP,001,3,13268,13460,4422,192,PERF
42255322780000,PI,IP,001,4,13535,13727,4422,192,PERF
42255322780000,PI,IP,001,5,13802,13994,4422,192,PERF
42255322780000,PI,IP,001,6,14069,14261,4422,192,PERF
42255322780000,PI,IP,001,7,14336,14528,4422,192,PERF
42255322780000,PI,IP,001,8,14603,14794,4422,191,PERF
42255322780000,PI,IP,001,9,14869,15061,4422,192,PERF
42255322780000,PI,IP,001,10,15136,15328,4422,192,PERF
42255322780000,PI,IP,001,11,15403,15595,4422,192,PERF
42255322780000,PI,IP,001,12,15670,15862,4422,192,PERF
42255322780000,PI,IP,001,13,15937,16129,4422,192,PERF
42255322780000,PI,IP,001,14,16204,16396,4422,192,PERF
42255322780000,PI,IP,001,15,16471,16663,4422,192,PERF
42255322790000,PI,IP,001,1,13224,19066,6902,5842,PERF
42255322800000,PI,IP,001,1,11537,16499,5758,4962,PERF
42255322810000,PI,IP,001,1,12867,12868,6267,1,PERF
42255322810000,PI,IP,001,2,12927,12928,6267,1,PERF
42255322810000,PI,IP,001,3,12987,12988,6267,1,PERF
42255322810000,PI,IP,001,4,13047,13048,6267,1,PERF
42255322810000,PI,IP,001,5,13107,13108,6267,1,PERF
42255322810000,PI,IP,001,6,13172,13173,6267,1,PERF
42255322810000,PI,IP,001,7,13232,13233,6267,1,PERF
42255322810000,PI,IP,001,8,13292,13293,6267,1,PERF
42255322810000,PI,IP,001,9,13352,13353,6267,1,PERF
42255322810000,PI,IP,001,10,13412,13413,6267,1,PERF
42255322810000,PI,IP,001,11,13477,13478,6267,1,PERF
42255322810000,PI,IP,001,12,13537,13538,6267,1,PERF
42255322810000,PI,IP,001,13,13595,13596,6267,1,PERF
42255322810000,PI,IP,001,14,13655,13656,6267,1,PERF
42255322810000,PI,IP,001,15,13715,13716,6267,1,PERF
42255322810000,PI,IP,001,16,13775,13776,6267,1,PERF
42255322810000,PI,IP,001,17,13840,13841,6267,1,PERF
42255322810000,PI,IP,001,18,13900,13901,6267,1,PERF
42255322810000,PI,IP,001,19,13965,13966,6267,1,PERF
42255322810000,PI,IP,001,20,14025,14026,6267,1,PERF
42255322810000,PI,IP,001,21,14085,14086,6267,1,PERF
42255322810000,PI,IP,001,22,14149,14150,6267,1,PERF
42255322810000,PI,IP,001,23,14214,14215,6267,1,PERF
42255322810000,PI,IP,001,24,14274,14275,6267,1,PERF
42255322810000,PI,IP,001,25,14339,14340,6267,1,PERF
42255322810000,PI,IP,001,26,14399,14400,6267,1,PERF
42255322810000,PI,IP,001,27,14459,14460,6267,1,PERF
42255322810000,PI,IP,001,28,14519,14520,6267,1,PERF
42255322810000,PI,IP,001,29,14584,14585,6267,1,PERF
42255322810000,PI,IP,001,30,14644,14645,6267,1,PERF
42255322810000,PI,IP,001,31,14709,14710,6267,1,PERF
42255322810000,PI,IP,001,32,14769,14770,6267,1,PERF
42255322810000,PI,IP,001,33,14829,14830,6267,1,PERF
42255322810000,PI,IP,001,34,14889,14890,6267,1,PERF
42255322810000,PI,IP,001,35,14954,14955,6267,1,PERF
42255322810000,PI,IP,001,36,15014,15015,6267,1,PERF
42255322810000,PI,IP,001,37,15074,15075,6267,1,PERF
42255322810000,PI,IP,001,38,15130,15131,6267,1,PERF
42255322810000,PI,IP,001,39,15190,15191,6267,1,PERF
42255322810000,PI,IP,001,40,15250,15251,6267,1,PERF
42255322810000,PI,IP,001,41,15317,15318,6267,1,PERF
42255322810000,PI,IP,001,42,15377,15378,6267,1,PERF
42255322810000,PI,IP,001,43,15437,15438,6267,1,PERF
42255322810000,PI,IP,001,44,15497,15498,6267,1,PERF
42255322810000,PI,IP,001,45,15557,15558,6267,1,PERF
42255322810000,PI,IP,001,46,15617,15618,6267,1,PERF
42255322810000,PI,IP,001,47,15682,15683,6267,1,PERF
42255322810000,PI,IP,001,48,15742,15743,6267,1,PERF
42255322810000,PI,IP,001,49,15802,15803,6267,1,PERF
42255322810000,PI,IP,001,50,15862,15863,6267,1,PERF
42255322810000,PI,IP,001,51,15920,15921,6267,1,PERF
42255322810000,PI,IP,001,52,15980,15981,6267,1,PERF
42255322810000,PI,IP,001,53,16045,16046,6267,1,PERF
42255322810000,PI,IP,001,54,16105,16106,6267,1,PERF
42255322810000,PI,IP,001,55,16170,16171,6267,1,PERF
42255322810000,PI,IP,001,56,16230,16231,6267,1,PERF
42255322810000,PI,IP,001,57,16290,16291,6267,1,PERF
42255322810000,PI,IP,001,58,16350,16351,6267,1,PERF
42255322810000,PI,IP,001,59,16415,16416,6267,1,PERF
42255322810000,PI,IP,001,60,16475,16476,6267,1,PERF
42255322810000,PI,IP,001,61,16535,16536,6267,1,PERF
42255322810000,PI,IP,001,62,16590,16591,6267,1,PERF
42255322810000,PI,IP,001,63,16650,16651,6267,1,PERF
42255322810000,PI,IP,001,64,16710,16711,6267,1,PERF
42255322810000,PI,IP,001,65,16778,16779,6267,1,PERF
42255322810000,PI,IP,001,66,16838,16839,6267,1,PERF
42255322810000,PI,IP,001,67,16898,16899,6267,1,PERF
42255322810000,PI,IP,001,68,16965,16966,6267,1,PERF
42255322810000,PI,IP,001,69,17025,17026,6267,1,PERF
42255322810000,PI,IP,001,70,17085,17086,6267,1,PERF
42255322810000,PI,IP,001,71,17150,17151,6267,1,PERF
42255322810000,PI,IP,001,72,17210,17211,6267,1,PERF
42255322810000,PI,IP,001,73,17270,17271,6267,1,PERF
42255322810000,PI,IP,001,74,17330,17331,6267,1,PERF
42255322810000,PI,IP,001,75,17390,17391,6267,1,PERF
42255322810000,PI,IP,001,76,17450,17451,6267,1,PERF
42255322820000,PI,IP,001,1,11929,12201,7127,272,PERF
42255322820000,PI,IP,001,2,12279,12549,7127,270,PERF
42255322820000,PI,IP,001,3,12629,12901,7127,272,PERF
42255322820000,PI,IP,001,4,12979,13251,7127,272,PERF
42255322820000,PI,IP,001,5,13329,13601,7127,272,PERF
42255322820000,PI,IP,001,6,13679,13951,7127,272,PERF
42255322820000,PI,IP,001,7,14029,14301,7127,272,PERF
42255322820000,PI,IP,001,8,14379,14651,7127,272,PERF
42255322820000,PI,IP,001,9,14729,15001,7127,272,PERF
42255322820000,PI,IP,001,10,15079,15351,7127,272,PERF
42255322820000,PI,IP,001,11,15429,15701,7127,272,PERF
42255322820000,PI,IP,001,12,15779,16051,7127,272,PERF
42255322820000,PI,IP,001,13,16129,16401,7127,272,PERF
42255322820000,PI,IP,001,14,16479,16751,7127,272,PERF
42255322820000,PI,IP,001,15,16829,17101,7127,272,PERF
42255322820000,PI,IP,001,16,17179,17451,7127,272,PERF
42255322820000,PI,IP,001,17,17529,17801,7127,272,PERF
42255322820000,PI,IP,001,18,17881,18151,7127,270,PERF
42255322820000,PI,IP,001,19,18256,18438,7127,182,PERF
42255322830000,PI,IP,001,1,11771,15226,4134,3455,PERF
42255322840000,PI,IP,001,1,12859,12860,5892,1,PERF
42255322840000,PI,IP,001,2,12917,12918,5892,1,PERF
42255322840000,PI,IP,001,3,12977,12978,5892,1,PERF
42255322840000,PI,IP,001,4,13037,13038,5892,1,PERF
42255322840000,PI,IP,001,5,13100,13101,5892,1,PERF
42255322840000,PI,IP,001,6,13170,13171,5892,1,PERF
42255322840000,PI,IP,001,7,13235,13236,5892,1,PERF
42255322840000,PI,IP,001,8,13295,13296,5892,1,PERF
42255322840000,PI,IP,001,9,13355,13356,5892,1,PERF
42255322840000,PI,IP,001,10,13422,13423,5892,1,PERF
42255322840000,PI,IP,001,11,13482,13483,5892,1,PERF
42255322840000,PI,IP,001,12,13552,13553,5892,1,PERF
42255322840000,PI,IP,001,13,13612,13613,5892,1,PERF
42255322840000,PI,IP,001,14,13672,13673,5892,1,PERF
42255322840000,PI,IP,001,15,13732,13733,5892,1,PERF
42255322840000,PI,IP,001,16,13790,13791,5892,1,PERF
42255322840000,PI,IP,001,17,13850,13851,5892,1,PERF
42255322840000,PI,IP,001,18,13920,13921,5892,1,PERF
42255322840000,PI,IP,001,19,13980,13981,5892,1,PERF
42255322840000,PI,IP,001,20,14040,14041,5892,1,PERF
42255322840000,PI,IP,001,21,14100,14101,5892,1,PERF
42255322840000,PI,IP,001,22,14160,14161,5892,1,PERF
42255322840000,PI,IP,001,23,14220,14221,5892,1,PERF
42255322840000,PI,IP,001,24,14290,14291,5892,1,PERF
42255322840000,PI,IP,001,25,14350,14351,5892,1,PERF
42255322840000,PI,IP,001,26,14410,14411,5892,1,PERF
42255322840000,PI,IP,001,27,14470,14471,5892,1,PERF
42255322840000,PI,IP,001,28,14530,14531,5892,1,PERF
42255322840000,PI,IP,001,29,14590,14591,5892,1,PERF
42255322840000,PI,IP,001,30,14660,14661,5892,1,PERF
42255322840000,PI,IP,001,31,14720,14721,5892,1,PERF
42255322840000,PI,IP,001,32,14780,14781,5892,1,PERF
42255322840000,PI,IP,001,33,14840,14841,5892,1,PERF
42255322840000,PI,IP,001,34,14900,14901,5892,1,PERF
42255322840000,PI,IP,001,35,14960,14961,5892,1,PERF
42255322840000,PI,IP,001,36,15030,15031,5892,1,PERF
42255322840000,PI,IP,001,37,15090,15091,5892,1,PERF
42255322840000,PI,IP,001,38,15150,15151,5892,1,PERF
42255322840000,PI,IP,001,39,15210,15211,5892,1,PERF
42255322840000,PI,IP,001,40,15270,15271,5892,1,PERF
42255322840000,PI,IP,001,41,15330,15331,5892,1,PERF
42255322840000,PI,IP,001,42,15400,15401,5892,1,PERF
42255322840000,PI,IP,001,43,15465,15466,5892,1,PERF
42255322840000,PI,IP,001,44,15523,15524,5892,1,PERF
42255322840000,PI,IP,001,45,15585,15586,5892,1,PERF
42255322840000,PI,IP,001,46,15645,15646,5892,1,PERF
42255322840000,PI,IP,001,47,15705,15706,5892,1,PERF
42255322840000,PI,IP,001,48,15770,15771,5892,1,PERF
42255322840000,PI,IP,001,49,15830,15831,5892,1,PERF
42255322840000,PI,IP,001,50,15890,15891,5892,1,PERF
42255322840000,PI,IP,001,51,15950,15951,5892,1,PERF
42255322840000,PI,IP,001,52,16010,16011,5892,1,PERF
42255322840000,PI,IP,001,53,16070,16071,5892,1,PERF
42255322840000,PI,IP,001,54,16135,16136,5892,1,PERF
42255322840000,PI,IP,001,55,16195,16196,5892,1,PERF
42255322840000,PI,IP,001,56,16255,16256,5892,1,PERF
42255322840000,PI,IP,001,57,16315,16316,5892,1,PERF
42255322840000,PI,IP,001,58,16375,16376,5892,1,PERF
42255322840000,PI,IP,001,59,16435,16436,5892,1,PERF
42255322840000,PI,IP,001,60,16500,16501,5892,1,PERF
42255322840000,PI,IP,001,61,16560,16561,5892,1,PERF
42255322840000,PI,IP,001,62,16624,16625,5892,1,PERF
42255322840000,PI,IP,001,63,16684,16685,5892,1,PERF
42255322840000,PI,IP,001,64,16744,16745,5892,1,PERF
42255322840000,PI,IP,001,65,16804,16805,5892,1,PERF
42255322840000,PI,IP,001,66,16869,16870,5892,1,PERF
42255322840000,PI,IP,001,67,16929,16930,5892,1,PERF
42255322840000,PI,IP,001,68,16992,16993,5892,1,PERF
42255322840000,PI,IP,001,69,17052,17053,5892,1,PERF
42255322840000,PI,IP,001,70,17112,17113,5892,1,PERF
42255322840000,PI,IP,001,71,17171,17172,5892,1,PERF
42255322840000,PI,IP,001,72,17236,17237,5892,1,PERF
42255322840000,PI,IP,001,73,17293,17294,5892,1,PERF
42255322840000,PI,IP,001,74,17352,17353,5892,1,PERF
42255322840000,PI,IP,001,75,17414,17415,5892,1,PERF
42255322840000,PI,IP,001,76,17474,17475,5892,1,PERF
42255322840000,PI,IP,001,77,17534,17535,5892,1,PERF
42255322840000,PI,IP,001,78,17599,17600,5892,1,PERF
42255322840000,PI,IP,001,79,17659,17660,5892,1,PERF
42255322840000,PI,IP,001,80,17719,17720,5892,1,PERF
42255322840000,PI,IP,001,81,17785,17786,5892,1,PERF
42255322840000,PI,IP,001,82,17845,17846,5892,1,PERF
42255322840000,PI,IP,001,83,17905,17906,5892,1,PERF
42255322840000,PI,IP,001,84,17970,17971,5892,1,PERF
42255322840000,PI,IP,001,85,18026,18027,5892,1,PERF
42255322840000,PI,IP,001,86,18082,18083,5892,1,PERF
42255322840000,PI,IP,001,87,18136,18137,5892,1,PERF
42255322840000,PI,IP,001,88,18194,18195,5892,1,PERF
42255322840000,PI,IP,001,89,18250,18251,5892,1,PERF
42255322850000,PI,IP,001,1,10800,16757,6361,5957,PERF
42255322880000,PI,IP,001,1,12395,12395,5125,0,PERF
42255322880000,PI,IP,001,2,12469,12469,5125,0,PERF
42255322880000,PI,IP,001,3,12543,12543,5125,0,PERF
42255322880000,PI,IP,001,4,12617,12617,5125,0,PERF
42255322880000,PI,IP,001,5,12692,12692,5125,0,PERF
42255322880000,PI,IP,001,6,12765,12765,5125,0,PERF
42255322880000,PI,IP,001,7,12839,12839,5125,0,PERF
42255322880000,PI,IP,001,8,12913,12913,5125,0,PERF
42255322880000,PI,IP,001,9,12988,12988,5125,0,PERF
42255322880000,PI,IP,001,10,13062,13062,5125,0,PERF
42255322880000,PI,IP,001,11,13136,13136,5125,0,PERF
42255322880000,PI,IP,001,12,13210,13210,5125,0,PERF
42255322880000,PI,IP,001,13,13285,13285,5125,0,PERF
42255322880000,PI,IP,001,14,13359,13359,5125,0,PERF
42255322880000,PI,IP,001,15,13432,13432,5125,0,PERF
42255322880000,PI,IP,001,16,13506,13506,5125,0,PERF
42255322880000,PI,IP,001,17,13581,13581,5125,0,PERF
42255322880000,PI,IP,001,18,13655,13655,5125,0,PERF
42255322880000,PI,IP,001,19,13729,13729,5125,0,PERF
42255322880000,PI,IP,001,20,13803,13803,5125,0,PERF
42255322880000,PI,IP,001,21,13878,13878,5125,0,PERF
42255322880000,PI,IP,001,22,13952,13952,5125,0,PERF
42255322880000,PI,IP,001,23,14026,14026,5125,0,PERF
42255322880000,PI,IP,001,24,14099,14099,5125,0,PERF
42255322880000,PI,IP,001,25,14174,14174,5125,0,PERF
42255322880000,PI,IP,001,26,14248,14248,5125,0,PERF
42255322880000,PI,IP,001,27,14322,14322,5125,0,PERF
42255322880000,PI,IP,001,28,14396,14396,5125,0,PERF
42255322880000,PI,IP,001,29,14471,14471,5125,0,PERF
42255322880000,PI,IP,001,30,14545,14545,5125,0,PERF
42255322880000,PI,IP,001,31,14619,14619,5125,0,PERF
42255322880000,PI,IP,001,32,14693,14693,5125,0,PERF
42255322880000,PI,IP,001,33,14768,14768,5125,0,PERF
42255322880000,PI,IP,001,34,14841,14841,5125,0,PERF
42255322880000,PI,IP,001,35,14915,14915,5125,0,PERF
42255322880000,PI,IP,001,36,14989,14989,5125,0,PERF
42255322880000,PI,IP,001,37,15064,15064,5125,0,PERF
42255322880000,PI,IP,001,38,15138,15138,5125,0,PERF
42255322880000,PI,IP,001,39,15212,15212,5125,0,PERF
42255322880000,PI,IP,001,40,15286,15286,5125,0,PERF
42255322880000,PI,IP,001,41,15361,15361,5125,0,PERF
42255322880000,PI,IP,001,42,15434,15434,5125,0,PERF
42255322880000,PI,IP,001,43,15508,15508,5125,0,PERF
42255322880000,PI,IP,001,44,15582,15582,5125,0,PERF
42255322880000,PI,IP,001,45,15657,15657,5125,0,PERF
42255322880000,PI,IP,001,46,15731,15731,5125,0,PERF
42255322880000,PI,IP,001,47,15805,15805,5125,0,PERF
42255322880000,PI,IP,001,48,15879,15879,5125,0,PERF
42255322880000,PI,IP,001,49,15954,15954,5125,0,PERF
42255322880000,PI,IP,001,50,16028,16028,5125,0,PERF
42255322880000,PI,IP,001,51,16101,16101,5125,0,PERF
42255322880000,PI,IP,001,52,16175,16175,5125,0,PERF
42255322880000,PI,IP,001,53,16250,16250,5125,0,PERF
42255322880000,PI,IP,001,54,16324,16324,5125,0,PERF
42255322880000,PI,IP,001,55,16398,16398,5125,0,PERF
42255322880000,PI,IP,001,56,16472,16472,5125,0,PERF
42255322880000,PI,IP,001,57,16547,16547,5125,0,PERF
42255322880000,PI,IP,001,58,16621,16621,5125,0,PERF
42255322880000,PI,IP,001,59,16695,16695,5125,0,PERF
42255322880000,PI,IP,001,60,16768,16768,5125,0,PERF
42255322880000,PI,IP,001,61,16843,16843,5125,0,PERF
42255322880000,PI,IP,001,62,16917,16917,5125,0,PERF
42255322880000,PI,IP,001,63,16991,16991,5125,0,PERF
42255322880000,PI,IP,001,64,17065,17065,5125,0,PERF
42255322890000,PI,IP,001,1,13290,13465,,175,PERF
42255322890000,PI,IP,001,2,13531,13697,,166,PERF
42255322890000,PI,IP,001,3,13772,13938,,166,PERF
42255322890000,PI,IP,001,4,14013,14179,,166,PERF
42255322890000,PI,IP,001,5,14254,14420,,166,PERF
42255322890000,PI,IP,001,6,14495,14661,,166,PERF
42255322890000,PI,IP,001,7,14736,14902,,166,PERF
42255322890000,PI,IP,001,8,14977,15143,,166,PERF
42255322890000,PI,IP,001,9,15218,15384,,166,PERF
42255322890000,PI,IP,001,10,15459,15624,,165,PERF
42255322890000,PI,IP,001,11,15699,15865,,166,PERF
42255322890000,PI,IP,001,12,15940,16106,,166,PERF
42255322890000,PI,IP,001,13,16181,16347,,166,PERF
42255322890000,PI,IP,001,14,16422,16588,,166,PERF
42255322890000,PI,IP,001,15,16663,16829,,166,PERF
42255322890000,PI,IP,001,16,16904,17070,,166,PERF
42255322890000,PI,IP,001,17,17145,17311,,166,PERF
42255322890000,PI,IP,001,18,17386,17552,,166,PERF
42255322900000,PI,IP,001,1,10919,15834,5406,4915,PERF
42255322910000,PI,IP,001,1,13100,18992,6870,5892,PERF
42255322920000,PI,IP,001,1,13140,13298,4940,158,PERF
42255322920000,PI,IP,001,2,13373,13530,4940,157,PERF
42255322920000,PI,IP,001,3,13605,13763,4940,158,PERF
42255322920000,PI,IP,001,4,13838,13995,4940,157,PERF
42255322920000,PI,IP,001,5,14070,14228,4940,158,PERF
42255322920000,PI,IP,001,6,14303,14460,4940,157,PERF
42255322920000,PI,IP,001,7,14535,14693,4940,158,PERF
42255322920000,PI,IP,001,8,14768,14925,4940,157,PERF
42255322920000,PI,IP,001,9,15000,15158,4940,158,PERF
42255322920000,PI,IP,001,10,15233,15390,4940,157,PERF
42255322920000,PI,IP,001,11,15465,15623,4940,158,PERF
42255322920000,PI,IP,001,12,15698,15855,4940,157,PERF
42255322920000,PI,IP,001,13,15930,16088,4940,158,PERF
42255322920000,PI,IP,001,14,16163,16320,4940,157,PERF
42255322920000,PI,IP,001,15,16395,16553,4940,158,PERF
42255322920000,PI,IP,001,16,16628,16785,4940,157,PERF
42255322920000,PI,IP,001,17,16860,17018,4940,158,PERF
42255322920000,PI,IP,001,18,17046,17250,4940,204,PERF
42255322930000,PI,IP,001,1,11153,15825,5304,4672,PERF
42255322940000,PI,IP,001,1,11127,11248,4818,121,PERF
42255322940000,PI,IP,001,2,11323,11443,4818,120,PERF
42255322940000,PI,IP,001,3,11518,11639,4818,121,PERF
42255322940000,PI,IP,001,4,11714,11835,4818,121,PERF
42255322940000,PI,IP,001,5,11910,12030,4818,120,PERF
42255322940000,PI,IP,001,6,12105,12226,4818,121,PERF
42255322940000,PI,IP,001,7,12301,12422,4818,121,PERF
42255322940000,PI,IP,001,8,12497,12617,4818,120,PERF
42255322940000,PI,IP,001,9,12692,12813,4818,121,PERF
42255322940000,PI,IP,001,10,12888,13008,4818,120,PERF
42255322940000,PI,IP,001,11,13083,13204,4818,121,PERF
42255322940000,PI,IP,001,12,13279,13400,4818,121,PERF
42255322940000,PI,IP,001,13,13475,13595,4818,120,PERF
42255322940000,PI,IP,001,14,13670,13791,4818,121,PERF
42255322940000,PI,IP,001,15,13866,13987,4818,121,PERF
42255322940000,PI,IP,001,16,14062,14182,4818,120,PERF
42255322940000,PI,IP,001,17,14257,14378,4818,121,PERF
42255322940000,PI,IP,001,18,14453,14573,4818,120,PERF
42255322940000,PI,IP,001,19,14648,14769,4818,121,PERF
42255322940000,PI,IP,001,20,14844,15069,4818,225,PERF
42255322950000,PI,IP,001,1,12735,12941,4479,206,PERF
42255322950000,PI,IP,001,2,13016,13222,4479,206,PERF
42255322950000,PI,IP,001,3,13297,13503,4479,206,PERF
42255322950000,PI,IP,001,4,13578,13783,4479,205,PERF
42255322950000,PI,IP,001,5,13858,14064,4479,206,PERF
42255322950000,PI,IP,001,6,14139,14345,4479,206,PERF
42255322950000,PI,IP,001,7,14420,14626,4479,206,PERF
42255322950000,PI,IP,001,8,14701,14907,4479,206,PERF
42255322950000,PI,IP,001,9,14982,15188,4479,206,PERF
42255322950000,PI,IP,001,10,15263,15469,4479,206,PERF
42255322950000,PI,IP,001,11,15544,15749,4479,205,PERF
42255322950000,PI,IP,001,12,15824,16030,4479,206,PERF
42255322950000,PI,IP,001,13,16105,16311,4479,206,PERF
42255322950000,PI,IP,001,14,16386,16592,4479,206,PERF
42255322960000,PI,IP,001,1,12615,12857,5649,242,PERF
42255322960000,PI,IP,001,2,12925,13137,5649,212,PERF
42255322960000,PI,IP,001,3,13205,13417,5649,212,PERF
42255322960000,PI,IP,001,4,13485,13697,5649,212,PERF
42255322960000,PI,IP,001,5,13765,13979,5649,214,PERF
42255322960000,PI,IP,001,6,14045,14257,5649,212,PERF
42255322960000,PI,IP,001,7,14325,14537,5649,212,PERF
42255322960000,PI,IP,001,8,14605,14817,5649,212,PERF
42255322960000,PI,IP,001,9,14887,15095,5649,208,PERF
42255322960000,PI,IP,001,10,15165,15375,5649,210,PERF
42255322960000,PI,IP,001,11,15445,15657,5649,212,PERF
42255322960000,PI,IP,001,12,15725,15937,5649,212,PERF
42255322960000,PI,IP,001,13,16065,16217,5649,152,PERF
42255322960000,PI,IP,001,14,16285,16497,5649,212,PERF
42255322960000,PI,IP,001,15,16598,16770,5649,172,PERF
42255322970000,PI,IP,001,1,10885,11093,4050,208,PERF
42255322970000,PI,IP,001,2,11168,11375,4050,207,PERF
42255322970000,PI,IP,001,3,11450,11658,4050,208,PERF
42255322970000,PI,IP,001,4,11733,11941,4050,208,PERF
42255322970000,PI,IP,001,5,12016,12223,4050,207,PERF
42255322970000,PI,IP,001,6,12298,12506,4050,208,PERF
42255322970000,PI,IP,001,7,12581,12789,4050,208,PERF
42255322970000,PI,IP,001,8,12864,13071,4050,207,PERF
42255322970000,PI,IP,001,9,13146,13354,4050,208,PERF
42255322970000,PI,IP,001,10,13429,13637,4050,208,PERF
42255322970000,PI,IP,001,11,13712,13919,4050,207,PERF
42255322970000,PI,IP,001,12,13994,14202,4050,208,PERF
42255322980000,PI,IP,001,1,12360,12360,5111,0,PERF
42255322980000,PI,IP,001,2,12431,12431,5111,0,PERF
42255322980000,PI,IP,001,3,12502,12502,5111,0,PERF
42255322980000,PI,IP,001,4,12573,12573,5111,0,PERF
42255322980000,PI,IP,001,5,12648,12648,5111,0,PERF
42255322980000,PI,IP,001,6,12719,12719,5111,0,PERF
42255322980000,PI,IP,001,7,12790,12790,5111,0,PERF
42255322980000,PI,IP,001,8,12861,12861,5111,0,PERF
42255322980000,PI,IP,001,9,12936,12936,5111,0,PERF
42255322980000,PI,IP,001,10,13007,13007,5111,0,PERF
42255322980000,PI,IP,001,11,13078,13078,5111,0,PERF
42255322980000,PI,IP,001,12,13150,13150,5111,0,PERF
42255322980000,PI,IP,001,13,13225,13225,5111,0,PERF
42255322980000,PI,IP,001,14,13296,13296,5111,0,PERF
42255322980000,PI,IP,001,15,13367,13367,5111,0,PERF
42255322980000,PI,IP,001,16,13438,13438,5111,0,PERF
42255322980000,PI,IP,001,17,13513,13513,5111,0,PERF
42255322980000,PI,IP,001,18,13584,13584,5111,0,PERF
42255322980000,PI,IP,001,19,13655,13655,5111,0,PERF
42255322980000,PI,IP,001,20,13726,13726,5111,0,PERF
42255322980000,PI,IP,001,21,13801,13801,5111,0,PERF
42255322980000,PI,IP,001,22,13872,13872,5111,0,PERF
42255322980000,PI,IP,001,23,13943,13943,5111,0,PERF
42255322980000,PI,IP,001,24,14014,14014,5111,0,PERF
42255322980000,PI,IP,001,25,14089,14089,5111,0,PERF
42255322980000,PI,IP,001,26,14160,14160,5111,0,PERF
42255322980000,PI,IP,001,27,14231,14231,5111,0,PERF
42255322980000,PI,IP,001,28,14302,14302,5111,0,PERF
42255322980000,PI,IP,001,29,14377,14377,5111,0,PERF
42255322980000,PI,IP,001,30,14448,14448,5111,0,PERF
42255322980000,PI,IP,001,31,14519,14519,5111,0,PERF
42255322980000,PI,IP,001,32,14590,14590,5111,0,PERF
42255322980000,PI,IP,001,33,14665,14665,5111,0,PERF
42255322980000,PI,IP,001,34,14736,14736,5111,0,PERF
42255322980000,PI,IP,001,35,14808,14808,5111,0,PERF
42255322980000,PI,IP,001,36,14879,14879,5111,0,PERF
42255322980000,PI,IP,001,37,14954,14954,5111,0,PERF
42255322980000,PI,IP,001,38,15025,15025,5111,0,PERF
42255322980000,PI,IP,001,39,15096,15096,5111,0,PERF
42255322980000,PI,IP,001,40,15167,15167,5111,0,PERF
42255322980000,PI,IP,001,41,15242,15242,5111,0,PERF
42255322980000,PI,IP,001,42,15313,15313,5111,0,PERF
42255322980000,PI,IP,001,43,15384,15384,5111,0,PERF
42255322980000,PI,IP,001,44,15455,15455,5111,0,PERF
42255322980000,PI,IP,001,45,15530,15530,5111,0,PERF
42255322980000,PI,IP,001,46,15601,15601,5111,0,PERF
42255322980000,PI,IP,001,47,15672,15672,5111,0,PERF
42255322980000,PI,IP,001,48,15743,15743,5111,0,PERF
42255322980000,PI,IP,001,49,15818,15818,5111,0,PERF
42255322980000,PI,IP,001,50,15889,15889,5111,0,PERF
42255322980000,PI,IP,001,51,15960,15960,5111,0,PERF
42255322980000,PI,IP,001,52,16031,16031,5111,0,PERF
42255322980000,PI,IP,001,53,16106,16106,5111,0,PERF
42255322980000,PI,IP,001,54,16177,16177,5111,0,PERF
42255322980000,PI,IP,001,55,16248,16248,5111,0,PERF
42255322980000,PI,IP,001,56,16319,16319,5111,0,PERF
42255322980000,PI,IP,001,57,16394,16394,5111,0,PERF
42255322980000,PI,IP,001,58,16466,16466,5111,0,PERF
42255322980000,PI,IP,001,59,16537,16537,5111,0,PERF
42255322980000,PI,IP,001,60,16608,16608,5111,0,PERF
42255322980000,PI,IP,001,61,16683,16683,5111,0,PERF
42255322980000,PI,IP,001,62,16754,16754,5111,0,PERF
42255322980000,PI,IP,001,63,16825,16825,5111,0,PERF
42255322980000,PI,IP,001,64,16896,16896,5111,0,PERF
42255322980000,PI,IP,001,65,16971,16971,5111,0,PERF
42255322980000,PI,IP,001,66,17042,17042,5111,0,PERF
42255322980000,PI,IP,001,67,17113,17113,5111,0,PERF
42255322980000,PI,IP,001,68,17184,17184,5111,0,PERF
42255322990000,PI,IP,001,1,13230,16154,3695,2924,PERF
42255323000000,PI,IP,001,1,13178,18497,5702,5319,PERF
42255323010000,PI,IP,001,1,12925,17300,5385,4375,PERF
42255323020000,PI,IP,001,1,11153,11283,4730,130,PERF
42255323020000,PI,IP,001,2,11358,11488,4730,130,PERF
42255323020000,PI,IP,001,3,11563,11693,4730,130,PERF
42255323020000,PI,IP,001,4,11768,11898,4730,130,PERF
42255323020000,PI,IP,001,5,11973,12103,4730,130,PERF
42255323020000,PI,IP,001,6,12178,12308,4730,130,PERF
42255323020000,PI,IP,001,7,12383,12513,4730,130,PERF
42255323020000,PI,IP,001,8,12588,12718,4730,130,PERF
42255323020000,PI,IP,001,9,12793,12923,4730,130,PERF
42255323020000,PI,IP,001,10,12998,13128,4730,130,PERF
42255323020000,PI,IP,001,11,13203,13333,4730,130,PERF
42255323020000,PI,IP,001,12,13408,13538,4730,130,PERF
42255323020000,PI,IP,001,13,13613,13743,4730,130,PERF
42255323020000,PI,IP,001,14,13818,13948,4730,130,PERF
42255323020000,PI,IP,001,15,14023,14153,4730,130,PERF
42255323020000,PI,IP,001,16,14228,14358,4730,130,PERF
42255323020000,PI,IP,001,17,14433,14563,4730,130,PERF
42255323020000,PI,IP,001,18,14638,14768,4730,130,PERF
42255323020000,PI,IP,001,19,14843,14969,4730,126,PERF
42255323020000,PI,IP,001,20,15044,15269,4730,225,PERF
42255323030000,PI,IP,001,1,11244,16813,6044,5569,PERF
42255323040100,PI,IP,001,1,11993,16188,5031,4195,PERF
42255323050100,PI,IP,001,1,12539,17500,5227,4961,PERF
42255323060000,PI,IP,001,1,11642,11838,5601,196,PERF
42255323060000,PI,IP,001,2,11901,12100,5601,199,PERF
42255323060000,PI,IP,001,3,12161,12358,5601,197,PERF
42255323060000,PI,IP,001,4,12402,12618,5601,216,PERF
42255323060000,PI,IP,001,5,12691,12889,5601,198,PERF
42255323060000,PI,IP,001,6,12976,13188,5601,212,PERF
42255323060000,PI,IP,001,7,13268,13473,5601,205,PERF
42255323060000,PI,IP,001,8,13546,13754,5601,208,PERF
42255323060000,PI,IP,001,9,13831,14043,5601,212,PERF
42255323060000,PI,IP,001,10,14122,14328,5601,206,PERF
42255323060000,PI,IP,001,11,14401,14612,5601,211,PERF
42255323060000,PI,IP,001,12,14686,14898,5601,212,PERF
42255323060000,PI,IP,001,13,14966,15183,5601,217,PERF
42255323060000,PI,IP,001,14,15256,15464,5601,208,PERF
42255323060000,PI,IP,001,15,15541,15753,5601,212,PERF
42255323060000,PI,IP,001,16,15820,16038,5601,218,PERF
42255323060000,PI,IP,001,17,16111,16323,5601,212,PERF
42255323060000,PI,IP,001,18,16396,16638,5601,242,PERF
42255323070000,PI,IP,001,1,12089,17445,5365,5356,PERF
42255323080000,PI,IP,001,1,12462,17315,,4853,PERF
42255323090000,PI,IP,001,1,12170,16073,4668,3903,PERF
42255323100000,PI,IP,001,1,10900,16037,5607,5137,PERF
42255323110000,PI,IP,001,1,11273,11608,4790,335,PERF
42255323110000,PI,IP,001,2,11765,12052,4790,287,PERF
42255323110000,PI,IP,001,3,12145,12436,4790,291,PERF
42255323110000,PI,IP,001,4,12525,12812,4790,287,PERF
42255323110000,PI,IP,001,5,12905,13192,4790,287,PERF
42255323110000,PI,IP,001,6,13285,13562,4790,277,PERF
42255323110000,PI,IP,001,7,13668,13952,4790,284,PERF
42255323110000,PI,IP,001,8,14045,14332,4790,287,PERF
42255323110000,PI,IP,001,9,14425,14712,4790,287,PERF
42255323110000,PI,IP,001,10,14810,15097,4790,287,PERF
42255323110000,PI,IP,001,11,15185,15397,4790,212,PERF
42255323120000,PI,IP,001,1,11180,11296,4545,116,PERF
42255323120000,PI,IP,001,2,11371,11487,4545,116,PERF
42255323120000,PI,IP,001,3,11562,11678,4545,116,PERF
42255323120000,PI,IP,001,4,11753,11869,4545,116,PERF
42255323120000,PI,IP,001,5,11944,12060,4545,116,PERF
42255323120000,PI,IP,001,6,12135,12251,4545,116,PERF
42255323120000,PI,IP,001,7,12326,12442,4545,116,PERF
42255323120000,PI,IP,001,8,12517,12633,4545,116,PERF
42255323120000,PI,IP,001,9,12708,12824,4545,116,PERF
42255323120000,PI,IP,001,10,12899,13015,4545,116,PERF
42255323120000,PI,IP,001,11,13090,13206,4545,116,PERF
42255323120000,PI,IP,001,12,13281,13397,4545,116,PERF
42255323120000,PI,IP,001,13,13472,13588,4545,116,PERF
42255323120000,PI,IP,001,14,13663,13779,4545,116,PERF
42255323120000,PI,IP,001,15,13854,13970,4545,116,PERF
42255323120000,PI,IP,001,16,14045,14161,4545,116,PERF
42255323120000,PI,IP,001,17,14236,14352,4545,116,PERF
42255323120000,PI,IP,001,18,14427,14543,4545,116,PERF
42255323120000,PI,IP,001,19,14618,14729,4545,111,PERF
42255323120000,PI,IP,001,20,14804,15029,4545,225,PERF
42255323130000,PI,IP,001,1,11084,11201,4754,117,PERF
42255323130000,PI,IP,001,2,11276,11392,4754,116,PERF
42255323130000,PI,IP,001,3,11467,11584,4754,117,PERF
42255323130000,PI,IP,001,4,11659,11776,4754,117,PERF
42255323130000,PI,IP,001,5,11851,11968,4754,117,PERF
42255323130000,PI,IP,001,6,12043,12160,4754,117,PERF
42255323130000,PI,IP,001,7,12235,12352,4754,117,PERF
42255323130000,PI,IP,001,8,12427,12544,4754,117,PERF
42255323130000,PI,IP,001,9,12619,12735,4754,116,PERF
42255323130000,PI,IP,001,10,12810,12927,4754,117,PERF
42255323130000,PI,IP,001,11,13002,13119,4754,117,PERF
42255323130000,PI,IP,001,12,13194,13311,4754,117,PERF
42255323130000,PI,IP,001,13,13386,13503,4754,117,PERF
42255323130000,PI,IP,001,14,13578,13695,4754,117,PERF
42255323130000,PI,IP,001,15,13770,13887,4754,117,PERF
42255323130000,PI,IP,001,16,13962,14078,4754,116,PERF
42255323130000,PI,IP,001,17,14153,14270,4754,117,PERF
42255323130000,PI,IP,001,18,14345,14462,4754,117,PERF
42255323130000,PI,IP,001,19,14537,14654,4754,117,PERF
42255323130000,PI,IP,001,20,14729,14954,4754,225,PERF
42255323140000,PI,IP,001,1,10975,13094,2975,2119,PERF
42255323150000,PI,IP,001,1,10882,15090,4866,4208,PERF
42255323160000,PI,IP,001,1,11331,16446,5757,5115,PERF
42255323180000,PI,IP,001,1,11306,16788,6024,5482,PERF
42255323190000,PI,IP,001,1,11136,11321,6410,185,PERF
42255323190000,PI,IP,001,2,11396,11582,6410,186,PERF
42255323190000,PI,IP,001,3,11657,11842,6410,185,PERF
42255323190000,PI,IP,001,4,11917,12103,6410,186,PERF
42255323190000,PI,IP,001,5,12178,12363,6410,185,PERF
42255323190000,PI,IP,001,6,12438,12624,6410,186,PERF
42255323190000,PI,IP,001,7,12699,12884,6410,185,PERF
42255323190000,PI,IP,001,8,12959,13144,6410,185,PERF
42255323190000,PI,IP,001,9,13219,13405,6410,186,PERF
42255323190000,PI,IP,001,10,13480,13665,6410,185,PERF
42255323190000,PI,IP,001,11,13740,13926,6410,186,PERF
42255323190000,PI,IP,001,12,14001,14186,6410,185,PERF
42255323190000,PI,IP,001,13,14261,14447,6410,186,PERF
42255323190000,PI,IP,001,14,14522,14707,6410,185,PERF
42255323190000,PI,IP,001,15,14782,14967,6410,185,PERF
42255323190000,PI,IP,001,16,15042,15228,6410,186,PERF
42255323190000,PI,IP,001,17,15303,15488,6410,185,PERF
42255323190000,PI,IP,001,18,15563,15749,6410,186,PERF
42255323190000,PI,IP,001,19,15824,16009,6410,185,PERF
42255323190000,PI,IP,001,20,16084,16270,6410,186,PERF
42255323190000,PI,IP,001,21,16345,16530,6410,185,PERF
42255323200000,PI,IP,001,1,13150,17542,5347,4392,PERF
42255323210000,PI,IP,001,1,10936,11161,,225,PERF
42255323210000,PI,IP,001,2,11489,11685,,196,PERF
42255323210000,PI,IP,001,3,11760,11956,,196,PERF
42255323210000,PI,IP,001,4,12031,12226,,195,PERF
42255323210000,PI,IP,001,5,12301,12497,,196,PERF
42255323210000,PI,IP,001,6,12572,12768,,196,PERF
42255323210000,PI,IP,001,7,12843,13038,,195,PERF
42255323210000,PI,IP,001,8,13113,13309,,196,PERF
42255323210000,PI,IP,001,9,13384,13579,,195,PERF
42255323210000,PI,IP,001,10,13654,13850,,196,PERF
42255323210000,PI,IP,001,11,14155,14335,,180,PERF
42255323210000,PI,IP,001,12,14410,14590,,180,PERF
42255323210000,PI,IP,001,13,14665,14845,,180,PERF
42255323210000,PI,IP,001,14,14920,15100,,180,PERF
42255323220000,PI,IP,001,1,10925,11110,6134,185,PERF
42255323220000,PI,IP,001,2,11185,11370,6134,185,PERF
42255323220000,PI,IP,001,3,11445,11630,6134,185,PERF
42255323220000,PI,IP,001,4,11705,11890,6134,185,PERF
42255323220000,PI,IP,001,5,11965,12150,6134,185,PERF
42255323220000,PI,IP,001,6,12225,12409,6134,184,PERF
42255323220000,PI,IP,001,7,12484,12669,6134,185,PERF
42255323220000,PI,IP,001,8,12744,12929,6134,185,PERF
42255323220000,PI,IP,001,9,13004,13189,6134,185,PERF
42255323220000,PI,IP,001,10,13264,13449,6134,185,PERF
42255323220000,PI,IP,001,11,13524,13709,6134,185,PERF
42255323220000,PI,IP,001,12,13784,13969,6134,185,PERF
42255323220000,PI,IP,001,13,14044,14229,6134,185,PERF
42255323220000,PI,IP,001,14,14304,14489,6134,185,PERF
42255323220000,PI,IP,001,15,14564,14749,6134,185,PERF
42255323220000,PI,IP,001,16,14824,15009,6134,185,PERF
42255323220000,PI,IP,001,17,15084,15268,6134,184,PERF
42255323220000,PI,IP,001,18,15343,15528,6134,185,PERF
42255323220000,PI,IP,001,19,15603,15788,6134,185,PERF
42255323220000,PI,IP,001,20,15863,16048,6134,185,PERF
42255323220000,PI,IP,001,21,16123,16308,6134,185,PERF
42255323220000,PI,IP,001,22,16383,16568,6134,185,PERF
42255323230000,PI,IP,001,1,11639,11877,5992,238,PERF
42255323230000,PI,IP,001,2,11937,12179,5992,242,PERF
42255323230000,PI,IP,001,3,12237,12449,5992,212,PERF
42255323230000,PI,IP,001,4,12507,12719,5992,212,PERF
42255323230000,PI,IP,001,5,12777,12989,5992,212,PERF
42255323230000,PI,IP,001,6,13074,13259,5992,185,PERF
42255323230000,PI,IP,001,7,13317,13529,5992,212,PERF
42255323230000,PI,IP,001,8,13587,13799,5992,212,PERF
42255323230000,PI,IP,001,9,13857,14069,5992,212,PERF
42255323230000,PI,IP,001,10,14127,14339,5992,212,PERF
42255323230000,PI,IP,001,11,14392,14609,5992,217,PERF
42255323230000,PI,IP,001,12,14671,14877,5992,206,PERF
42255323230000,PI,IP,001,13,14937,15149,5992,212,PERF
42255323230000,PI,IP,001,14,15207,15417,5992,210,PERF
42255323230000,PI,IP,001,15,15477,15684,5992,207,PERF
42255323230000,PI,IP,001,16,15747,15959,5992,212,PERF
42255323230000,PI,IP,001,17,16017,16229,5992,212,PERF
42255323230000,PI,IP,001,18,16287,16499,5992,212,PERF
42255323230000,PI,IP,001,19,16557,16762,5992,205,PERF
42255323230000,PI,IP,001,20,16984,17067,5992,83,PERF
42255323240000,PI,IP,001,1,12968,13223,6444,255,PERF
42255323240000,PI,IP,001,2,13301,13558,6444,257,PERF
42255323240000,PI,IP,001,3,13636,13896,6444,260,PERF
42255323240000,PI,IP,001,4,13971,14228,6444,257,PERF
42255323240000,PI,IP,001,5,14308,14568,6444,260,PERF
42255323240000,PI,IP,001,6,14646,14918,6444,272,PERF
42255323240000,PI,IP,001,7,14996,15266,6444,270,PERF
42255323240000,PI,IP,001,8,15346,15618,6444,272,PERF
42255323240000,PI,IP,001,9,15696,15968,6444,272,PERF
42255323240000,PI,IP,001,10,16052,16318,6444,266,PERF
42255323240000,PI,IP,001,11,16396,16668,6444,272,PERF
42255323240000,PI,IP,001,12,16746,17018,6444,272,PERF
42255323240000,PI,IP,001,13,17096,17368,6444,272,PERF
42255323240000,PI,IP,001,14,17446,17718,6444,272,PERF
42255323240000,PI,IP,001,15,17796,18068,6444,272,PERF
42255323240000,PI,IP,001,16,18146,18418,6444,272,PERF
42255323240000,PI,IP,001,17,18496,18768,6444,272,PERF
42255323250000,PI,IP,001,1,10845,11033,5611,188,PERF
42255323250000,PI,IP,001,2,11108,11297,5611,189,PERF
42255323250000,PI,IP,001,3,11372,11560,5611,188,PERF
42255323250000,PI,IP,001,4,11635,11824,5611,189,PERF
42255323250000,PI,IP,001,5,11899,12087,5611,188,PERF
42255323250000,PI,IP,001,6,12162,12350,5611,188,PERF
42255323250000,PI,IP,001,7,12425,12614,5611,189,PERF
42255323250000,PI,IP,001,8,12689,12877,5611,188,PERF
42255323250000,PI,IP,001,9,12962,13140,5611,178,PERF
42255323250000,PI,IP,001,10,13215,13404,5611,189,PERF
42255323250000,PI,IP,001,11,13479,13667,5611,188,PERF
42255323250000,PI,IP,001,12,13742,13931,5611,189,PERF
42255323250000,PI,IP,001,13,14006,14194,5611,188,PERF
42255323250000,PI,IP,001,14,14269,14457,5611,188,PERF
42255323250000,PI,IP,001,15,14532,14721,5611,189,PERF
42255323250000,PI,IP,001,16,14796,14984,5611,188,PERF
42255323250000,PI,IP,001,17,15059,15247,5611,188,PERF
42255323250000,PI,IP,001,18,15322,15511,5611,189,PERF
42255323250000,PI,IP,001,19,15586,15774,5611,188,PERF
42255323250000,PI,IP,001,20,15849,16038,5611,189,PERF
42255323250000,PI,IP,001,21,16113,16301,5611,188,PERF
42255323260000,PI,IP,001,1,12231,16561,5467,4330,PERF
42255323270000,PI,IP,001,1,10813,13814,3460,3001,PERF
42255323280000,PI,IP,001,1,10946,14607,4338,3661,PERF
42255323290000,PI,IP,001,1,13665,19039,6174,5374,PERF
42255323300000,PI,IP,001,1,13750,18327,5080,4577,PERF
42255323310000,PI,IP,001,1,11655,11867,5641,212,PERF
42255323310000,PI,IP,001,2,11925,12137,5641,212,PERF
42255323310000,PI,IP,001,3,12195,12407,5641,212,PERF
42255323310000,PI,IP,001,4,12465,12677,5641,212,PERF
42255323310000,PI,IP,001,5,12735,12947,5641,212,PERF
42255323310000,PI,IP,001,6,13005,13217,5641,212,PERF
42255323310000,PI,IP,001,7,13275,13487,5641,212,PERF
42255323310000,PI,IP,001,8,13545,13757,5641,212,PERF
42255323310000,PI,IP,001,9,13815,14027,5641,212,PERF
42255323310000,PI,IP,001,10,14085,14297,5641,212,PERF
42255323310000,PI,IP,001,11,14355,14567,5641,212,PERF
42255323310000,PI,IP,001,12,14625,14837,5641,212,PERF
42255323310000,PI,IP,001,13,14895,15107,5641,212,PERF
42255323310000,PI,IP,001,14,15165,15377,5641,212,PERF
42255323310000,PI,IP,001,15,15435,15647,5641,212,PERF
42255323310000,PI,IP,001,16,15705,15917,5641,212,PERF
42255323310000,PI,IP,001,17,15975,16187,5641,212,PERF
42255323310000,PI,IP,001,18,16245,16457,5641,212,PERF
42255323310000,PI,IP,001,19,16517,16759,5641,242,PERF
42255323320000,PI,IP,001,1,12898,19192,6629,6294,PERF
42255323330000,PI,IP,001,1,13194,18275,5552,5081,PERF
42255323340000,PI,IP,001,1,12934,16905,4205,3971,PERF
42255323350000,PI,IP,001,1,10501,13980,4138,3479,PERF
42255323360000,PI,IP,001,1,13420,17208,4645,3788,PERF
42255323370000,PI,IP,001,1,12626,12880,6084,254,PERF
42255323370000,PI,IP,001,2,12966,13218,6084,252,PERF
42255323370000,PI,IP,001,3,13301,13556,6084,255,PERF
42255323370000,PI,IP,001,4,13639,13896,6084,257,PERF
42255323370000,PI,IP,001,5,13977,14232,6084,255,PERF
42255323370000,PI,IP,001,6,14315,14570,6084,255,PERF
42255323370000,PI,IP,001,7,14653,14910,6084,257,PERF
42255323370000,PI,IP,001,8,14991,15250,6084,259,PERF
42255323370000,PI,IP,001,9,15329,15588,6084,259,PERF
42255323370000,PI,IP,001,10,15667,15922,6084,255,PERF
42255323370000,PI,IP,001,11,16005,16260,6084,255,PERF
42255323370000,PI,IP,001,12,16340,16585,6084,245,PERF
42255323370000,PI,IP,001,13,16681,16936,6084,255,PERF
42255323370000,PI,IP,001,14,17019,17274,6084,255,PERF
42255323370000,PI,IP,001,15,17357,17629,6084,272,PERF
42255323390000,PI,IP,001,1,10904,14386,4356,3482,PERF
42255323400000,PI,IP,001,1,12896,18541,6296,5645,PERF
42255323420000,PI,IP,001,1,12525,17821,5343,5296,PERF
42255323430200,PI,IP,001,1,13707,18275,5171,4568,PERF
42255323440000,PI,IP,001,1,13172,13421,6653,249,PERF
42255323440000,PI,IP,001,2,13499,13750,6653,251,PERF
42255323440000,PI,IP,001,3,13828,14079,6653,251,PERF
42255323440000,PI,IP,001,4,14157,14408,6653,251,PERF
42255323440000,PI,IP,001,5,14486,14743,6653,257,PERF
42255323440000,PI,IP,001,6,14821,15078,6653,257,PERF
42255323440000,PI,IP,001,7,15156,15413,6653,257,PERF
42255323440000,PI,IP,001,8,15491,15748,6653,257,PERF
42255323440000,PI,IP,001,9,15826,16083,6653,257,PERF
42255323440000,PI,IP,001,10,16161,16418,6653,257,PERF
42255323440000,PI,IP,001,11,16496,16754,6653,258,PERF
42255323440000,PI,IP,001,12,16831,17088,6653,257,PERF
42255323440000,PI,IP,001,13,17166,17423,6653,257,PERF
42255323440000,PI,IP,001,14,17501,17758,6653,257,PERF
42255323440000,PI,IP,001,15,17836,18093,6653,257,PERF
42255323440000,PI,IP,001,16,18171,18428,6653,257,PERF
42255323440000,PI,IP,001,17,18506,18778,6653,272,PERF
42255323450000,PI,IP,001,1,12945,18761,6342,5816,PERF
42255323470000,PI,IP,001,1,12316,12558,6769,242,PERF
42255323470000,PI,IP,001,2,12636,12908,6769,272,PERF
42255323470000,PI,IP,001,3,12986,13262,6769,276,PERF
42255323470000,PI,IP,001,4,13336,13608,6769,272,PERF
42255323470000,PI,IP,001,5,13686,13958,6769,272,PERF
42255323470000,PI,IP,001,6,14036,14310,6769,274,PERF
42255323470000,PI,IP,001,7,14386,14658,6769,272,PERF
42255323470000,PI,IP,001,8,14736,15008,6769,272,PERF
42255323470000,PI,IP,001,9,15082,15358,6769,276,PERF
42255323470000,PI,IP,001,10,15436,15708,6769,272,PERF
42255323470000,PI,IP,001,11,15786,16058,6769,272,PERF
42255323470000,PI,IP,001,12,16136,16408,6769,272,PERF
42255323470000,PI,IP,001,13,16486,16678,6769,192,PERF
42255323470000,PI,IP,001,14,16836,17102,6769,266,PERF
42255323470000,PI,IP,001,15,17186,17458,6769,272,PERF
42255323470000,PI,IP,001,16,17536,17808,6769,272,PERF
42255323470000,PI,IP,001,17,17886,18138,6769,252,PERF
42255323480000,PI,IP,001,1,10517,10700,5735,183,PERF
42255323480000,PI,IP,001,2,10785,10978,5735,193,PERF
42255323480000,PI,IP,001,3,11053,11245,5735,192,PERF
42255323480000,PI,IP,001,4,11320,11500,5735,180,PERF
42255323480000,PI,IP,001,5,11580,11781,5735,201,PERF
42255323480000,PI,IP,001,6,11853,12029,5735,176,PERF
42255323480000,PI,IP,001,7,12123,12364,5735,241,PERF
42255323480000,PI,IP,001,8,12391,12558,5735,167,PERF
42255323480000,PI,IP,001,9,12650,12839,5735,189,PERF
42255323480000,PI,IP,001,10,12914,13106,5735,192,PERF
42255323480000,PI,IP,001,11,13181,13374,5735,193,PERF
42255323480000,PI,IP,001,12,13449,13642,5735,193,PERF
42255323480000,PI,IP,001,13,13720,13909,5735,189,PERF
42255323480000,PI,IP,001,14,13984,14177,5735,193,PERF
42255323480000,PI,IP,001,15,14252,14445,5735,193,PERF
42255323480000,PI,IP,001,16,14520,14712,5735,192,PERF
42255323480000,PI,IP,001,17,14787,14980,5735,193,PERF
42255323500000,PI,IP,001,1,12438,12668,6342,230,PERF
42255323500000,PI,IP,001,2,12746,12972,6342,226,PERF
42255323500000,PI,IP,001,3,13051,13278,6342,227,PERF
42255323500000,PI,IP,001,4,13356,13583,6342,227,PERF
42255323500000,PI,IP,001,5,13661,13888,6342,227,PERF
42255323500000,PI,IP,001,6,13966,14193,6342,227,PERF
42255323500000,PI,IP,001,7,14271,14498,6342,227,PERF
42255323500000,PI,IP,001,8,14576,14803,6342,227,PERF
42255323500000,PI,IP,001,9,14878,15108,6342,230,PERF
42255323500000,PI,IP,001,10,15186,15413,6342,227,PERF
42255323500000,PI,IP,001,11,15494,15718,6342,224,PERF
42255323500000,PI,IP,001,12,15796,16023,6342,227,PERF
42255323500000,PI,IP,001,13,16101,16332,6342,231,PERF
42255323500000,PI,IP,001,14,16406,16633,6342,227,PERF
42255323500000,PI,IP,001,15,16711,16938,6342,227,PERF
42255323500000,PI,IP,001,16,17016,17240,6342,224,PERF
42255323500000,PI,IP,001,17,17321,17548,6342,227,PERF
42255323500000,PI,IP,001,18,17626,17868,6342,242,PERF
42255323550000,PI,IP,001,1,11613,17341,6300,5728,PERF
42255323560000,PI,IP,001,1,10661,14465,4484,3804,PERF
42255323570000,PI,IP,001,1,10350,14740,4796,4390,PERF
42255323580000,PI,IP,001,1,10686,10871,5734,185,PERF
42255323580000,PI,IP,001,2,10946,11132,5734,186,PERF
42255323580000,PI,IP,001,3,11207,11393,5734,186,PERF
42255323580000,PI,IP,001,4,11468,11634,5734,166,PERF
42255323580000,PI,IP,001,5,11729,11906,5734,177,PERF
42255323580000,PI,IP,001,6,11990,12160,5734,170,PERF
42255323580000,PI,IP,001,7,12257,12420,5734,163,PERF
42255323580000,PI,IP,001,8,12511,12692,5734,181,PERF
42255323580000,PI,IP,001,9,12765,12945,5734,180,PERF
42255323580000,PI,IP,001,10,13027,13213,5734,186,PERF
42255323580000,PI,IP,001,11,13288,13474,5734,186,PERF
42255323580000,PI,IP,001,12,13549,13735,5734,186,PERF
42255323580000,PI,IP,001,13,13810,13996,5734,186,PERF
42255323580000,PI,IP,001,14,14071,14257,5734,186,PERF
42255323580000,PI,IP,001,15,14332,14517,5734,185,PERF
42255323580000,PI,IP,001,16,14592,14778,5734,186,PERF
42255323580000,PI,IP,001,17,14853,15039,5734,186,PERF
42255323590100,PI,IP,001,1,12217,16695,4657,4478,PERF
42255323610000,PI,IP,001,1,11260,15646,4995,4386,PERF
42255323620000,PI,IP,001,1,11208,15703,5088,4495,PERF
42255323630000,PI,IP,001,1,11177,16766,6013,5589,PERF
42255323640000,PI,IP,001,1,12636,12917,6700,281,PERF
42255323640000,PI,IP,001,2,13000,13272,6700,272,PERF
42255323640000,PI,IP,001,3,13360,13632,6700,272,PERF
42255323640000,PI,IP,001,4,13710,13982,6700,272,PERF
42255323640000,PI,IP,001,5,14060,14332,6700,272,PERF
42255323640000,PI,IP,001,6,14410,14682,6700,272,PERF
42255323640000,PI,IP,001,7,14683,14759,6700,76,PERF
42255323640000,PI,IP,001,8,14760,15032,6700,272,PERF
42255323640000,PI,IP,001,9,15110,15382,6700,272,PERF
42255323640000,PI,IP,001,10,15810,16082,6700,272,PERF
42255323640000,PI,IP,001,11,16160,16432,6700,272,PERF
42255323640000,PI,IP,001,12,16510,16782,6700,272,PERF
42255323640000,PI,IP,001,13,16860,17132,6700,272,PERF
42255323640000,PI,IP,001,14,17210,17480,6700,270,PERF
42255323640000,PI,IP,001,15,17560,17832,6700,272,PERF
42255323640000,PI,IP,001,16,17910,18182,6700,272,PERF
42255323640000,PI,IP,001,17,18259,18501,6700,242,PERF
42255323650000,PI,IP,001,1,12529,12741,5754,212,PERF
42255323650000,PI,IP,001,2,12806,13021,5754,215,PERF
42255323650000,PI,IP,001,3,13089,13361,5754,272,PERF
42255323650000,PI,IP,001,4,13439,13711,5754,272,PERF
42255323650000,PI,IP,001,5,13789,14011,5754,222,PERF
42255323650000,PI,IP,001,6,14089,14361,5754,272,PERF
42255323650000,PI,IP,001,7,14439,14711,5754,272,PERF
42255323650000,PI,IP,001,8,14789,15061,5754,272,PERF
42255323650000,PI,IP,001,9,15139,15411,5754,272,PERF
42255323650000,PI,IP,001,10,15485,15761,5754,276,PERF
42255323650000,PI,IP,001,11,15839,16111,5754,272,PERF
42255323650000,PI,IP,001,12,16186,16456,5754,270,PERF
42255323650000,PI,IP,001,13,16539,16811,5754,272,PERF
42255323650000,PI,IP,001,14,16889,17161,5754,272,PERF
42255323650000,PI,IP,001,15,17241,17511,5754,270,PERF
42255323660000,PI,IP,001,1,12758,13003,5264,245,PERF
42255323660000,PI,IP,001,2,13071,13313,5264,242,PERF
42255323660000,PI,IP,001,3,13381,13623,5264,242,PERF
42255323660000,PI,IP,001,4,13691,13933,5264,242,PERF
42255323660000,PI,IP,001,5,13999,14246,5264,247,PERF
42255323660000,PI,IP,001,6,14311,14553,5264,242,PERF
42255323660000,PI,IP,001,7,14621,14863,5264,242,PERF
42255323660000,PI,IP,001,8,14931,15177,5264,246,PERF
42255323660000,PI,IP,001,9,15241,15483,5264,242,PERF
42255323660000,PI,IP,001,10,15551,15793,5264,242,PERF
42255323660000,PI,IP,001,11,15861,16103,5264,242,PERF
42255323660000,PI,IP,001,12,16171,16413,5264,242,PERF
42255323660000,PI,IP,001,13,16481,16723,5264,242,PERF
42255323660000,PI,IP,001,14,16791,17033,5264,242,PERF
42255323670000,PI,IP,001,1,11781,17195,6181,5414,PERF
42255323680000,PI,IP,001,1,13028,17324,4585,4296,PERF
42255323700000,PI,IP,001,1,12275,17362,5546,5087,PERF
42255323710000,PI,IP,001,1,11465,11693,6341,228,PERF
42255323710000,PI,IP,001,2,11771,12013,6341,242,PERF
42255323710000,PI,IP,001,3,12091,12333,6341,242,PERF
42255323710000,PI,IP,001,4,12411,12683,6341,272,PERF
42255323710000,PI,IP,001,5,12771,13043,6341,272,PERF
42255323710000,PI,IP,001,6,13131,13403,6341,272,PERF
42255323710000,PI,IP,001,7,13491,13763,6341,272,PERF
42255323710000,PI,IP,001,8,13851,14123,6341,272,PERF
42255323710000,PI,IP,001,9,14211,14483,6341,272,PERF
42255323710000,PI,IP,001,10,14571,14843,6341,272,PERF
42255323710000,PI,IP,001,11,14931,15204,6341,273,PERF
42255323710000,PI,IP,001,12,15294,15563,6341,269,PERF
42255323710000,PI,IP,001,13,15651,15920,6341,269,PERF
42255323710000,PI,IP,001,14,16008,16283,6341,275,PERF
42255323710000,PI,IP,001,15,16371,16851,6341,480,PERF
42255323720000,PI,IP,001,1,11688,17479,6273,5791,PERF
42255323730000,PI,IP,001,1,11753,17240,6140,5487,PERF
42255323740000,PI,IP,001,1,11679,17288,6134,5609,PERF
42255323750000,PI,IP,001,1,11871,17170,6269,5299,PERF
42255323770000,PI,IP,001,1,13194,13195,6102,1,PERF
42255323770000,PI,IP,001,2,13259,13260,6102,1,PERF
42255323770000,PI,IP,001,3,13324,13325,6102,1,PERF
42255323770000,PI,IP,001,4,13387,13388,6102,1,PERF
42255323770000,PI,IP,001,5,13453,13454,6102,1,PERF
42255323770000,PI,IP,001,6,13518,13519,6102,1,PERF
42255323770000,PI,IP,001,7,13589,13590,6102,1,PERF
42255323770000,PI,IP,001,8,13652,13653,6102,1,PERF
42255323770000,PI,IP,001,9,13713,13714,6102,1,PERF
42255323770000,PI,IP,001,10,13777,13778,6102,1,PERF
42255323770000,PI,IP,001,11,13840,13841,6102,1,PERF
42255323770000,PI,IP,001,12,13901,13902,6102,1,PERF
42255323770000,PI,IP,001,13,13967,13968,6102,1,PERF
42255323770000,PI,IP,001,14,14030,14032,6102,2,PERF
42255323770000,PI,IP,001,15,14090,14091,6102,1,PERF
42255323770000,PI,IP,001,16,14156,14157,6102,1,PERF
42255323770000,PI,IP,001,17,14218,14219,6102,1,PERF
42255323770000,PI,IP,001,18,14278,14279,6102,1,PERF
42255323770000,PI,IP,001,19,14345,14346,6102,1,PERF
42255323770000,PI,IP,001,20,14407,14408,6102,1,PERF
42255323770000,PI,IP,001,21,14469,14470,6102,1,PERF
42255323770000,PI,IP,001,22,14531,14532,6102,1,PERF
42255323770000,PI,IP,001,23,14593,14594,6102,1,PERF
42255323770000,PI,IP,001,24,14653,14654,6102,1,PERF
42255323770000,PI,IP,001,25,14715,14716,6102,1,PERF
42255323770000,PI,IP,001,26,14773,14774,6102,1,PERF
42255323770000,PI,IP,001,27,14831,14832,6102,1,PERF
42255323770000,PI,IP,001,28,14889,14890,6102,1,PERF
42255323770000,PI,IP,001,29,14947,14948,6102,1,PERF
42255323770000,PI,IP,001,30,15006,15007,6102,1,PERF
42255323770000,PI,IP,001,31,15065,15066,6102,1,PERF
42255323770000,PI,IP,001,32,15123,15124,6102,1,PERF
42255323770000,PI,IP,001,33,15189,15190,6102,1,PERF
42255323770000,PI,IP,001,34,15250,15251,6102,1,PERF
42255323770000,PI,IP,001,35,15310,15311,6102,1,PERF
42255323770000,PI,IP,001,36,15370,15371,6102,1,PERF
42255323770000,PI,IP,001,37,15430,15431,6102,1,PERF
42255323770000,PI,IP,001,38,15489,15490,6102,1,PERF
42255323770000,PI,IP,001,39,15546,15547,6102,1,PERF
42255323770000,PI,IP,001,40,15607,15608,6102,1,PERF
42255323770000,PI,IP,001,41,15665,15666,6102,1,PERF
42255323770000,PI,IP,001,42,15723,15724,6102,1,PERF
42255323770000,PI,IP,001,43,15783,15784,6102,1,PERF
42255323770000,PI,IP,001,44,15843,15844,6102,1,PERF
42255323770000,PI,IP,001,45,15898,15899,6102,1,PERF
42255323770000,PI,IP,001,46,15960,15961,6102,1,PERF
42255323770000,PI,IP,001,47,16076,16077,6102,1,PERF
42255323770000,PI,IP,001,48,16081,16082,6102,1,PERF
42255323770000,PI,IP,001,49,16132,16133,6102,1,PERF
42255323770000,PI,IP,001,50,16194,16195,6102,1,PERF
42255323770000,PI,IP,001,51,16252,16253,6102,1,PERF
42255323770000,PI,IP,001,52,16310,16311,6102,1,PERF
42255323770000,PI,IP,001,53,16364,16365,6102,1,PERF
42255323770000,PI,IP,001,54,16426,16427,6102,1,PERF
42255323770000,PI,IP,001,55,16484,16485,6102,1,PERF
42255323770000,PI,IP,001,56,16542,16543,6102,1,PERF
42255323770000,PI,IP,001,57,16601,16602,6102,1,PERF
42255323770000,PI,IP,001,58,16660,16661,6102,1,PERF
42255323770000,PI,IP,001,59,16719,16720,6102,1,PERF
42255323770000,PI,IP,001,60,16777,16778,6102,1,PERF
42255323770000,PI,IP,001,61,16837,16838,6102,1,PERF
42255323770000,PI,IP,001,62,16896,16897,6102,1,PERF
42255323770000,PI,IP,001,63,16955,16956,6102,1,PERF
42255323770000,PI,IP,001,64,17013,17014,6102,1,PERF
42255323770000,PI,IP,001,65,17072,17073,6102,1,PERF
42255323770000,PI,IP,001,66,17131,17132,6102,1,PERF
42255323770000,PI,IP,001,67,17191,17192,6102,1,PERF
42255323770000,PI,IP,001,68,17248,17249,6102,1,PERF
42255323770000,PI,IP,001,69,17306,17307,6102,1,PERF
42255323770000,PI,IP,001,70,17362,17363,6102,1,PERF
42255323770000,PI,IP,001,71,17418,17419,6102,1,PERF
42255323770000,PI,IP,001,72,17474,17475,6102,1,PERF
42255323770000,PI,IP,001,73,17534,17535,6102,1,PERF
42255323770000,PI,IP,001,74,17591,17592,6102,1,PERF
42255323770000,PI,IP,001,75,17650,17651,6102,1,PERF
42255323770000,PI,IP,001,76,17703,17704,6102,1,PERF
42255323770000,PI,IP,001,77,17759,17760,6102,1,PERF
42255323770000,PI,IP,001,78,17815,17816,6102,1,PERF
42255323770000,PI,IP,001,79,17875,17876,6102,1,PERF
42255323770000,PI,IP,001,80,17933,17934,6102,1,PERF
42255323770000,PI,IP,001,81,17991,17992,6102,1,PERF
42255323770000,PI,IP,001,82,18049,18050,6102,1,PERF
42255323770000,PI,IP,001,83,18107,18108,6102,1,PERF
42255323770000,PI,IP,001,84,18165,18166,6102,1,PERF
42255323770000,PI,IP,001,85,18255,18256,6102,1,PERF
42255323770000,PI,IP,001,86,18279,18280,6102,1,PERF
42255323770000,PI,IP,001,87,18334,18335,6102,1,PERF
42255323770000,PI,IP,001,88,18392,18393,6102,1,PERF
42255323770000,PI,IP,001,89,18450,18451,6102,1,PERF
42255323770000,PI,IP,001,90,18507,18508,6102,1,PERF
42255323780000,PI,IP,001,1,13359,19520,,6161,PERF
42255323790000,PI,IP,001,1,13265,19356,6491,6091,PERF
42255323800000,PI,IP,001,1,13275,19246,6436,5971,PERF
42255323820000,PI,IP,001,1,12625,18091,6213,5466,PERF
42255323850000,PI,IP,001,1,12326,17451,5508,5125,PERF
42255323860000,PI,IP,001,1,13133,13134,6784,1,PERF
42255323860000,PI,IP,001,2,13197,13198,6784,1,PERF
42255323860000,PI,IP,001,3,13261,13262,6784,1,PERF
42255323860000,PI,IP,001,4,13325,13326,6784,1,PERF
42255323860000,PI,IP,001,5,13389,13390,6784,1,PERF
42255323860000,PI,IP,001,6,13453,13454,6784,1,PERF
42255323860000,PI,IP,001,7,13518,13519,6784,1,PERF
42255323860000,PI,IP,001,8,13582,13583,6784,1,PERF
42255323860000,PI,IP,001,9,13647,13648,6784,1,PERF
42255323860000,PI,IP,001,10,13712,13713,6784,1,PERF
42255323860000,PI,IP,001,11,13783,13784,6784,1,PERF
42255323860000,PI,IP,001,12,13843,13844,6784,1,PERF
42255323860000,PI,IP,001,13,13908,13909,6784,1,PERF
42255323860000,PI,IP,001,14,13970,13971,6784,1,PERF
42255323860000,PI,IP,001,15,14032,14033,6784,1,PERF
42255323860000,PI,IP,001,16,14095,14096,6784,1,PERF
42255323860000,PI,IP,001,17,14158,14159,6784,1,PERF
42255323860000,PI,IP,001,18,14220,14221,6784,1,PERF
42255323860000,PI,IP,001,19,14285,14286,6784,1,PERF
42255323860000,PI,IP,001,20,14347,14348,6784,1,PERF
42255323860000,PI,IP,001,21,14409,14410,6784,1,PERF
42255323860000,PI,IP,001,22,14471,14472,6784,1,PERF
42255323860000,PI,IP,001,23,14533,14534,6784,1,PERF
42255323860000,PI,IP,001,24,14596,14597,6784,1,PERF
42255323860000,PI,IP,001,25,14656,14657,6784,1,PERF
42255323860000,PI,IP,001,26,14718,14719,6784,1,PERF
42255323860000,PI,IP,001,27,14780,14781,6784,1,PERF
42255323860000,PI,IP,001,28,14842,14843,6784,1,PERF
42255323860000,PI,IP,001,29,14904,14905,6784,1,PERF
42255323860000,PI,IP,001,30,14966,14967,6784,1,PERF
42255323860000,PI,IP,001,31,15031,15032,6784,1,PERF
42255323860000,PI,IP,001,32,15091,15092,6784,1,PERF
42255323860000,PI,IP,001,33,15151,15152,6784,1,PERF
42255323860000,PI,IP,001,34,15210,15211,6784,1,PERF
42255323860000,PI,IP,001,35,15267,15268,6784,1,PERF
42255323860000,PI,IP,001,36,15328,15329,6784,1,PERF
42255323860000,PI,IP,001,37,15391,15392,6784,1,PERF
42255323860000,PI,IP,001,38,15453,15454,6784,1,PERF
42255323860000,PI,IP,001,39,15515,15516,6784,1,PERF
42255323860000,PI,IP,001,40,15577,15578,6784,1,PERF
42255323860000,PI,IP,001,41,15635,15636,6784,1,PERF
42255323860000,PI,IP,001,42,15693,15694,6784,1,PERF
42255323860000,PI,IP,001,43,15753,15754,6784,1,PERF
42255323860000,PI,IP,001,44,15815,15816,6784,1,PERF
42255323860000,PI,IP,001,45,15877,15878,6784,1,PERF
42255323860000,PI,IP,001,46,15938,15939,6784,1,PERF
42255323860000,PI,IP,001,47,15998,15999,6784,1,PERF
42255323860000,PI,IP,001,48,16056,16057,6784,1,PERF
42255323860000,PI,IP,001,49,16114,16115,6784,1,PERF
42255323860000,PI,IP,001,50,16172,16173,6784,1,PERF
42255323860000,PI,IP,001,51,16231,16232,6784,1,PERF
42255323860000,PI,IP,001,52,16290,16291,6784,1,PERF
42255323860000,PI,IP,001,53,16348,16349,6784,1,PERF
42255323860000,PI,IP,001,54,16406,16407,6784,1,PERF
42255323860000,PI,IP,001,55,16464,16465,6784,1,PERF
42255323860000,PI,IP,001,56,16525,16526,6784,1,PERF
42255323860000,PI,IP,001,57,16584,16585,6784,1,PERF
42255323860000,PI,IP,001,58,16643,16644,6784,1,PERF
42255323860000,PI,IP,001,59,16700,16701,6784,1,PERF
42255323860000,PI,IP,001,60,16760,16761,6784,1,PERF
42255323860000,PI,IP,001,61,16821,16822,6784,1,PERF
42255323860000,PI,IP,001,62,16879,16880,6784,1,PERF
42255323860000,PI,IP,001,63,16935,16936,6784,1,PERF
42255323860000,PI,IP,001,64,16995,16997,6784,2,PERF
42255323860000,PI,IP,001,65,17054,17055,6784,1,PERF
42255323860000,PI,IP,001,66,17111,17112,6784,1,PERF
42255323860000,PI,IP,001,67,17171,17172,6784,1,PERF
42255323860000,PI,IP,001,68,17229,17230,6784,1,PERF
42255323860000,PI,IP,001,69,17287,17288,6784,1,PERF
42255323860000,PI,IP,001,70,17344,17345,6784,1,PERF
42255323860000,PI,IP,001,71,17401,17402,6784,1,PERF
42255323860000,PI,IP,001,72,17459,17460,6784,1,PERF
42255323860000,PI,IP,001,73,17519,17520,6784,1,PERF
42255323860000,PI,IP,001,74,17578,17579,6784,1,PERF
42255323860000,PI,IP,001,75,17637,17638,6784,1,PERF
42255323860000,PI,IP,001,76,17696,17697,6784,1,PERF
42255323860000,PI,IP,001,77,17755,17756,6784,1,PERF
42255323860000,PI,IP,001,78,17814,17815,6784,1,PERF
42255323860000,PI,IP,001,79,17878,17879,6784,1,PERF
42255323860000,PI,IP,001,80,17931,17932,6784,1,PERF
42255323860000,PI,IP,001,81,17989,17990,6784,1,PERF
42255323860000,PI,IP,001,82,18044,18045,6784,1,PERF
42255323860000,PI,IP,001,83,18099,18100,6784,1,PERF
42255323860000,PI,IP,001,84,18154,18155,6784,1,PERF
42255323860000,PI,IP,001,85,18214,18215,6784,1,PERF
42255323860000,PI,IP,001,86,18271,18272,6784,1,PERF
42255323860000,PI,IP,001,87,18326,18327,6784,1,PERF
42255323860000,PI,IP,001,88,18381,18382,6784,1,PERF
42255323860000,PI,IP,001,89,18436,18437,6784,1,PERF
42255323860000,PI,IP,001,90,18496,18497,6784,1,PERF
42255323860000,PI,IP,001,91,18551,18552,6784,1,PERF
42255323860000,PI,IP,001,92,18609,18610,6784,1,PERF
42255323860000,PI,IP,001,93,18667,18668,6784,1,PERF
42255323860000,PI,IP,001,94,18725,18726,6784,1,PERF
42255323860000,PI,IP,001,95,18783,18784,6784,1,PERF
42255323860000,PI,IP,001,96,18841,18842,6784,1,PERF
42255323860000,PI,IP,001,97,18901,18902,6784,1,PERF
42255323860000,PI,IP,001,98,18956,18957,6784,1,PERF
42255323860000,PI,IP,001,99,19011,19012,6784,1,PERF
42255323860000,PI,IP,001,100,19069,19070,6784,1,PERF
42255323860000,PI,IP,001,101,19125,19126,6784,1,PERF
42255323860000,PI,IP,001,102,19180,19181,6784,1,PERF
42255323890000,PI,IP,001,1,12592,18132,7326,5540,PERF
42255323900000,PI,IP,001,1,12340,12612,6815,272,PERF
42255323900000,PI,IP,001,2,12690,12962,6815,272,PERF
42255323900000,PI,IP,001,3,13040,13312,6815,272,PERF
42255323900000,PI,IP,001,4,13390,13662,6815,272,PERF
42255323900000,PI,IP,001,5,13740,14012,6815,272,PERF
42255323900000,PI,IP,001,6,14090,14356,6815,266,PERF
42255323900000,PI,IP,001,7,14440,14712,6815,272,PERF
42255323900000,PI,IP,001,8,14790,15062,6815,272,PERF
42255323900000,PI,IP,001,9,15140,15412,6815,272,PERF
42255323900000,PI,IP,001,10,15490,15762,6815,272,PERF
42255323900000,PI,IP,001,11,15837,16112,6815,275,PERF
42255323900000,PI,IP,001,12,16190,16462,6815,272,PERF
42255323900000,PI,IP,001,13,16540,16812,6815,272,PERF
42255323900000,PI,IP,001,14,16890,17162,6815,272,PERF
42255323900000,PI,IP,001,15,17238,17512,6815,274,PERF
42255323900000,PI,IP,001,16,17590,17862,6815,272,PERF
42255323900000,PI,IP,001,17,17948,18190,6815,242,PERF
42255323910000,PI,IP,001,1,13480,18644,5422,5164,PERF
42255323920000,PI,IP,001,1,12490,18198,6059,5708,PERF
42255323930000,PI,IP,001,1,12733,13004,5928,271,PERF
42255323930000,PI,IP,001,2,13072,13341,5928,269,PERF
42255323930000,PI,IP,001,3,13421,13685,5928,264,PERF
42255323930000,PI,IP,001,4,13765,14032,5928,267,PERF
42255323930000,PI,IP,001,5,14109,14373,5928,264,PERF
42255323930000,PI,IP,001,6,14453,14717,5928,264,PERF
42255323930000,PI,IP,001,7,14797,15061,5928,264,PERF
42255323930000,PI,IP,001,8,15141,15405,5928,264,PERF
42255323930000,PI,IP,001,9,15490,15749,5928,259,PERF
42255323930000,PI,IP,001,10,15829,16093,5928,264,PERF
42255323930000,PI,IP,001,11,16173,16437,5928,264,PERF
42255323930000,PI,IP,001,12,16517,16781,5928,264,PERF
42255323930000,PI,IP,001,13,16861,17125,5928,264,PERF
42255323930000,PI,IP,001,14,17205,17469,5928,264,PERF
42255323930000,PI,IP,001,15,17549,17821,5928,272,PERF
42255323950000,PI,IP,001,1,13474,17699,,4225,PERF
42255323960000,PI,IP,001,1,13128,19291,,6163,PERF
42255323970000,PI,IP,001,1,12710,12882,6082,172,PERF
42255323970000,PI,IP,001,2,13045,13302,6082,257,PERF
42255323970000,PI,IP,001,3,13380,13637,6082,257,PERF
42255323970000,PI,IP,001,4,13715,13972,6082,257,PERF
42255323970000,PI,IP,001,5,14050,14307,6082,257,PERF
42255323970000,PI,IP,001,6,14385,14642,6082,257,PERF
42255323970000,PI,IP,001,7,14720,14977,6082,257,PERF
42255323970000,PI,IP,001,8,15057,15312,6082,255,PERF
42255323970000,PI,IP,001,9,15390,15637,6082,247,PERF
42255323970000,PI,IP,001,10,15715,15957,6082,242,PERF
42255323970000,PI,IP,001,11,16035,16277,6082,242,PERF
42255323970000,PI,IP,001,12,16355,16597,6082,242,PERF
42255323970000,PI,IP,001,13,16677,16934,6082,257,PERF
42255323970000,PI,IP,001,14,17002,17257,6082,255,PERF
42255323970000,PI,IP,001,15,17327,17584,6082,257,PERF
42255323970000,PI,IP,001,16,17654,17909,6082,255,PERF
42255323970000,PI,IP,001,17,17977,18222,6082,245,PERF
42255323980000,PI,IP,001,1,12413,18588,6718,6175,PERF
42255323990000,PI,IP,001,1,13300,19201,6524,5901,PERF
42255324000000,PI,IP,001,1,13320,19641,6590,6321,PERF
42255324010100,PI,IP,001,1,10035,10211,6448,176,PERF
42255324010100,PI,IP,001,2,10286,10462,6448,176,PERF
42255324010100,PI,IP,001,3,10537,10714,6448,177,PERF
42255324010100,PI,IP,001,4,10789,10965,6448,176,PERF
42255324010100,PI,IP,001,5,11040,11216,6448,176,PERF
42255324010100,PI,IP,001,6,11291,11467,6448,176,PERF
42255324010100,PI,IP,001,7,11542,11718,6448,176,PERF
42255324010100,PI,IP,001,8,11793,11970,6448,177,PERF
42255324010100,PI,IP,001,9,12045,12221,6448,176,PERF
42255324010100,PI,IP,001,10,12296,12472,6448,176,PERF
42255324010100,PI,IP,001,11,12547,12723,6448,176,PERF
42255324010100,PI,IP,001,12,12798,12975,6448,177,PERF
42255324010100,PI,IP,001,13,13050,13226,6448,176,PERF
42255324010100,PI,IP,001,14,13301,13477,6448,176,PERF
42255324010100,PI,IP,001,15,13552,13728,6448,176,PERF
42255324010100,PI,IP,001,16,13803,13979,6448,176,PERF
42255324010100,PI,IP,001,17,14054,14231,6448,177,PERF
42255324010100,PI,IP,001,18,14306,14482,6448,176,PERF
42255324010100,PI,IP,001,19,14557,14733,6448,176,PERF
42255324010100,PI,IP,001,20,14808,14984,6448,176,PERF
42255324010100,PI,IP,001,21,15059,15235,6448,176,PERF
42255324010100,PI,IP,001,22,15310,15487,6448,177,PERF
42255324010100,PI,IP,001,23,15562,15738,6448,176,PERF
42255324010100,PI,IP,001,24,15813,15989,6448,176,PERF
42255324020000,PI,IP,001,1,11715,11987,5305,272,PERF
42255324020000,PI,IP,001,2,12075,12347,5305,272,PERF
42255324020000,PI,IP,001,3,12435,12707,5305,272,PERF
42255324020000,PI,IP,001,4,12795,13067,5305,272,PERF
42255324020000,PI,IP,001,5,13155,13422,5305,267,PERF
42255324020000,PI,IP,001,6,13510,13792,5305,282,PERF
42255324020000,PI,IP,001,7,13875,14147,5305,272,PERF
42255324020000,PI,IP,001,8,14235,14522,5305,287,PERF
42255324020000,PI,IP,001,9,14610,14897,5305,287,PERF
42255324020000,PI,IP,001,10,14985,15272,5305,287,PERF
42255324020000,PI,IP,001,11,15360,15630,5305,270,PERF
42255324020000,PI,IP,001,12,15720,15992,5305,272,PERF
42255324020000,PI,IP,001,13,16081,16238,5305,157,PERF
42255324030000,PI,IP,001,1,12916,13175,6079,259,PERF
42255324030000,PI,IP,001,2,13256,13520,6079,264,PERF
42255324030000,PI,IP,001,3,13601,13865,6079,264,PERF
42255324030000,PI,IP,001,4,13946,14212,6079,266,PERF
42255324030000,PI,IP,001,5,14291,14557,6079,266,PERF
42255324030000,PI,IP,001,6,14636,14900,6079,264,PERF
42255324030000,PI,IP,001,7,14981,15286,6079,305,PERF
42255324030000,PI,IP,001,8,15326,15592,6079,266,PERF
42255324030000,PI,IP,001,9,15671,15935,6079,264,PERF
42255324030000,PI,IP,001,10,16016,16280,6079,264,PERF
42255324030000,PI,IP,001,11,16361,16625,6079,264,PERF
42255324030000,PI,IP,001,12,16704,16970,6079,266,PERF
42255324030000,PI,IP,001,13,17051,17317,6079,266,PERF
42255324030000,PI,IP,001,14,17396,17660,6079,264,PERF
42255324030000,PI,IP,001,15,17741,17997,6079,256,PERF
42255324040100,PI,IP,001,1,10620,10789,6808,169,PERF
42255324040100,PI,IP,001,2,10864,11032,6808,168,PERF
42255324040100,PI,IP,001,3,11107,11276,6808,169,PERF
42255324040100,PI,IP,001,4,11351,11520,6808,169,PERF
42255324040100,PI,IP,001,5,11595,11763,6808,168,PERF
42255324040100,PI,IP,001,6,11838,12007,6808,169,PERF
42255324040100,PI,IP,001,7,12082,12250,6808,168,PERF
42255324040100,PI,IP,001,8,12325,12494,6808,169,PERF
42255324040100,PI,IP,001,9,12569,12738,6808,169,PERF
42255324040100,PI,IP,001,10,12813,12981,6808,168,PERF
42255324040100,PI,IP,001,11,13056,13225,6808,169,PERF
42255324040100,PI,IP,001,12,13300,13469,6808,169,PERF
42255324040100,PI,IP,001,13,13544,13712,6808,168,PERF
42255324040100,PI,IP,001,14,13787,13956,6808,169,PERF
42255324040100,PI,IP,001,15,14031,14199,6808,168,PERF
42255324040100,PI,IP,001,16,14274,14443,6808,169,PERF
42255324040100,PI,IP,001,17,14518,14687,6808,169,PERF
42255324040100,PI,IP,001,18,14762,14930,6808,168,PERF
42255324040100,PI,IP,001,19,15005,15174,6808,169,PERF
42255324040100,PI,IP,001,20,15249,15418,6808,169,PERF
42255324040100,PI,IP,001,21,15493,15661,6808,168,PERF
42255324040100,PI,IP,001,22,15736,15905,6808,169,PERF
42255324040100,PI,IP,001,23,15980,16148,6808,168,PERF
42255324040100,PI,IP,001,24,16223,16392,6808,169,PERF
42255324050000,PI,IP,001,1,10528,15719,5544,5191,PERF
42255324060000,PI,IP,001,1,13119,13257,6244,138,PERF
42255324060000,PI,IP,001,2,13429,13668,6244,239,PERF
42255324060000,PI,IP,001,3,13740,13912,6244,172,PERF
42255324060000,PI,IP,001,4,14075,14332,6244,257,PERF
42255324060000,PI,IP,001,5,14410,14667,6244,257,PERF
42255324060000,PI,IP,001,6,14745,15002,6244,257,PERF
42255324060000,PI,IP,001,7,15080,15337,6244,257,PERF
42255324060000,PI,IP,001,8,15415,15672,6244,257,PERF
42255324060000,PI,IP,001,9,15750,16007,6244,257,PERF
42255324060000,PI,IP,001,10,16085,16342,6244,257,PERF
42255324060000,PI,IP,001,11,16420,16592,6244,172,PERF
42255324060000,PI,IP,001,12,16755,17012,6244,257,PERF
42255324060000,PI,IP,001,13,17090,17347,6244,257,PERF
42255324060000,PI,IP,001,14,17425,17682,6244,257,PERF
42255324060000,PI,IP,001,15,17760,18032,6244,272,PERF
42255324070000,PI,IP,001,1,11040,17024,6442,5984,PERF
42255324080000,PI,IP,001,1,12624,12876,5377,252,PERF
42255324080000,PI,IP,001,2,12956,13208,5377,252,PERF
42255324080000,PI,IP,001,3,13286,13540,5377,254,PERF
42255324080000,PI,IP,001,4,13620,13872,5377,252,PERF
42255324080000,PI,IP,001,5,13950,14204,5377,254,PERF
42255324080000,PI,IP,001,6,14282,14536,5377,254,PERF
42255324080000,PI,IP,001,7,14614,14868,5377,254,PERF
42255324080000,PI,IP,001,8,14946,15200,5377,254,PERF
42255324080000,PI,IP,001,9,15278,15532,5377,254,PERF
42255324080000,PI,IP,001,10,15610,15864,5377,254,PERF
42255324080000,PI,IP,001,11,15942,16196,5377,254,PERF
42255324080000,PI,IP,001,12,16274,16528,5377,254,PERF
42255324080000,PI,IP,001,13,16606,16860,5377,254,PERF
42255324080000,PI,IP,001,14,16938,17202,5377,264,PERF
42255324090000,PI,IP,001,1,13260,19351,5682,6091,PERF
42255324100000,PI,IP,001,1,11511,17834,6538,6323,PERF
42255324140000,PI,IP,001,1,11832,12011,5557,179,PERF
42255324140000,PI,IP,001,2,12086,12260,5557,174,PERF
42255324140000,PI,IP,001,3,12340,12519,5557,179,PERF
42255324140000,PI,IP,001,4,12594,12773,5557,179,PERF
42255324140000,PI,IP,001,5,12848,13030,5557,182,PERF
42255324140000,PI,IP,001,6,13103,13282,5557,179,PERF
42255324140000,PI,IP,001,7,13362,13536,5557,174,PERF
42255324140000,PI,IP,001,8,13611,13790,5557,179,PERF
42255324140000,PI,IP,001,9,13865,14048,5557,183,PERF
42255324140000,PI,IP,001,10,14119,14290,5557,171,PERF
42255324140000,PI,IP,001,11,14380,14552,5557,172,PERF
42255324140000,PI,IP,001,12,14627,14806,5557,179,PERF
42255324140000,PI,IP,001,13,14881,15050,5557,169,PERF
42255324140000,PI,IP,001,14,15135,15315,5557,180,PERF
42255324140000,PI,IP,001,15,15400,15569,5557,169,PERF
42255324140000,PI,IP,001,16,15644,15823,5557,179,PERF
42255324140000,PI,IP,001,17,15898,16070,5557,172,PERF
42255324140000,PI,IP,001,18,16152,16331,5557,179,PERF
42255324140000,PI,IP,001,19,16406,16585,5557,179,PERF
42255324150100,PI,IP,001,1,12260,19087,7401,6827,PERF
42255324160000,PI,IP,001,1,11268,17399,6719,6131,PERF
42255324170000,PI,IP,001,1,12438,17374,5410,4936,PERF
42255324180000,PI,IP,001,1,11318,17342,6604,6024,PERF
42255324190100,PI,IP,001,1,11453,16806,5594,5353,PERF
42255324200000,PI,IP,001,1,10865,14968,4541,4103,PERF
42255324210000,PI,IP,001,1,13584,18692,5424,5108,PERF
42255324240000,PI,IP,001,1,12183,17367,5720,5184,PERF
42255324250000,PI,IP,001,1,11710,16284,4747,4574,PERF
42255324260000,PI,IP,001,1,12177,12447,6637,270,PERF
42255324260000,PI,IP,001,2,12535,12807,6637,272,PERF
42255324260000,PI,IP,001,3,12895,13167,6637,272,PERF
42255324260000,PI,IP,001,4,13255,13527,6637,272,PERF
42255324260000,PI,IP,001,5,13615,13887,6637,272,PERF
42255324260000,PI,IP,001,6,13975,14247,6637,272,PERF
42255324260000,PI,IP,001,7,14335,14607,6637,272,PERF
42255324260000,PI,IP,001,8,14695,14967,6637,272,PERF
42255324260000,PI,IP,001,9,15055,15327,6637,272,PERF
42255324260000,PI,IP,001,10,15415,15687,6637,272,PERF
42255324260000,PI,IP,001,11,15775,16047,6637,272,PERF
42255324260000,PI,IP,001,12,16135,16407,6637,272,PERF
42255324260000,PI,IP,001,13,16495,16767,6637,272,PERF
42255324260000,PI,IP,001,14,16855,17127,6637,272,PERF
42255324260000,PI,IP,001,15,17215,17532,6637,317,PERF
42255324260000,PI,IP,001,16,17567,17743,6637,176,PERF
42255324260000,PI,IP,001,17,17836,18100,6637,264,PERF
42255324280000,PI,IP,001,1,10313,15099,5459,4786,PERF
42255324300000,PI,IP,001,1,12240,12482,6410,242,PERF
42255324300000,PI,IP,001,2,12560,12802,6410,242,PERF
42255324300000,PI,IP,001,3,12880,13126,6410,246,PERF
42255324300000,PI,IP,001,4,13205,13472,6410,267,PERF
42255324300000,PI,IP,001,5,13550,13827,6410,277,PERF
42255324300000,PI,IP,001,6,13907,14172,6410,265,PERF
42255324300000,PI,IP,001,7,14250,14518,6410,268,PERF
42255324300000,PI,IP,001,8,14600,14872,6410,272,PERF
42255324300000,PI,IP,001,9,14950,15218,6410,268,PERF
42255324300000,PI,IP,001,10,15298,15572,6410,274,PERF
42255324300000,PI,IP,001,11,15650,15920,6410,270,PERF
42255324300000,PI,IP,001,12,16008,16272,6410,264,PERF
42255324300000,PI,IP,001,13,16350,16622,6410,272,PERF
42255324300000,PI,IP,001,14,16696,16972,6410,276,PERF
42255324300000,PI,IP,001,15,17050,17322,6410,272,PERF
42255324300000,PI,IP,001,16,17400,17672,6410,272,PERF
42255324300000,PI,IP,001,17,17752,18000,6410,248,PERF
42255324310000,PI,IP,001,1,13755,18586,4982,4831,PERF
42255324320000,PI,IP,001,1,13502,19594,5992,6092,PERF
42255324330000,PI,IP,001,1,11050,18010,,6960,PERF
42255324340000,PI,IP,001,1,11170,17772,7097,6602,PERF
42255324350000,PI,IP,001,1,11050,11270,6607,220,PERF
42255324350000,PI,IP,001,2,11345,11566,6607,221,PERF
42255324350000,PI,IP,001,3,11641,11861,6607,220,PERF
42255324350000,PI,IP,001,4,11936,12156,6607,220,PERF
42255324350000,PI,IP,001,5,12231,12452,6607,221,PERF
42255324350000,PI,IP,001,6,12527,12747,6607,220,PERF
42255324350000,PI,IP,001,7,12822,13042,6607,220,PERF
42255324350000,PI,IP,001,8,13117,13338,6607,221,PERF
42255324350000,PI,IP,001,9,13413,13633,6607,220,PERF
42255324350000,PI,IP,001,10,13708,13928,6607,220,PERF
42255324350000,PI,IP,001,11,14003,14224,6607,221,PERF
42255324350000,PI,IP,001,12,14299,14519,6607,220,PERF
42255324350000,PI,IP,001,13,14594,14814,6607,220,PERF
42255324350000,PI,IP,001,14,14889,15110,6607,221,PERF
42255324350000,PI,IP,001,15,15185,15405,6607,220,PERF
42255324350000,PI,IP,001,16,15480,15600,6607,120,PERF
42255324350000,PI,IP,001,17,15696,15775,6607,79,PERF
42255324350000,PI,IP,001,18,16071,16291,6607,220,PERF
42255324370000,PI,IP,001,1,10850,15334,4958,4484,PERF
42255324380000,PI,IP,001,1,10880,14972,4416,4092,PERF
42255324390000,PI,IP,001,1,13080,17386,,4306,PERF
42255324400000,PI,IP,001,1,12050,12288,4160,238,PERF
42255324400000,PI,IP,001,2,12350,12592,4160,242,PERF
42255324400000,PI,IP,001,3,12650,12892,4160,242,PERF
42255324400000,PI,IP,001,4,12950,13192,4160,242,PERF
42255324400000,PI,IP,001,5,13250,13492,4160,242,PERF
42255324400000,PI,IP,001,6,13550,13790,4160,240,PERF
42255324400000,PI,IP,001,7,13850,14092,4160,242,PERF
42255324400000,PI,IP,001,8,14151,14392,4160,241,PERF
42255324400000,PI,IP,001,9,14450,14700,4160,250,PERF
42255324400000,PI,IP,001,10,14750,14992,4160,242,PERF
42255324400000,PI,IP,001,11,15028,15300,4160,272,PERF
42255324410000,PI,IP,001,1,12090,12302,4133,212,PERF
42255324410000,PI,IP,001,2,12360,12600,4133,240,PERF
42255324410000,PI,IP,001,3,12660,12902,4133,242,PERF
42255324410000,PI,IP,001,4,12958,13202,4133,244,PERF
42255324410000,PI,IP,001,5,13260,13502,4133,242,PERF
42255324410000,PI,IP,001,6,13560,13802,4133,242,PERF
42255324410000,PI,IP,001,7,13860,14102,4133,242,PERF
42255324410000,PI,IP,001,8,14160,14402,4133,242,PERF
42255324410000,PI,IP,001,9,14460,14700,4133,240,PERF
42255324410000,PI,IP,001,10,14760,15002,4133,242,PERF
42255324410000,PI,IP,001,11,15060,15332,4133,272,PERF
42255324420000,PI,IP,001,1,12927,18691,6211,5764,PERF
42255324430000,PI,IP,001,1,12034,12288,4117,254,PERF
42255324430000,PI,IP,001,2,12350,12592,4117,242,PERF
42255324430000,PI,IP,001,3,12733,12892,4117,159,PERF
42255324430000,PI,IP,001,4,12950,13112,4117,162,PERF
42255324430000,PI,IP,001,5,13250,13492,4117,242,PERF
42255324430000,PI,IP,001,6,13630,13792,4117,162,PERF
42255324430000,PI,IP,001,7,13850,14092,4117,242,PERF
42255324430000,PI,IP,001,8,14225,14392,4117,167,PERF
42255324430000,PI,IP,001,9,14450,14692,4117,242,PERF
42255324430000,PI,IP,001,10,14750,14992,4117,242,PERF
42255324430000,PI,IP,001,11,15052,15332,4117,280,PERF
42255324440000,PI,IP,001,1,11274,15808,4974,4534,PERF
42255324450000,PI,IP,001,1,12440,12629,6773,189,PERF
42255324450000,PI,IP,001,2,12710,12982,6773,272,PERF
42255324450000,PI,IP,001,3,13070,13342,6773,272,PERF
42255324450000,PI,IP,001,4,13430,13706,6773,276,PERF
42255324450000,PI,IP,001,5,13790,14062,6773,272,PERF
42255324450000,PI,IP,001,6,14150,14422,6773,272,PERF
42255324450000,PI,IP,001,7,14510,14782,6773,272,PERF
42255324450000,PI,IP,001,8,14870,15142,6773,272,PERF
42255324450000,PI,IP,001,9,15230,15502,6773,272,PERF
42255324450000,PI,IP,001,10,15590,15862,6773,272,PERF
42255324450000,PI,IP,001,11,15950,16222,6773,272,PERF
42255324450000,PI,IP,001,12,16317,16586,6773,269,PERF
42255324450000,PI,IP,001,13,16670,16942,6773,272,PERF
42255324450000,PI,IP,001,14,17030,17302,6773,272,PERF
42255324450000,PI,IP,001,15,17395,17662,6773,267,PERF
42255324450000,PI,IP,001,16,17750,18022,6773,272,PERF
42255324450000,PI,IP,001,17,18104,18376,6773,272,PERF
42255324460000,PI,IP,001,1,13086,18685,6630,5599,PERF
42255324470000,PI,IP,001,1,11398,16270,,4872,PERF
42255324480000,PI,IP,001,1,13572,18367,6578,4795,PERF
42255324490000,PI,IP,001,1,12125,12397,5377,272,PERF
42255324490000,PI,IP,001,2,12480,12752,5377,272,PERF
42255324490000,PI,IP,001,3,12835,13107,5377,272,PERF
42255324490000,PI,IP,001,4,13195,13467,5377,272,PERF
42255324490000,PI,IP,001,5,13555,13827,5377,272,PERF
42255324490000,PI,IP,001,6,13915,14187,5377,272,PERF
42255324490000,PI,IP,001,7,14275,14547,5377,272,PERF
42255324490000,PI,IP,001,8,14635,14907,5377,272,PERF
42255324490000,PI,IP,001,9,14995,15267,5377,272,PERF
42255324490000,PI,IP,001,10,15360,15632,5377,272,PERF
42255324490000,PI,IP,001,11,15720,15987,5377,267,PERF
42255324490000,PI,IP,001,12,16075,16347,5377,272,PERF
42255324490000,PI,IP,001,13,16428,16692,5377,264,PERF
42255324500000,PI,IP,001,1,10210,10387,5937,177,PERF
42255324500000,PI,IP,001,2,10462,10638,5937,176,PERF
42255324500000,PI,IP,001,3,10713,10890,5937,177,PERF
42255324500000,PI,IP,001,4,10965,11142,5937,177,PERF
42255324500000,PI,IP,001,5,11217,11393,5937,176,PERF
42255324500000,PI,IP,001,6,11468,11645,5937,177,PERF
42255324500000,PI,IP,001,7,11720,11897,5937,177,PERF
42255324500000,PI,IP,001,8,11972,12148,5937,176,PERF
42255324500000,PI,IP,001,9,12223,12400,5937,177,PERF
42255324500000,PI,IP,001,10,12475,12652,5937,177,PERF
42255324500000,PI,IP,001,11,12727,12904,5937,177,PERF
42255324500000,PI,IP,001,12,12979,13155,5937,176,PERF
42255324500000,PI,IP,001,13,13230,13407,5937,177,PERF
42255324500000,PI,IP,001,14,13482,13659,5937,177,PERF
42255324500000,PI,IP,001,15,13734,13910,5937,176,PERF
42255324500000,PI,IP,001,16,13985,14162,5937,177,PERF
42255324500000,PI,IP,001,17,14237,14414,5937,177,PERF
42255324500000,PI,IP,001,18,14489,14665,5937,176,PERF
42255324500000,PI,IP,001,19,14740,14917,5937,177,PERF
42255324500000,PI,IP,001,20,14992,15169,5937,177,PERF
42255324500000,PI,IP,001,21,15244,15420,5937,176,PERF
42255324500000,PI,IP,001,22,15495,15672,5937,177,PERF
42255324520000,PI,IP,001,1,11606,17747,,6141,PERF
42255324530000,PI,IP,001,1,11588,16127,4952,4539,PERF
42255324540000,PI,IP,001,1,12057,12230,5375,173,PERF
42255324540000,PI,IP,001,2,12318,12490,5375,172,PERF
42255324540000,PI,IP,001,3,12565,12744,5375,179,PERF
42255324540000,PI,IP,001,4,12819,12999,5375,180,PERF
42255324540000,PI,IP,001,5,13074,13256,5375,182,PERF
42255324540000,PI,IP,001,6,13328,13500,5375,172,PERF
42255324540000,PI,IP,001,7,13582,13751,5375,169,PERF
42255324540000,PI,IP,001,8,13844,14015,5375,171,PERF
42255324540000,PI,IP,001,9,14090,14264,5375,174,PERF
42255324540000,PI,IP,001,10,14342,14524,5375,182,PERF
42255324540000,PI,IP,001,11,14596,14778,5375,182,PERF
42255324540000,PI,IP,001,12,14853,15032,5375,179,PERF
42255324540000,PI,IP,001,13,15107,15286,5375,179,PERF
42255324540000,PI,IP,001,14,15361,15532,5375,171,PERF
42255324540000,PI,IP,001,15,15615,15790,5375,175,PERF
42255324540000,PI,IP,001,16,15869,16049,5375,180,PERF
42255324540000,PI,IP,001,17,16122,16303,5375,181,PERF
42255324540000,PI,IP,001,18,16378,16557,5375,179,PERF
42255324540000,PI,IP,001,19,16632,16811,5375,179,PERF
42255324550000,PI,IP,001,1,13139,18293,,5154,PERF
42255324560100,PI,IP,001,1,12076,16973,5568,4897,PERF
42255324570000,PI,IP,001,1,13491,17709,4870,4218,PERF
42255324580000,PI,IP,001,1,11992,12182,5244,190,PERF
42255324580000,PI,IP,001,2,12257,12437,5244,180,PERF
42255324580000,PI,IP,001,3,12512,12684,5244,172,PERF
42255324580000,PI,IP,001,4,12767,12947,5244,180,PERF
42255324580000,PI,IP,001,5,13022,13202,5244,180,PERF
42255324580000,PI,IP,001,6,13272,13450,5244,178,PERF
42255324580000,PI,IP,001,7,13540,13712,5244,172,PERF
42255324580000,PI,IP,001,8,13787,13967,5244,180,PERF
42255324580000,PI,IP,001,9,14042,14222,5244,180,PERF
42255324580000,PI,IP,001,10,14304,14477,5244,173,PERF
42255324580000,PI,IP,001,11,14552,14722,5244,170,PERF
42255324580000,PI,IP,001,12,14807,14987,5244,180,PERF
42255324580000,PI,IP,001,13,15067,15240,5244,173,PERF
42255324580000,PI,IP,001,14,15317,15497,5244,180,PERF
42255324580000,PI,IP,001,15,15570,15752,5244,182,PERF
42255324580000,PI,IP,001,16,15827,16007,5244,180,PERF
42255324580000,PI,IP,001,17,16082,16252,5244,170,PERF
42255324580000,PI,IP,001,18,16337,16517,5244,180,PERF
42255324580000,PI,IP,001,19,16592,16772,5244,180,PERF
42255324590000,PI,IP,001,1,11479,17828,6490,6349,PERF
42255324610000,PI,IP,001,1,12770,17894,5710,5124,PERF
42255324620000,PI,IP,001,1,12315,12315,5705,0,PERF
42255324620000,PI,IP,001,2,12379,12379,5705,0,PERF
42255324620000,PI,IP,001,3,12442,12442,5705,0,PERF
42255324620000,PI,IP,001,4,12506,12506,5705,0,PERF
42255324620000,PI,IP,001,5,12581,12581,5705,0,PERF
42255324620000,PI,IP,001,6,12645,12645,5705,0,PERF
42255324620000,PI,IP,001,7,12709,12709,5705,0,PERF
42255324620000,PI,IP,001,8,12772,12772,5705,0,PERF
42255324620000,PI,IP,001,9,12847,12847,5705,0,PERF
42255324620000,PI,IP,001,10,12911,12911,5705,0,PERF
42255324620000,PI,IP,001,11,12975,12975,5705,0,PERF
42255324620000,PI,IP,001,12,13039,13039,5705,0,PERF
42255324620000,PI,IP,001,13,13114,13114,5705,0,PERF
42255324620000,PI,IP,001,14,13177,13177,5705,0,PERF
42255324620000,PI,IP,001,15,13241,13241,5705,0,PERF
42255324620000,PI,IP,001,16,13305,13305,5705,0,PERF
42255324620000,PI,IP,001,17,13380,13380,5705,0,PERF
42255324620000,PI,IP,001,18,13444,13444,5705,0,PERF
42255324620000,PI,IP,001,19,13507,13507,5705,0,PERF
42255324620000,PI,IP,001,20,13571,13571,5705,0,PERF
42255324620000,PI,IP,001,21,13646,13646,5705,0,PERF
42255324620000,PI,IP,001,22,13710,13710,5705,0,PERF
42255324620000,PI,IP,001,23,13773,13773,5705,0,PERF
42255324620000,PI,IP,001,24,13837,13837,5705,0,PERF
42255324620000,PI,IP,001,25,13912,13912,5705,0,PERF
42255324620000,PI,IP,001,26,13976,13976,5705,0,PERF
42255324620000,PI,IP,001,27,14040,14040,5705,0,PERF
42255324620000,PI,IP,001,28,14103,14103,5705,0,PERF
42255324620000,PI,IP,001,29,14178,14178,5705,0,PERF
42255324620000,PI,IP,001,30,14242,14242,5705,0,PERF
42255324620000,PI,IP,001,31,14306,14306,5705,0,PERF
42255324620000,PI,IP,001,32,14370,14370,5705,0,PERF
42255324620000,PI,IP,001,33,14445,14445,5705,0,PERF
42255324620000,PI,IP,001,34,14508,14508,5705,0,PERF
42255324620000,PI,IP,001,35,14572,14572,5705,0,PERF
42255324620000,PI,IP,001,36,14636,14636,5705,0,PERF
42255324620000,PI,IP,001,37,14711,14711,5705,0,PERF
42255324620000,PI,IP,001,38,14775,14775,5705,0,PERF
42255324620000,PI,IP,001,39,14838,14838,5705,0,PERF
42255324620000,PI,IP,001,40,14902,14902,5705,0,PERF
42255324620000,PI,IP,001,41,14977,14977,5705,0,PERF
42255324620000,PI,IP,001,42,15041,15041,5705,0,PERF
42255324620000,PI,IP,001,43,15104,15104,5705,0,PERF
42255324620000,PI,IP,001,44,15168,15168,5705,0,PERF
42255324620000,PI,IP,001,45,15243,15243,5705,0,PERF
42255324620000,PI,IP,001,46,15307,15307,5705,0,PERF
42255324620000,PI,IP,001,47,15371,15371,5705,0,PERF
42255324620000,PI,IP,001,48,15434,15434,5705,0,PERF
42255324620000,PI,IP,001,49,15509,15509,5705,0,PERF
42255324620000,PI,IP,001,50,15573,15573,5705,0,PERF
42255324620000,PI,IP,001,51,15637,15637,5705,0,PERF
42255324620000,PI,IP,001,52,15701,15701,5705,0,PERF
42255324620000,PI,IP,001,53,15776,15776,5705,0,PERF
42255324620000,PI,IP,001,54,15839,15839,5705,0,PERF
42255324620000,PI,IP,001,55,15903,15903,5705,0,PERF
42255324620000,PI,IP,001,56,15967,15967,5705,0,PERF
42255324620000,PI,IP,001,57,16042,16042,5705,0,PERF
42255324620000,PI,IP,001,58,16106,16106,5705,0,PERF
42255324620000,PI,IP,001,59,16169,16169,5705,0,PERF
42255324620000,PI,IP,001,60,16233,16233,5705,0,PERF
42255324620000,PI,IP,001,61,16308,16308,5705,0,PERF
42255324620000,PI,IP,001,62,16372,16372,5705,0,PERF
42255324620000,PI,IP,001,63,16435,16435,5705,0,PERF
42255324620000,PI,IP,001,64,16499,16499,5705,0,PERF
42255324620000,PI,IP,001,65,16574,16574,5705,0,PERF
42255324620000,PI,IP,001,66,16638,16638,5705,0,PERF
42255324620000,PI,IP,001,67,16702,16702,5705,0,PERF
42255324620000,PI,IP,001,68,16765,16765,5705,0,PERF
42255324620000,PI,IP,001,69,16840,16840,5705,0,PERF
42255324620000,PI,IP,001,70,16904,16904,5705,0,PERF
42255324620000,PI,IP,001,71,16968,16968,5705,0,PERF
42255324620000,PI,IP,001,72,17032,17032,5705,0,PERF
42255324620000,PI,IP,001,73,17107,17107,5705,0,PERF
42255324620000,PI,IP,001,74,17170,17170,5705,0,PERF
42255324620000,PI,IP,001,75,17234,17234,5705,0,PERF
42255324620000,PI,IP,001,76,17298,17298,5705,0,PERF
42255324620000,PI,IP,001,77,17373,17373,5705,0,PERF
42255324620000,PI,IP,001,78,17437,17437,5705,0,PERF
42255324620000,PI,IP,001,79,17500,17500,5705,0,PERF
42255324620000,PI,IP,001,80,17564,17564,5705,0,PERF
42255324640000,PI,IP,001,1,12887,13159,6087,272,PERF
42255324640000,PI,IP,001,2,13247,13519,6087,272,PERF
42255324640000,PI,IP,001,3,13607,13879,6087,272,PERF
42255324640000,PI,IP,001,4,13967,14239,6087,272,PERF
42255324640000,PI,IP,001,5,14327,14599,6087,272,PERF
42255324640000,PI,IP,001,6,14687,14959,6087,272,PERF
42255324640000,PI,IP,001,7,15047,15319,6087,272,PERF
42255324640000,PI,IP,001,8,15407,15679,6087,272,PERF
42255324640000,PI,IP,001,9,15767,16039,6087,272,PERF
42255324640000,PI,IP,001,10,16127,16394,6087,267,PERF
42255324640000,PI,IP,001,11,16482,16752,6087,270,PERF
42255324640000,PI,IP,001,12,16850,17119,6087,269,PERF
42255324640000,PI,IP,001,13,17207,17397,6087,190,PERF
42255324640000,PI,IP,001,14,17567,17839,6087,272,PERF
42255324640000,PI,IP,001,15,17927,18199,6087,272,PERF
42255324660000,PI,IP,001,1,13005,13282,6062,277,PERF
42255324660000,PI,IP,001,2,13360,13632,6062,272,PERF
42255324660000,PI,IP,001,3,13710,13982,6062,272,PERF
42255324660000,PI,IP,001,4,14060,14332,6062,272,PERF
42255324660000,PI,IP,001,5,14410,14682,6062,272,PERF
42255324660000,PI,IP,001,6,14760,15032,6062,272,PERF
42255324660000,PI,IP,001,7,15110,15382,6062,272,PERF
42255324660000,PI,IP,001,8,15460,15732,6062,272,PERF
42255324660000,PI,IP,001,9,15810,16082,6062,272,PERF
42255324660000,PI,IP,001,10,16160,16432,6062,272,PERF
42255324660000,PI,IP,001,11,16510,16782,6062,272,PERF
42255324660000,PI,IP,001,12,16860,17132,6062,272,PERF
42255324660000,PI,IP,001,13,17210,17482,6062,272,PERF
42255324660000,PI,IP,001,14,17560,17832,6062,272,PERF
42255324660000,PI,IP,001,15,17913,18169,6062,256,PERF
42255324670000,PI,IP,001,1,12368,16039,4574,3671,PERF
42255324680000,PI,IP,001,1,12621,16007,4405,3386,PERF
42255324690000,PI,IP,001,1,12370,12636,6636,266,PERF
42255324690000,PI,IP,001,2,12714,12986,6636,272,PERF
42255324690000,PI,IP,001,3,13064,13336,6636,272,PERF
42255324690000,PI,IP,001,4,13414,13684,6636,270,PERF
42255324690000,PI,IP,001,5,13762,14038,6636,276,PERF
42255324690000,PI,IP,001,6,14118,14384,6636,266,PERF
42255324690000,PI,IP,001,7,14467,14734,6636,267,PERF
42255324690000,PI,IP,001,8,14812,15084,6636,272,PERF
42255324690000,PI,IP,001,9,15162,15434,6636,272,PERF
42255324690000,PI,IP,001,10,15512,15784,6636,272,PERF
42255324690000,PI,IP,001,11,15868,16135,6636,267,PERF
42255324690000,PI,IP,001,12,16212,16484,6636,272,PERF
42255324690000,PI,IP,001,13,16562,16834,6636,272,PERF
42255324690000,PI,IP,001,14,16912,17184,6636,272,PERF
42255324690000,PI,IP,001,15,17262,17534,6636,272,PERF
42255324690000,PI,IP,001,16,17612,17884,6636,272,PERF
42255324690000,PI,IP,001,17,17962,18234,6636,272,PERF
42255324700000,PI,IP,001,1,11320,11545,6325,225,PERF
42255324700000,PI,IP,001,2,11620,11830,6325,210,PERF
42255324700000,PI,IP,001,3,11920,12135,6325,215,PERF
42255324700000,PI,IP,001,4,12224,12384,6325,160,PERF
42255324700000,PI,IP,001,5,12462,12620,6325,158,PERF
42255324700000,PI,IP,001,6,12700,12877,6325,177,PERF
42255324700000,PI,IP,001,7,12940,13114,6325,174,PERF
42255324700000,PI,IP,001,8,13189,13352,6325,163,PERF
42255324700000,PI,IP,001,9,13436,13612,6325,176,PERF
42255324700000,PI,IP,001,10,13674,13832,6325,158,PERF
42255324700000,PI,IP,001,11,13910,14089,6325,179,PERF
42255324700000,PI,IP,001,12,14159,14331,6325,172,PERF
42255324700000,PI,IP,001,13,14401,14574,6325,173,PERF
42255324700000,PI,IP,001,14,14640,14816,6325,176,PERF
42255324700000,PI,IP,001,15,14886,15058,6325,172,PERF
42255324700000,PI,IP,001,16,15122,15301,6325,179,PERF
42255324700000,PI,IP,001,17,15371,15534,6325,163,PERF
42255324700000,PI,IP,001,18,15607,15764,6325,157,PERF
42255324700000,PI,IP,001,19,15855,16063,6325,208,PERF
42255324700000,PI,IP,001,20,16098,16260,6325,162,PERF
42255324700000,PI,IP,001,21,16340,16505,6325,165,PERF
42255324700000,PI,IP,001,22,16582,16755,6325,173,PERF
42255324700000,PI,IP,001,23,16825,16997,6325,172,PERF
42255324710000,PI,IP,001,1,11594,16087,6145,4493,PERF
42255324720000,PI,IP,001,1,12021,12272,4115,251,PERF
42255324720000,PI,IP,001,2,12336,12588,4115,252,PERF
42255324720000,PI,IP,001,3,12730,12892,4115,162,PERF
42255324720000,PI,IP,001,4,12950,13192,4115,242,PERF
42255324720000,PI,IP,001,5,13250,13492,4115,242,PERF
42255324720000,PI,IP,001,6,13550,13793,4115,243,PERF
42255324720000,PI,IP,001,7,13850,14092,4115,242,PERF
42255324720000,PI,IP,001,8,14150,14392,4115,242,PERF
42255324720000,PI,IP,001,9,14450,14692,4115,242,PERF
42255324720000,PI,IP,001,10,14750,14992,4115,242,PERF
42255324720000,PI,IP,001,11,15050,15292,4115,242,PERF
42255324730000,PI,IP,001,1,12375,12532,4965,157,PERF
42255324730000,PI,IP,001,2,12607,12750,4965,143,PERF
42255324730000,PI,IP,001,3,12839,12997,4965,158,PERF
42255324730000,PI,IP,001,4,13072,13229,4965,157,PERF
42255324730000,PI,IP,001,5,13304,13461,4965,157,PERF
42255324730000,PI,IP,001,6,13563,13693,4965,130,PERF
42255324730000,PI,IP,001,7,13768,13925,4965,157,PERF
42255324730000,PI,IP,001,8,14000,14158,4965,158,PERF
42255324730000,PI,IP,001,9,14233,14390,4965,157,PERF
42255324730000,PI,IP,001,10,14465,14622,4965,157,PERF
42255324730000,PI,IP,001,11,14697,14860,4965,163,PERF
42255324730000,PI,IP,001,12,14929,15086,4965,157,PERF
42255324730000,PI,IP,001,13,15161,15319,4965,158,PERF
42255324730000,PI,IP,001,14,15394,15551,4965,157,PERF
42255324730000,PI,IP,001,15,15630,15770,4965,140,PERF
42255324730000,PI,IP,001,16,15864,16023,4965,159,PERF
42255324730000,PI,IP,001,17,16090,16247,4965,157,PERF
42255324730000,PI,IP,001,18,16322,16480,4965,158,PERF
42255324730000,PI,IP,001,19,16555,16712,4965,157,PERF
42255324730000,PI,IP,001,20,16787,16944,4965,157,PERF
42255324740000,PI,IP,001,1,11555,11715,6329,160,PERF
42255324740000,PI,IP,001,2,11803,11980,6329,177,PERF
42255324740000,PI,IP,001,3,12050,12205,6329,155,PERF
42255324740000,PI,IP,001,4,12298,12460,6329,162,PERF
42255324740000,PI,IP,001,5,12550,12712,6329,162,PERF
42255324740000,PI,IP,001,6,12793,12971,6329,178,PERF
42255324740000,PI,IP,001,7,13041,13214,6329,173,PERF
42255324740000,PI,IP,001,8,13288,13466,6329,178,PERF
42255324740000,PI,IP,001,9,13533,13703,6329,170,PERF
42255324740000,PI,IP,001,10,13783,13961,6329,178,PERF
42255324740000,PI,IP,001,11,14031,14202,6329,171,PERF
42255324740000,PI,IP,001,12,14279,14440,6329,161,PERF
42255324740000,PI,IP,001,13,14530,14700,6329,170,PERF
42255324740000,PI,IP,001,14,14774,14954,6329,180,PERF
42255324740000,PI,IP,001,15,15021,15192,6329,171,PERF
42255324740000,PI,IP,001,16,15269,15440,6329,171,PERF
42255324740000,PI,IP,001,17,15517,15696,6329,179,PERF
42255324740000,PI,IP,001,18,15764,15930,6329,166,PERF
42255324740000,PI,IP,001,19,16012,16189,6329,177,PERF
42255324740000,PI,IP,001,20,16259,16437,6329,178,PERF
42255324750000,PI,IP,001,1,10600,10782,7028,182,PERF
42255324750000,PI,IP,001,2,10857,11039,7028,182,PERF
42255324750000,PI,IP,001,3,11114,11297,7028,183,PERF
42255324750000,PI,IP,001,4,11372,11554,7028,182,PERF
42255324750000,PI,IP,001,5,11629,11811,7028,182,PERF
42255324750000,PI,IP,001,6,11886,12068,7028,182,PERF
42255324750000,PI,IP,001,7,12143,12325,7028,182,PERF
42255324750000,PI,IP,001,8,12400,12583,7028,183,PERF
42255324750000,PI,IP,001,9,12658,12840,7028,182,PERF
42255324750000,PI,IP,001,10,12915,13097,7028,182,PERF
42255324750000,PI,IP,001,11,13172,13354,7028,182,PERF
42255324750000,PI,IP,001,12,13429,13612,7028,183,PERF
42255324750000,PI,IP,001,13,13687,13869,7028,182,PERF
42255324750000,PI,IP,001,14,13944,14126,7028,182,PERF
42255324750000,PI,IP,001,15,14201,14383,7028,182,PERF
42255324750000,PI,IP,001,16,14458,14640,7028,182,PERF
42255324750000,PI,IP,001,17,14715,14898,7028,183,PERF
42255324750000,PI,IP,001,18,14973,15155,7028,182,PERF
42255324750000,PI,IP,001,19,15230,15412,7028,182,PERF
42255324750000,PI,IP,001,20,15487,15669,7028,182,PERF
42255324750000,PI,IP,001,21,15744,15926,7028,182,PERF
42255324750000,PI,IP,001,22,16001,16184,7028,183,PERF
42255324750000,PI,IP,001,23,16259,16441,7028,182,PERF
42255324750000,PI,IP,001,24,16516,16698,7028,182,PERF
42255324760000,PI,IP,001,1,10190,15791,6182,5601,PERF
42255324770000,PI,IP,001,1,10763,10918,5084,155,PERF
42255324770000,PI,IP,001,2,10993,11148,5084,155,PERF
42255324770000,PI,IP,001,3,11223,11378,5084,155,PERF
42255324770000,PI,IP,001,4,11453,11607,5084,154,PERF
42255324770000,PI,IP,001,5,11682,11837,5084,155,PERF
42255324770000,PI,IP,001,6,11912,12067,5084,155,PERF
42255324770000,PI,IP,001,7,12142,12297,5084,155,PERF
42255324770000,PI,IP,001,8,12372,12527,5084,155,PERF
42255324770000,PI,IP,001,9,12602,12757,5084,155,PERF
42255324770000,PI,IP,001,10,12832,12986,5084,154,PERF
42255324770000,PI,IP,001,11,13061,13216,5084,155,PERF
42255324770000,PI,IP,001,12,13291,13446,5084,155,PERF
42255324770000,PI,IP,001,13,13521,13676,5084,155,PERF
42255324770000,PI,IP,001,14,13751,13906,5084,155,PERF
42255324770000,PI,IP,001,15,13981,14136,5084,155,PERF
42255324770000,PI,IP,001,16,14211,14365,5084,154,PERF
42255324770000,PI,IP,001,17,14440,14595,5084,155,PERF
42255324770000,PI,IP,001,18,14670,14825,5084,155,PERF
42255324780000,PI,IP,001,1,10370,10561,6963,191,PERF
42255324780000,PI,IP,001,2,10636,10827,6963,191,PERF
42255324780000,PI,IP,001,3,10902,11092,6963,190,PERF
42255324780000,PI,IP,001,4,11167,11358,6963,191,PERF
42255324780000,PI,IP,001,5,11433,11624,6963,191,PERF
42255324780000,PI,IP,001,6,11699,11890,6963,191,PERF
42255324780000,PI,IP,001,7,11965,12155,6963,190,PERF
42255324780000,PI,IP,001,8,12230,12421,6963,191,PERF
42255324780000,PI,IP,001,9,12496,12687,6963,191,PERF
42255324780000,PI,IP,001,10,12762,12953,6963,191,PERF
42255324780000,PI,IP,001,11,13028,13218,6963,190,PERF
42255324780000,PI,IP,001,12,13293,13484,6963,191,PERF
42255324780000,PI,IP,001,13,13559,13750,6963,191,PERF
42255324780000,PI,IP,001,14,13825,14016,6963,191,PERF
42255324780000,PI,IP,001,15,14091,14281,6963,190,PERF
42255324780000,PI,IP,001,16,14356,14547,6963,191,PERF
42255324780000,PI,IP,001,17,14622,14813,6963,191,PERF
42255324780000,PI,IP,001,18,14888,15079,6963,191,PERF
42255324780000,PI,IP,001,19,15154,15344,6963,190,PERF
42255324780000,PI,IP,001,20,15419,15610,6963,191,PERF
42255324780000,PI,IP,001,21,15685,15876,6963,191,PERF
42255324780000,PI,IP,001,22,15951,16142,6963,191,PERF
42255324780000,PI,IP,001,23,16217,16407,6963,190,PERF
42255324780000,PI,IP,001,24,16482,16673,6963,191,PERF
42255324790000,PI,IP,001,1,11225,11412,5336,187,PERF
42255324790000,PI,IP,001,2,11495,11690,5336,195,PERF
42255324790000,PI,IP,001,3,11765,11939,5336,174,PERF
42255324790000,PI,IP,001,4,12019,12223,5336,204,PERF
42255324790000,PI,IP,001,5,12293,12478,5336,185,PERF
42255324790000,PI,IP,001,6,12557,12744,5336,187,PERF
42255324790000,PI,IP,001,7,13029,13210,5336,181,PERF
42255324790000,PI,IP,001,8,13287,13474,5336,187,PERF
42255324790000,PI,IP,001,9,13544,13728,5336,184,PERF
42255324790000,PI,IP,001,10,13802,13990,5336,188,PERF
42255324790000,PI,IP,001,11,14060,14247,5336,187,PERF
42255324790000,PI,IP,001,12,14317,14498,5336,181,PERF
42255324790000,PI,IP,001,13,14575,14763,5336,188,PERF
42255324790000,PI,IP,001,14,14833,15037,5336,204,PERF
42255324790000,PI,IP,001,15,15090,15278,5336,188,PERF
42255324800000,PI,IP,001,1,10640,16764,6901,6124,PERF
42255324810000,PI,IP,001,1,10237,16802,6900,6565,PERF
42255324820000,PI,IP,001,1,12534,17159,5472,4625,PERF
42255324830000,PI,IP,001,1,12567,17125,5402,4558,PERF
42255324840000,PI,IP,001,1,11592,11773,5666,181,PERF
42255324840000,PI,IP,001,2,11848,12024,5666,176,PERF
42255324840000,PI,IP,001,3,12094,12272,5666,178,PERF
42255324840000,PI,IP,001,4,12351,12527,5666,176,PERF
42255324840000,PI,IP,001,5,12602,12778,5666,176,PERF
42255324840000,PI,IP,001,6,12850,13029,5666,179,PERF
42255324840000,PI,IP,001,7,13104,13280,5666,176,PERF
42255324840000,PI,IP,001,8,13355,13530,5666,175,PERF
42255324840000,PI,IP,001,9,13607,13783,5666,176,PERF
42255324840000,PI,IP,001,10,13858,14024,5666,166,PERF
42255324840000,PI,IP,001,11,14109,14285,5666,176,PERF
42255324840000,PI,IP,001,12,14357,14536,5666,179,PERF
42255324840000,PI,IP,001,13,14611,14780,5666,169,PERF
42255324840000,PI,IP,001,14,14862,15039,5666,177,PERF
42255324840000,PI,IP,001,15,15114,15292,5666,178,PERF
42255324840000,PI,IP,001,16,15365,15541,5666,176,PERF
42255324840000,PI,IP,001,17,15620,15792,5666,172,PERF
42255324840000,PI,IP,001,18,15867,16043,5666,176,PERF
42255324840000,PI,IP,001,19,16125,16295,5666,170,PERF
42255324840000,PI,IP,001,20,16370,16546,5666,176,PERF
42255324840000,PI,IP,001,21,16621,16797,5666,176,PERF
42255324850000,PI,IP,001,1,11730,11923,5871,193,PERF
42255324850000,PI,IP,001,2,11993,12180,5871,187,PERF
42255324850000,PI,IP,001,3,12250,12437,5871,187,PERF
42255324850000,PI,IP,001,4,12507,12695,5871,188,PERF
42255324850000,PI,IP,001,5,12770,12945,5871,175,PERF
42255324850000,PI,IP,001,6,13022,13209,5871,187,PERF
42255324850000,PI,IP,001,7,13279,13466,5871,187,PERF
42255324850000,PI,IP,001,8,13536,13723,5871,187,PERF
42255324850000,PI,IP,001,9,13793,13980,5871,187,PERF
42255324850000,PI,IP,001,10,14050,14237,5871,187,PERF
42255324850000,PI,IP,001,11,14307,14498,5871,191,PERF
42255324850000,PI,IP,001,12,14565,14752,5871,187,PERF
42255324850000,PI,IP,001,13,14830,15009,5871,179,PERF
42255324850000,PI,IP,001,14,15075,15266,5871,191,PERF
42255324850000,PI,IP,001,15,15336,15523,5871,187,PERF
42255324850000,PI,IP,001,16,15593,15780,5871,187,PERF
42255324850000,PI,IP,001,17,15850,16037,5871,187,PERF
42255324850000,PI,IP,001,18,16107,16295,5871,188,PERF
42255324850000,PI,IP,001,19,16365,16552,5871,187,PERF
42255324850000,PI,IP,001,20,16622,16809,5871,187,PERF
42255324850000,PI,IP,001,21,16879,17066,5871,187,PERF
42255324860000,PI,IP,001,1,10625,14550,5058,3925,PERF
42255324910000,PI,IP,001,1,12470,12638,4767,168,PERF
42255324910000,PI,IP,001,2,12698,12850,4767,152,PERF
42255324910000,PI,IP,001,3,12946,13110,4767,164,PERF
42255324910000,PI,IP,001,4,13184,13348,4767,164,PERF
42255324910000,PI,IP,001,5,13422,13585,4767,163,PERF
42255324910000,PI,IP,001,6,13660,13808,4767,148,PERF
42255324910000,PI,IP,001,7,13906,14066,4767,160,PERF
42255324910000,PI,IP,001,8,14144,14304,4767,160,PERF
42255324910000,PI,IP,001,9,14380,14543,4767,163,PERF
42255324910000,PI,IP,001,10,14608,14761,4767,153,PERF
42255324910000,PI,IP,001,11,14851,15019,4767,168,PERF
42255324910000,PI,IP,001,12,15089,15257,4767,168,PERF
42255324910000,PI,IP,001,13,15327,15495,4767,168,PERF
42255324910000,PI,IP,001,14,15565,15733,4767,168,PERF
42255324910000,PI,IP,001,15,15803,15971,4767,168,PERF
42255324910000,PI,IP,001,16,16041,16209,4767,168,PERF
42255324910000,PI,IP,001,17,16279,16447,4767,168,PERF
42255324910000,PI,IP,001,18,16517,16685,4767,168,PERF
42255324920000,PI,IP,001,1,10904,14776,4372,3872,PERF
42255324930000,PI,IP,001,1,11040,15325,4744,4285,PERF
42255324940000,PI,IP,001,1,11202,15805,5160,4603,PERF
42255324950000,PI,IP,001,1,10518,15547,5368,5029,PERF
42255324960000,PI,IP,001,1,11415,16523,6251,5108,PERF
42255324980000,PI,IP,001,1,13076,13348,5692,272,PERF
42255324980000,PI,IP,001,2,13426,13694,5692,268,PERF
42255324980000,PI,IP,001,3,13776,14048,5692,272,PERF
42255324980000,PI,IP,001,4,14126,14394,5692,268,PERF
42255324980000,PI,IP,001,5,14476,14748,5692,272,PERF
42255324980000,PI,IP,001,6,14826,15098,5692,272,PERF
42255324980000,PI,IP,001,7,15176,15448,5692,272,PERF
42255324980000,PI,IP,001,8,15526,15798,5692,272,PERF
42255324980000,PI,IP,001,9,15878,16148,5692,270,PERF
42255324980000,PI,IP,001,10,16226,16498,5692,272,PERF
42255324980000,PI,IP,001,11,16576,16848,5692,272,PERF
42255324980000,PI,IP,001,12,16920,17198,5692,278,PERF
42255324980000,PI,IP,001,13,17276,17548,5692,272,PERF
42255324980000,PI,IP,001,14,17626,17863,5692,237,PERF
42255324990000,PI,IP,001,1,12315,12557,5003,242,PERF
42255324990000,PI,IP,001,2,12640,12882,5003,242,PERF
42255324990000,PI,IP,001,3,12965,13207,5003,242,PERF
42255324990000,PI,IP,001,4,13290,13532,5003,242,PERF
42255324990000,PI,IP,001,5,13615,13857,5003,242,PERF
42255324990000,PI,IP,001,6,13940,14182,5003,242,PERF
42255324990000,PI,IP,001,7,14265,14427,5003,162,PERF
42255324990000,PI,IP,001,8,14590,14832,5003,242,PERF
42255324990000,PI,IP,001,9,14915,15157,5003,242,PERF
42255324990000,PI,IP,001,10,15240,15482,5003,242,PERF
42255324990000,PI,IP,001,11,15565,15807,5003,242,PERF
42255324990000,PI,IP,001,12,15890,16132,5003,242,PERF
42255324990000,PI,IP,001,13,16215,16457,5003,242,PERF
42255324990000,PI,IP,001,14,16538,16808,5003,270,PERF
42255325000000,PI,IP,001,1,12896,18643,6287,5747,PERF
42255325010000,PI,IP,001,1,12792,12990,5673,198,PERF
42255325010000,PI,IP,001,2,13052,13232,5673,180,PERF
42255325010000,PI,IP,001,3,13423,13713,5673,290,PERF
42255325010000,PI,IP,001,4,13838,14054,5673,216,PERF
42255325010000,PI,IP,001,5,14110,14284,5673,174,PERF
42255325010000,PI,IP,001,6,14514,14740,5673,226,PERF
42255325010000,PI,IP,001,7,14825,15035,5673,210,PERF
42255325010000,PI,IP,001,8,15660,15916,5673,256,PERF
42255325010000,PI,IP,001,9,16033,16324,5673,291,PERF
42255325010000,PI,IP,001,10,16383,16818,5673,435,PERF
42255325010000,PI,IP,001,11,16858,17102,5673,244,PERF
42255325010000,PI,IP,001,12,17160,17372,5673,212,PERF
42255325010000,PI,IP,001,13,17489,17761,5673,272,PERF
42255325020000,PI,IP,001,1,11575,11760,6534,185,PERF
42255325020000,PI,IP,001,2,11835,12023,6534,188,PERF
42255325020000,PI,IP,001,3,12093,12281,6534,188,PERF
42255325020000,PI,IP,001,4,12351,12539,6534,188,PERF
42255325020000,PI,IP,001,5,12609,12797,6534,188,PERF
42255325020000,PI,IP,001,6,12867,13040,6534,173,PERF
42255325020000,PI,IP,001,7,13130,13295,6534,165,PERF
42255325020000,PI,IP,001,8,13388,13565,6534,177,PERF
42255325020000,PI,IP,001,9,13641,13829,6534,188,PERF
42255325020000,PI,IP,001,10,13908,14080,6534,172,PERF
42255325020000,PI,IP,001,11,14157,14335,6534,178,PERF
42255325020000,PI,IP,001,12,14416,14595,6534,179,PERF
42255325020000,PI,IP,001,13,14674,14862,6534,188,PERF
42255325020000,PI,IP,001,14,14932,15120,6534,188,PERF
42255325020000,PI,IP,001,15,15190,15378,6534,188,PERF
42255325020000,PI,IP,001,16,15448,15636,6534,188,PERF
42255325020000,PI,IP,001,17,15706,15870,6534,164,PERF
42255325020000,PI,IP,001,18,15964,16125,6534,161,PERF
42255325020000,PI,IP,001,19,16222,16410,6534,188,PERF
42255325020000,PI,IP,001,20,16480,16650,6534,170,PERF
42255325020000,PI,IP,001,21,16738,16926,6534,188,PERF
42255325020000,PI,IP,001,22,16996,17184,6534,188,PERF
42255325050000,PI,IP,001,1,11082,15630,5114,4548,PERF
42255325070000,PI,IP,001,1,12325,12542,4693,217,PERF
42255325070000,PI,IP,001,2,12605,12832,4693,227,PERF
42255325070000,PI,IP,001,3,12910,13137,4693,227,PERF
42255325070000,PI,IP,001,4,13215,13442,4693,227,PERF
42255325070000,PI,IP,001,5,13520,13747,4693,227,PERF
42255325070000,PI,IP,001,6,13825,14052,4693,227,PERF
42255325070000,PI,IP,001,7,14205,14357,4693,152,PERF
42255325070000,PI,IP,001,8,14435,14662,4693,227,PERF
42255325070000,PI,IP,001,9,14746,14960,4693,214,PERF
42255325070000,PI,IP,001,10,15045,15272,4693,227,PERF
42255325070000,PI,IP,001,11,15350,15577,4693,227,PERF
42255325070000,PI,IP,001,12,15655,15882,4693,227,PERF
42255325070000,PI,IP,001,13,15962,16187,4693,225,PERF
42255325070000,PI,IP,001,14,16268,16450,4693,182,PERF
42255325080000,PI,IP,001,1,10103,10103,6047,0,PERF
42255325080000,PI,IP,001,2,10170,10170,6047,0,PERF
42255325080000,PI,IP,001,3,10237,10237,6047,0,PERF
42255325080000,PI,IP,001,4,10304,10304,6047,0,PERF
42255325080000,PI,IP,001,5,10379,10379,6047,0,PERF
42255325080000,PI,IP,001,6,10446,10446,6047,0,PERF
42255325080000,PI,IP,001,7,10513,10513,6047,0,PERF
42255325080000,PI,IP,001,8,10580,10580,6047,0,PERF
42255325080000,PI,IP,001,9,10655,10655,6047,0,PERF
42255325080000,PI,IP,001,10,10722,10722,6047,0,PERF
42255325080000,PI,IP,001,11,10789,10789,6047,0,PERF
42255325080000,PI,IP,001,12,10856,10856,6047,0,PERF
42255325080000,PI,IP,001,13,10931,10931,6047,0,PERF
42255325080000,PI,IP,001,14,10998,10998,6047,0,PERF
42255325080000,PI,IP,001,15,11065,11065,6047,0,PERF
42255325080000,PI,IP,001,16,11132,11132,6047,0,PERF
42255325080000,PI,IP,001,17,11207,11207,6047,0,PERF
42255325080000,PI,IP,001,18,11274,11274,6047,0,PERF
42255325080000,PI,IP,001,19,11341,11341,6047,0,PERF
42255325080000,PI,IP,001,20,11408,11408,6047,0,PERF
42255325080000,PI,IP,001,21,11483,11483,6047,0,PERF
42255325080000,PI,IP,001,22,11550,11550,6047,0,PERF
42255325080000,PI,IP,001,23,11617,11617,6047,0,PERF
42255325080000,PI,IP,001,24,11684,11684,6047,0,PERF
42255325080000,PI,IP,001,25,11759,11759,6047,0,PERF
42255325080000,PI,IP,001,26,11826,11826,6047,0,PERF
42255325080000,PI,IP,001,27,11893,11893,6047,0,PERF
42255325080000,PI,IP,001,28,11960,11960,6047,0,PERF
42255325080000,PI,IP,001,29,13125,13125,6047,0,PERF
42255325080000,PI,IP,001,30,13200,13200,6047,0,PERF
42255325080000,PI,IP,001,31,13275,13275,6047,0,PERF
42255325080000,PI,IP,001,32,13350,13350,6047,0,PERF
42255325080000,PI,IP,001,33,13425,13425,6047,0,PERF
42255325080000,PI,IP,001,34,13500,13500,6047,0,PERF
42255325080000,PI,IP,001,35,13575,13575,6047,0,PERF
42255325080000,PI,IP,001,36,13650,13650,6047,0,PERF
42255325080000,PI,IP,001,37,13725,13725,6047,0,PERF
42255325080000,PI,IP,001,38,13800,13800,6047,0,PERF
42255325080000,PI,IP,001,39,13875,13875,6047,0,PERF
42255325080000,PI,IP,001,40,13950,13950,6047,0,PERF
42255325080000,PI,IP,001,41,14025,14025,6047,0,PERF
42255325080000,PI,IP,001,42,14100,14100,6047,0,PERF
42255325080000,PI,IP,001,43,14175,14175,6047,0,PERF
42255325080000,PI,IP,001,44,14250,14250,6047,0,PERF
42255325080000,PI,IP,001,45,14325,14325,6047,0,PERF
42255325080000,PI,IP,001,46,14400,14400,6047,0,PERF
42255325080000,PI,IP,001,47,14475,14475,6047,0,PERF
42255325080000,PI,IP,001,48,14550,14550,6047,0,PERF
42255325080000,PI,IP,001,49,14625,14625,6047,0,PERF
42255325080000,PI,IP,001,50,14700,14700,6047,0,PERF
42255325080000,PI,IP,001,51,14775,14775,6047,0,PERF
42255325080000,PI,IP,001,52,14850,14850,6047,0,PERF
42255325080000,PI,IP,001,53,14895,14895,6047,0,PERF
42255325080000,PI,IP,001,54,15000,15000,6047,0,PERF
42255325080000,PI,IP,001,55,15075,15075,6047,0,PERF
42255325080000,PI,IP,001,56,15150,15150,6047,0,PERF
42255325080000,PI,IP,001,57,15225,15225,6047,0,PERF
42255325080000,PI,IP,001,58,15300,15300,6047,0,PERF
42255325080000,PI,IP,001,59,15375,15375,6047,0,PERF
42255325080000,PI,IP,001,60,15450,15450,6047,0,PERF
42255325090000,PI,IP,001,1,13065,18854,6447,5789,PERF
42255325100000,PI,IP,001,1,11997,17479,5654,5482,PERF
42255325110000,PI,IP,001,1,12715,12892,4152,177,PERF
42255325110000,PI,IP,001,2,12962,13138,4152,176,PERF
42255325110000,PI,IP,001,3,13208,13385,4152,177,PERF
42255325110000,PI,IP,001,4,13455,13632,4152,177,PERF
42255325110000,PI,IP,001,5,13702,13878,4152,176,PERF
42255325110000,PI,IP,001,6,13948,14125,4152,177,PERF
42255325110000,PI,IP,001,7,14195,14372,4152,177,PERF
42255325110000,PI,IP,001,8,14442,14618,4152,176,PERF
42255325110000,PI,IP,001,9,14688,14865,4152,177,PERF
42255325110000,PI,IP,001,10,14935,15112,4152,177,PERF
42255325110000,PI,IP,001,11,15182,15358,4152,176,PERF
42255325110000,PI,IP,001,12,15428,15605,4152,177,PERF
42255325110000,PI,IP,001,13,15675,15852,4152,177,PERF
42255325110000,PI,IP,001,14,15922,16098,4152,176,PERF
42255325110000,PI,IP,001,15,16168,16345,4152,177,PERF
42255325120000,PI,IP,001,1,13050,13322,6057,272,PERF
42255325120000,PI,IP,001,2,13400,13672,6057,272,PERF
42255325120000,PI,IP,001,3,13745,14020,6057,275,PERF
42255325120000,PI,IP,001,4,14100,14372,6057,272,PERF
42255325120000,PI,IP,001,5,14450,14722,6057,272,PERF
42255325120000,PI,IP,001,6,14800,15072,6057,272,PERF
42255325120000,PI,IP,001,7,15150,15422,6057,272,PERF
42255325120000,PI,IP,001,8,15590,15772,6057,182,PERF
42255325120000,PI,IP,001,9,15850,16122,6057,272,PERF
42255325120000,PI,IP,001,10,16200,16472,6057,272,PERF
42255325120000,PI,IP,001,11,16550,16820,6057,270,PERF
42255325120000,PI,IP,001,12,16900,17172,6057,272,PERF
42255325120000,PI,IP,001,13,17250,17522,6057,272,PERF
42255325120000,PI,IP,001,14,17600,17910,6057,310,PERF
42255325120000,PI,IP,001,15,17920,18190,6057,270,PERF
42255325130000,PI,IP,001,1,12383,12569,5576,186,PERF
42255325130000,PI,IP,001,2,12644,12829,5576,185,PERF
42255325130000,PI,IP,001,3,12904,13085,5576,181,PERF
42255325130000,PI,IP,001,4,13165,13351,5576,186,PERF
42255325130000,PI,IP,001,5,13426,13600,5576,174,PERF
42255325130000,PI,IP,001,6,13686,13872,5576,186,PERF
42255325130000,PI,IP,001,7,13947,14133,5576,186,PERF
42255325130000,PI,IP,001,8,14208,14393,5576,185,PERF
42255325130000,PI,IP,001,9,14470,14660,5576,190,PERF
42255325130000,PI,IP,001,10,14729,14915,5576,186,PERF
42255325130000,PI,IP,001,11,14990,15178,5576,188,PERF
42255325130000,PI,IP,001,12,15250,15436,5576,186,PERF
42255325130000,PI,IP,001,13,15511,15696,5576,185,PERF
42255325130000,PI,IP,001,14,15771,15957,5576,186,PERF
42255325130000,PI,IP,001,15,16032,16218,5576,186,PERF
42255325130000,PI,IP,001,16,16293,16474,5576,181,PERF
42255325130000,PI,IP,001,17,16553,16739,5576,186,PERF
42255325130000,PI,IP,001,18,16814,17000,5576,186,PERF
42255325130000,PI,IP,001,19,17075,17260,5576,185,PERF
42255325130000,PI,IP,001,20,17335,17521,5576,186,PERF
42255325140000,PI,IP,001,1,12764,15645,3443,2881,PERF
42255325160000,PI,IP,001,1,12705,16704,4790,3999,PERF
42255325210000,PI,IP,001,1,12615,17057,5071,4442,PERF
42255325220000,PI,IP,001,1,11245,11424,5107,179,PERF
42255325220000,PI,IP,001,2,11500,11672,5107,172,PERF
42255325220000,PI,IP,001,3,11744,11928,5107,184,PERF
42255325220000,PI,IP,001,4,11993,12169,5107,176,PERF
42255325220000,PI,IP,001,5,12242,12422,5107,180,PERF
42255325220000,PI,IP,001,6,12492,12671,5107,179,PERF
42255325220000,PI,IP,001,7,12735,12920,5107,185,PERF
42255325220000,PI,IP,001,8,12990,13165,5107,175,PERF
42255325220000,PI,IP,001,9,13240,13419,5107,179,PERF
42255325220000,PI,IP,001,10,13489,13671,5107,182,PERF
42255325220000,PI,IP,001,11,13738,13918,5107,180,PERF
42255325220000,PI,IP,001,12,13998,14167,5107,169,PERF
42255325220000,PI,IP,001,13,14237,14420,5107,183,PERF
42255325220000,PI,IP,001,14,14486,14664,5107,178,PERF
42255325220000,PI,IP,001,15,14736,14910,5107,174,PERF
42255325220000,PI,IP,001,16,14985,15164,5107,179,PERF
42255325220000,PI,IP,001,17,15234,15414,5107,180,PERF
42255325220000,PI,IP,001,18,15482,15663,5107,181,PERF
42255325230000,PI,IP,001,1,11409,11580,5228,171,PERF
42255325230000,PI,IP,001,2,11665,11837,5228,172,PERF
42255325230000,PI,IP,001,3,11907,12090,5228,183,PERF
42255325230000,PI,IP,001,4,12145,12324,5228,179,PERF
42255325230000,PI,IP,001,5,12404,12583,5228,179,PERF
42255325230000,PI,IP,001,6,12653,12832,5228,179,PERF
42255325230000,PI,IP,001,7,12898,13081,5228,183,PERF
42255325230000,PI,IP,001,8,13151,13325,5228,174,PERF
42255325230000,PI,IP,001,9,13400,13579,5228,179,PERF
42255325230000,PI,IP,001,10,13649,13828,5228,179,PERF
42255325230000,PI,IP,001,11,13898,14077,5228,179,PERF
42255325230000,PI,IP,001,12,14147,14326,5228,179,PERF
42255325230000,PI,IP,001,13,14396,14570,5228,174,PERF
42255325230000,PI,IP,001,14,14645,14823,5228,178,PERF
42255325230000,PI,IP,001,15,14893,15077,5228,184,PERF
42255325230000,PI,IP,001,16,15142,15331,5228,189,PERF
42255325230000,PI,IP,001,17,15391,15570,5228,179,PERF
42255325230000,PI,IP,001,18,15638,15819,5228,181,PERF
42255325240000,PI,IP,001,1,12840,16199,3918,3359,PERF
42255325250000,PI,IP,001,1,10750,10910,5006,160,PERF
42255325250000,PI,IP,001,2,10976,11153,5006,177,PERF
42255325250000,PI,IP,001,3,11203,11370,5006,167,PERF
42255325250000,PI,IP,001,4,11430,11606,5006,176,PERF
42255325250000,PI,IP,001,5,11656,11830,5006,174,PERF
42255325250000,PI,IP,001,6,11890,12059,5006,169,PERF
42255325250000,PI,IP,001,7,12109,12280,5006,171,PERF
42255325250000,PI,IP,001,8,12336,12514,5006,178,PERF
42255325250000,PI,IP,001,9,12564,12730,5006,166,PERF
42255325250000,PI,IP,001,10,12794,12969,5006,175,PERF
42255325250000,PI,IP,001,11,13019,13180,5006,161,PERF
42255325250000,PI,IP,001,12,13246,13424,5006,178,PERF
42255325250000,PI,IP,001,13,13474,13654,5006,180,PERF
42255325250000,PI,IP,001,14,13701,13879,5006,178,PERF
42255325250000,PI,IP,001,15,13929,14106,5006,177,PERF
42255325250000,PI,IP,001,16,14156,14313,5006,157,PERF
42255325260000,PI,IP,001,1,12540,12710,5353,170,PERF
42255325260000,PI,IP,001,2,12791,12968,5353,177,PERF
42255325260000,PI,IP,001,3,13043,13219,5353,176,PERF
42255325260000,PI,IP,001,4,13294,13460,5353,166,PERF
42255325260000,PI,IP,001,5,13550,13722,5353,172,PERF
42255325260000,PI,IP,001,6,13797,13974,5353,177,PERF
42255325260000,PI,IP,001,7,14049,14220,5353,171,PERF
42255325260000,PI,IP,001,8,14300,14477,5353,177,PERF
42255325260000,PI,IP,001,9,14652,14728,5353,76,PERF
42255325260000,PI,IP,001,10,14803,14978,5353,175,PERF
42255325260000,PI,IP,001,11,15055,15231,5353,176,PERF
42255325260000,PI,IP,001,12,15306,15486,5353,180,PERF
42255325260000,PI,IP,001,13,15557,15734,5353,177,PERF
42255325260000,PI,IP,001,14,15820,15985,5353,165,PERF
42255325260000,PI,IP,001,15,16060,16230,5353,170,PERF
42255325260000,PI,IP,001,16,16312,16488,5353,176,PERF
42255325260000,PI,IP,001,17,16560,16719,5353,159,PERF
42255325260000,PI,IP,001,18,16815,16975,5353,160,PERF
42255325260000,PI,IP,001,19,17063,17227,5353,164,PERF
42255325260000,PI,IP,001,20,17318,17494,5353,176,PERF
42255325270000,PI,IP,001,1,10878,16448,6151,5570,PERF
42255325290000,PI,IP,001,1,13323,17973,5428,4650,PERF
42255325310000,PI,IP,001,1,12302,12570,6712,268,PERF
42255325310000,PI,IP,001,2,12658,12930,6712,272,PERF
42255325310000,PI,IP,001,3,13018,13290,6712,272,PERF
42255325310000,PI,IP,001,4,13378,13650,6712,272,PERF
42255325310000,PI,IP,001,5,13738,14010,6712,272,PERF
42255325310000,PI,IP,001,6,14098,14370,6712,272,PERF
42255325310000,PI,IP,001,7,14458,14730,6712,272,PERF
42255325310000,PI,IP,001,8,14818,15090,6712,272,PERF
42255325310000,PI,IP,001,9,15178,15450,6712,272,PERF
42255325310000,PI,IP,001,10,15538,15810,6712,272,PERF
42255325310000,PI,IP,001,11,15898,16170,6712,272,PERF
42255325310000,PI,IP,001,12,16258,16530,6712,272,PERF
42255325310000,PI,IP,001,13,16618,16890,6712,272,PERF
42255325310000,PI,IP,001,14,16978,17250,6712,272,PERF
42255325310000,PI,IP,001,15,17338,17610,6712,272,PERF
42255325310000,PI,IP,001,16,17888,17970,6712,82,PERF
42255325310000,PI,IP,001,17,18058,18330,6712,272,PERF
42255325310000,PI,IP,001,18,18415,18687,6712,272,PERF
42255325320000,PI,IP,001,1,13189,17741,6045,4552,PERF
42255325330000,PI,IP,001,1,13083,13355,6663,272,PERF
42255325330000,PI,IP,001,2,13431,13703,6663,272,PERF
42255325330000,PI,IP,001,3,13779,14051,6663,272,PERF
42255325330000,PI,IP,001,4,14127,14399,6663,272,PERF
42255325330000,PI,IP,001,5,14475,14747,6663,272,PERF
42255325330000,PI,IP,001,6,14823,15095,6663,272,PERF
42255325330000,PI,IP,001,7,15171,15443,6663,272,PERF
42255325330000,PI,IP,001,8,15519,15791,6663,272,PERF
42255325330000,PI,IP,001,9,15867,16139,6663,272,PERF
42255325330000,PI,IP,001,10,16215,16487,6663,272,PERF
42255325330000,PI,IP,001,11,16563,16835,6663,272,PERF
42255325330000,PI,IP,001,12,16911,17183,6663,272,PERF
42255325330000,PI,IP,001,13,17259,17531,6663,272,PERF
42255325330000,PI,IP,001,14,17607,17879,6663,272,PERF
42255325330000,PI,IP,001,15,17955,18227,6663,272,PERF
42255325330000,PI,IP,001,16,18301,18573,6663,272,PERF
42255325340000,PI,IP,001,1,13090,13358,,268,PERF
42255325340000,PI,IP,001,2,13428,13700,,272,PERF
42255325340000,PI,IP,001,3,13769,14040,,271,PERF
42255325340000,PI,IP,001,4,14108,14379,,271,PERF
42255325340000,PI,IP,001,5,14448,14719,,271,PERF
42255325340000,PI,IP,001,6,14788,15058,,270,PERF
42255325340000,PI,IP,001,7,15128,15396,,268,PERF
42255325340000,PI,IP,001,8,15468,15739,,271,PERF
42255325340000,PI,IP,001,9,15811,16080,,269,PERF
42255325340000,PI,IP,001,10,16148,16420,,272,PERF
42255325340000,PI,IP,001,11,16488,16759,,271,PERF
42255325340000,PI,IP,001,12,16828,17099,,271,PERF
42255325340000,PI,IP,001,13,17168,17440,,272,PERF
42255325340000,PI,IP,001,14,17508,17780,,272,PERF
42255325340000,PI,IP,001,15,17848,18120,,272,PERF
42255325340000,PI,IP,001,16,18188,18459,,271,PERF
42255325350000,PI,IP,001,1,13386,19980,,6594,PERF
42255325360000,PI,IP,001,1,12260,12533,5201,273,PERF
42255325360000,PI,IP,001,2,12611,12880,5201,269,PERF
42255325360000,PI,IP,001,3,12958,13222,5201,264,PERF
42255325360000,PI,IP,001,4,13305,13574,5201,269,PERF
42255325360000,PI,IP,001,5,13652,13921,5201,269,PERF
42255325360000,PI,IP,001,6,13999,14268,5201,269,PERF
42255325360000,PI,IP,001,7,14346,14615,5201,269,PERF
42255325360000,PI,IP,001,8,14693,14962,5201,269,PERF
42255325360000,PI,IP,001,9,15040,15309,5201,269,PERF
42255325360000,PI,IP,001,10,15387,15656,5201,269,PERF
42255325360000,PI,IP,001,11,15734,16002,5201,268,PERF
42255325360000,PI,IP,001,12,16081,16350,5201,269,PERF
42255325360000,PI,IP,001,13,16428,16697,5201,269,PERF
42255325370000,PI,IP,001,1,10350,16506,6750,6156,PERF
42255325380000,PI,IP,001,1,10216,16559,6693,6343,PERF
42255325390000,PI,IP,001,1,10197,14544,4755,4347,PERF
42255325400000,PI,IP,001,1,13442,18611,6194,5169,PERF
42255325420000,PI,IP,001,1,12775,13047,7662,272,PERF
42255325420000,PI,IP,001,2,13130,13402,7662,272,PERF
42255325420000,PI,IP,001,3,13485,13757,7662,272,PERF
42255325420000,PI,IP,001,4,13840,14112,7662,272,PERF
42255325420000,PI,IP,001,5,14200,14467,7662,267,PERF
42255325420000,PI,IP,001,6,14550,14822,7662,272,PERF
42255325420000,PI,IP,001,7,14905,15177,7662,272,PERF
42255325420000,PI,IP,001,8,15260,15532,7662,272,PERF
42255325420000,PI,IP,001,9,15615,15887,7662,272,PERF
42255325420000,PI,IP,001,10,15970,16242,7662,272,PERF
42255325420000,PI,IP,001,11,16325,16597,7662,272,PERF
42255325420000,PI,IP,001,12,16680,16952,7662,272,PERF
42255325420000,PI,IP,001,13,17035,17352,7662,317,PERF
42255325420000,PI,IP,001,14,17480,17662,7662,182,PERF
42255325420000,PI,IP,001,15,17740,18012,7662,272,PERF
42255325420000,PI,IP,001,16,18090,18362,7662,272,PERF
42255325420000,PI,IP,001,17,18440,18712,7662,272,PERF
42255325420000,PI,IP,001,18,18790,19060,7662,270,PERF
42255325420000,PI,IP,001,19,19186,19420,7662,234,PERF
42255325430000,PI,IP,001,1,12325,12591,5502,266,PERF
42255325430000,PI,IP,001,2,12669,12938,5502,269,PERF
42255325430000,PI,IP,001,3,13016,13285,5502,269,PERF
42255325430000,PI,IP,001,4,13363,13632,5502,269,PERF
42255325430000,PI,IP,001,5,13710,13979,5502,269,PERF
42255325430000,PI,IP,001,6,14057,14329,5502,272,PERF
42255325430000,PI,IP,001,7,14407,14679,5502,272,PERF
42255325430000,PI,IP,001,8,14757,15029,5502,272,PERF
42255325430000,PI,IP,001,9,15107,15379,5502,272,PERF
42255325430000,PI,IP,001,10,15457,15729,5502,272,PERF
42255325430000,PI,IP,001,11,15807,16079,5502,272,PERF
42255325430000,PI,IP,001,12,16157,16429,5502,272,PERF
42255325430000,PI,IP,001,13,16507,16779,5502,272,PERF
42255325430000,PI,IP,001,14,16857,17129,5502,272,PERF
42255325440000,PI,IP,001,1,10170,16237,6618,6067,PERF
42255325450000,PI,IP,001,1,10086,16424,6831,6338,PERF
42255325470000,PI,IP,001,1,13145,18732,6494,5587,PERF
42255325480000,PI,IP,001,1,10191,14186,4679,3995,PERF
42255325490000,PI,IP,001,1,10206,14550,5040,4344,PERF
42255325500000,PI,IP,001,1,12476,18532,6962,6056,PERF
42255325510000,PI,IP,001,1,12625,12842,4701,217,PERF
42255325510000,PI,IP,001,2,12910,13152,4701,242,PERF
42255325510000,PI,IP,001,3,13220,13462,4701,242,PERF
42255325510000,PI,IP,001,4,13535,13777,4701,242,PERF
42255325510000,PI,IP,001,5,13850,14092,4701,242,PERF
42255325510000,PI,IP,001,6,14165,14407,4701,242,PERF
42255325510000,PI,IP,001,7,14480,14722,4701,242,PERF
42255325510000,PI,IP,001,8,14795,15037,4701,242,PERF
42255325510000,PI,IP,001,9,15110,15352,4701,242,PERF
42255325510000,PI,IP,001,10,15425,15667,4701,242,PERF
42255325510000,PI,IP,001,11,15740,15982,4701,242,PERF
42255325510000,PI,IP,001,12,16055,16297,4701,242,PERF
42255325510000,PI,IP,001,13,16463,16645,4701,182,PERF
42255325530000,PI,IP,001,1,12456,18506,6972,6050,PERF
42255325540000,PI,IP,001,1,12282,17227,6430,4945,PERF
42255325550000,PI,IP,001,1,13501,18822,5577,5321,PERF
42255325560000,PI,IP,001,1,13314,18985,5922,5671,PERF
42255325570000,PI,IP,001,1,12050,17731,6301,5681,PERF
42255325580000,PI,IP,001,1,12100,17763,6303,5663,PERF
42255325590000,PI,IP,001,1,13088,17009,,3921,PERF
42255325620000,PI,IP,001,1,13507,19668,,6161,PERF
42255325630000,PI,IP,001,1,13598,19759,6338,6161,PERF
42255325650000,PI,IP,001,1,11594,16614,5593,5020,PERF
42255325660000,PI,IP,001,1,10344,15197,5706,4853,PERF
42255325670000,PI,IP,001,1,10346,15349,5612,5003,PERF
42255325680000,PI,IP,001,1,10408,10587,5823,179,PERF
42255325680000,PI,IP,001,2,10667,10840,5823,173,PERF
42255325680000,PI,IP,001,3,10915,11094,5823,179,PERF
42255325680000,PI,IP,001,4,11169,11348,5823,179,PERF
42255325680000,PI,IP,001,5,11423,11596,5823,173,PERF
42255325680000,PI,IP,001,6,11677,11832,5823,155,PERF
42255325680000,PI,IP,001,7,11930,12108,5823,178,PERF
42255325680000,PI,IP,001,8,12183,12362,5823,179,PERF
42255325680000,PI,IP,001,9,12437,12615,5823,178,PERF
42255325680000,PI,IP,001,10,12690,12869,5823,179,PERF
42255325680000,PI,IP,001,11,12950,13124,5823,174,PERF
42255325680000,PI,IP,001,12,13199,13460,5823,261,PERF
42255325680000,PI,IP,001,13,13460,13620,5823,160,PERF
42255325680000,PI,IP,001,14,13706,13885,5823,179,PERF
42255325680000,PI,IP,001,15,13960,14138,5823,178,PERF
42255325680000,PI,IP,001,16,14213,14417,5823,204,PERF
42255325680000,PI,IP,001,17,14467,14647,5823,180,PERF
42255325680000,PI,IP,001,18,14720,14901,5823,181,PERF
42255325680000,PI,IP,001,19,14974,15152,5823,178,PERF
42255325680000,PI,IP,001,20,15227,15406,5823,179,PERF
42255325710000,PI,IP,001,1,12834,13078,7065,244,PERF
42255325710000,PI,IP,001,2,13148,13398,7065,250,PERF
42255325710000,PI,IP,001,3,13470,13742,7065,272,PERF
42255325710000,PI,IP,001,4,13820,14092,7065,272,PERF
42255325710000,PI,IP,001,5,14170,14441,7065,271,PERF
42255325710000,PI,IP,001,6,14520,14791,7065,271,PERF
42255325710000,PI,IP,001,7,14870,15141,7065,271,PERF
42255325710000,PI,IP,001,8,15220,15492,7065,272,PERF
42255325710000,PI,IP,001,9,15566,15841,7065,275,PERF
42255325710000,PI,IP,001,10,15920,16192,7065,272,PERF
42255325710000,PI,IP,001,11,16270,16542,7065,272,PERF
42255325710000,PI,IP,001,12,16620,16892,7065,272,PERF
42255325710000,PI,IP,001,13,16970,17240,7065,270,PERF
42255325710000,PI,IP,001,14,17320,17592,7065,272,PERF
42255325710000,PI,IP,001,15,17670,17942,7065,272,PERF
42255325710000,PI,IP,001,16,18020,18292,7065,272,PERF
42255325710000,PI,IP,001,17,18370,18642,7065,272,PERF
42255325710000,PI,IP,001,18,18720,18992,7065,272,PERF
42255325730000,PI,IP,001,1,9976,10164,5747,188,PERF
42255325730000,PI,IP,001,2,10239,10431,5747,192,PERF
42255325730000,PI,IP,001,3,10506,10697,5747,191,PERF
42255325730000,PI,IP,001,4,10772,10964,5747,192,PERF
42255325730000,PI,IP,001,5,11039,11223,5747,184,PERF
42255325730000,PI,IP,001,6,11306,11490,5747,184,PERF
42255325730000,PI,IP,001,7,11572,11754,5747,182,PERF
42255325730000,PI,IP,001,8,11842,12031,5747,189,PERF
42255325730000,PI,IP,001,9,12100,12297,5747,197,PERF
42255325730000,PI,IP,001,10,12372,12564,5747,192,PERF
42255325730000,PI,IP,001,11,12650,12819,5747,169,PERF
42255325730000,PI,IP,001,12,12894,13086,5747,192,PERF
42255325730000,PI,IP,001,13,13161,13377,5747,216,PERF
42255325730000,PI,IP,001,14,13427,13616,5747,189,PERF
42255325730000,PI,IP,001,15,13694,13879,5747,185,PERF
42255325730000,PI,IP,001,16,13961,14152,5747,191,PERF
42255325730000,PI,IP,001,17,14227,14416,5747,189,PERF
42255325730000,PI,IP,001,18,14494,14686,5747,192,PERF
42255325730000,PI,IP,001,19,14761,14952,5747,191,PERF
42255325730000,PI,IP,001,20,15027,15219,5747,192,PERF
42255325740000,PI,IP,001,1,12855,17346,5113,4491,PERF
42255325750000,PI,IP,001,1,12808,17530,5120,4722,PERF
42255325760000,PI,IP,001,1,12910,16921,4553,4011,PERF
42255325770000,PI,IP,001,1,11005,11197,6733,192,PERF
42255325770000,PI,IP,001,2,11267,11458,6733,191,PERF
42255325770000,PI,IP,001,3,11528,11720,6733,192,PERF
42255325770000,PI,IP,001,4,11790,11981,6733,191,PERF
42255325770000,PI,IP,001,5,12051,12243,6733,192,PERF
42255325770000,PI,IP,001,6,12313,12498,6733,185,PERF
42255325770000,PI,IP,001,7,12574,12754,6733,180,PERF
42255325770000,PI,IP,001,8,12836,13020,6733,184,PERF
42255325770000,PI,IP,001,9,13097,13284,6733,187,PERF
42255325770000,PI,IP,001,10,13359,13550,6733,191,PERF
42255325770000,PI,IP,001,11,13626,13812,6733,186,PERF
42255325770000,PI,IP,001,12,13887,14062,6733,175,PERF
42255325770000,PI,IP,001,13,14143,14335,6733,192,PERF
42255325770000,PI,IP,001,14,14405,14596,6733,191,PERF
42255325770000,PI,IP,001,15,14674,14858,6733,184,PERF
42255325770000,PI,IP,001,16,14928,15119,6733,191,PERF
42255325770000,PI,IP,001,17,15189,15381,6733,192,PERF
42255325770000,PI,IP,001,18,15451,15642,6733,191,PERF
42255325770000,PI,IP,001,19,15712,15906,6733,194,PERF
42255325770000,PI,IP,001,20,15974,16165,6733,191,PERF
42255325770000,PI,IP,001,21,16235,16427,6733,192,PERF
42255325770000,PI,IP,001,22,16497,16685,6733,188,PERF
42255325770000,PI,IP,001,23,16758,16950,6733,192,PERF
42255325770000,PI,IP,001,24,17020,17193,6733,173,PERF
42255325780000,PI,IP,001,1,11378,15172,4667,3794,PERF
42255325790000,PI,IP,001,1,12789,13046,6162,257,PERF
42255325790000,PI,IP,001,2,13124,13387,6162,263,PERF
42255325790000,PI,IP,001,3,13465,13728,6162,263,PERF
42255325790000,PI,IP,001,4,13806,14069,6162,263,PERF
42255325790000,PI,IP,001,5,14147,14410,6162,263,PERF
42255325790000,PI,IP,001,6,14488,14751,6162,263,PERF
42255325790000,PI,IP,001,7,14829,15092,6162,263,PERF
42255325790000,PI,IP,001,8,15170,15433,6162,263,PERF
42255325790000,PI,IP,001,9,15511,15768,6162,257,PERF
42255325790000,PI,IP,001,10,15852,16115,6162,263,PERF
42255325790000,PI,IP,001,11,16193,16456,6162,263,PERF
42255325790000,PI,IP,001,12,16534,16797,6162,263,PERF
42255325790000,PI,IP,001,13,16875,17138,6162,263,PERF
42255325790000,PI,IP,001,14,17216,17479,6162,263,PERF
42255325790000,PI,IP,001,15,17557,17820,6162,263,PERF
42255325790000,PI,IP,001,16,17898,18170,6162,272,PERF
42255325800000,PI,IP,001,1,12943,18222,6419,5279,PERF
42255325810000,PI,IP,001,1,11438,16619,,5181,PERF
42255325820000,PI,IP,001,1,11480,19117,8076,7637,PERF
42255325830000,PI,IP,001,1,10816,16210,5640,5394,PERF
42255325840000,PI,IP,001,1,10872,15735,5588,4863,PERF
42255325850000,PI,IP,001,1,10092,10284,4770,192,PERF
42255325850000,PI,IP,001,2,11247,11432,4770,185,PERF
42255325850000,PI,IP,001,3,11486,11686,4770,200,PERF
42255325850000,PI,IP,001,4,11731,11924,4770,193,PERF
42255325850000,PI,IP,001,5,11974,12166,4770,192,PERF
42255325850000,PI,IP,001,6,12220,12400,4770,180,PERF
42255325850000,PI,IP,001,7,12458,12650,4770,192,PERF
42255325850000,PI,IP,001,8,12700,12892,4770,192,PERF
42255325850000,PI,IP,001,9,12942,13140,4770,198,PERF
42255325850000,PI,IP,001,10,13184,13366,4770,182,PERF
42255325850000,PI,IP,001,11,13426,13618,4770,192,PERF
42255325850000,PI,IP,001,12,13668,13842,4770,174,PERF
42255325850000,PI,IP,001,13,13911,14100,4770,189,PERF
42255325850000,PI,IP,001,14,14160,14340,4770,180,PERF
42255325850000,PI,IP,001,15,14395,14587,4770,192,PERF
42255325850000,PI,IP,001,16,14636,14829,4770,193,PERF
42255325870000,PI,IP,001,1,10095,10284,4608,189,PERF
42255325870000,PI,IP,001,2,11190,11379,4608,189,PERF
42255325870000,PI,IP,001,3,11429,11622,4608,193,PERF
42255325870000,PI,IP,001,4,11675,11860,4608,185,PERF
42255325870000,PI,IP,001,5,11907,12080,4608,173,PERF
42255325870000,PI,IP,001,6,12145,12324,4608,179,PERF
42255325870000,PI,IP,001,7,12384,12573,4608,189,PERF
42255325870000,PI,IP,001,8,12623,12790,4608,167,PERF
42255325870000,PI,IP,001,9,12862,13050,4608,188,PERF
42255325870000,PI,IP,001,10,13106,13281,4608,175,PERF
42255325870000,PI,IP,001,11,13340,13530,4608,190,PERF
42255325870000,PI,IP,001,12,13579,13768,4608,189,PERF
42255325870000,PI,IP,001,13,13814,14006,4608,192,PERF
42255325870000,PI,IP,001,14,14060,14240,4608,180,PERF
42255325870000,PI,IP,001,15,14295,14484,4608,189,PERF
42255325870000,PI,IP,001,16,14534,14721,4608,187,PERF
42255325880000,PI,IP,001,1,11270,15343,4769,4073,PERF
42255325890000,PI,IP,001,1,10953,15243,4739,4290,PERF
42255325900000,PI,IP,001,1,10989,16032,5528,5043,PERF
42255325910000,PI,IP,001,1,13252,13524,6196,272,PERF
42255325910000,PI,IP,001,2,13602,13874,6196,272,PERF
42255325910000,PI,IP,001,3,13952,14224,6196,272,PERF
42255325910000,PI,IP,001,4,14302,14574,6196,272,PERF
42255325910000,PI,IP,001,5,14652,14924,6196,272,PERF
42255325910000,PI,IP,001,6,15002,15271,6196,269,PERF
42255325910000,PI,IP,001,7,15349,15618,6196,269,PERF
42255325910000,PI,IP,001,8,15696,15965,6196,269,PERF
42255325910000,PI,IP,001,9,16043,16312,6196,269,PERF
42255325910000,PI,IP,001,10,16390,16659,6196,269,PERF
42255325910000,PI,IP,001,11,16737,17006,6196,269,PERF
42255325910000,PI,IP,001,12,17084,17353,6196,269,PERF
42255325910000,PI,IP,001,13,17431,17700,6196,269,PERF
42255325910000,PI,IP,001,14,17778,18047,6196,269,PERF
42255325910000,PI,IP,001,15,18125,18397,6196,272,PERF
42255325920000,PI,IP,001,1,13451,18632,5439,5181,PERF
42255325930000,PI,IP,001,1,13608,19349,5731,5741,PERF
42255325940000,PI,IP,001,1,13538,18789,5571,5251,PERF
42255325950000,PI,IP,001,1,10286,15632,5981,5346,PERF
42255325970000,PI,IP,001,1,10350,15802,5993,5452,PERF
42255325980000,PI,IP,001,1,11693,11832,,139,PERF
42255325980000,PI,IP,001,2,11955,12225,,270,PERF
42255325980000,PI,IP,001,3,12303,12574,,271,PERF
42255325980000,PI,IP,001,4,12651,12921,,270,PERF
42255325980000,PI,IP,001,5,12999,13199,,200,PERF
42255325980000,PI,IP,001,6,13277,13477,,200,PERF
42255325980000,PI,IP,001,7,13555,13755,,200,PERF
42255325980000,PI,IP,001,8,13833,14032,,199,PERF
42255325980000,PI,IP,001,9,14111,14311,,200,PERF
42255325980000,PI,IP,001,10,14389,14589,,200,PERF
42255325980000,PI,IP,001,11,14667,14867,,200,PERF
42255325980000,PI,IP,001,12,14945,15145,,200,PERF
42255325980000,PI,IP,001,13,15223,15423,,200,PERF
42255325980000,PI,IP,001,14,15501,15701,,200,PERF
42255325980000,PI,IP,001,15,15779,15999,,220,PERF
42255325980000,PI,IP,001,16,16055,16255,,200,PERF
42255325990000,PI,IP,001,1,13322,18602,5764,5280,PERF
42255326000000,PI,IP,001,1,11510,11677,5664,167,PERF
42255326000000,PI,IP,001,2,11850,12107,5664,257,PERF
42255326000000,PI,IP,001,3,12185,12457,5664,272,PERF
42255326000000,PI,IP,001,4,12535,12807,5664,272,PERF
42255326000000,PI,IP,001,5,12885,13157,5664,272,PERF
42255326000000,PI,IP,001,6,13235,13507,5664,272,PERF
42255326000000,PI,IP,001,7,13585,13857,5664,272,PERF
42255326000000,PI,IP,001,8,13935,14207,5664,272,PERF
42255326000000,PI,IP,001,9,14285,14557,5664,272,PERF
42255326000000,PI,IP,001,10,14635,14907,5664,272,PERF
42255326000000,PI,IP,001,11,14985,15257,5664,272,PERF
42255326000000,PI,IP,001,12,15340,15607,5664,267,PERF
42255326000000,PI,IP,001,13,15687,15957,5664,270,PERF
42255326000000,PI,IP,001,14,16035,16307,5664,272,PERF
42255326000000,PI,IP,001,15,16385,16657,5664,272,PERF
42255326000000,PI,IP,001,16,16737,17007,5664,270,PERF
42255326000000,PI,IP,001,17,17085,17269,5664,184,PERF
42255326010000,PI,IP,001,1,13149,18050,4965,4901,PERF
42255326020000,PI,IP,001,1,13221,17772,4777,4551,PERF
42255326050000,PI,IP,001,1,10456,16773,6686,6317,PERF
42255326060000,PI,IP,001,1,10242,16772,6904,6530,PERF
42255326070000,PI,IP,001,1,11920,12089,4382,169,PERF
42255326070000,PI,IP,001,2,12168,12345,4382,177,PERF
42255326070000,PI,IP,001,3,12415,12583,4382,168,PERF
42255326070000,PI,IP,001,4,12658,12840,4382,182,PERF
42255326070000,PI,IP,001,5,12910,13080,4382,170,PERF
42255326070000,PI,IP,001,6,13156,13335,4382,179,PERF
42255326070000,PI,IP,001,7,13405,13580,4382,175,PERF
42255326070000,PI,IP,001,8,13653,13810,4382,157,PERF
42255326070000,PI,IP,001,9,13900,14070,4382,170,PERF
42255326070000,PI,IP,001,10,14148,14325,4382,177,PERF
42255326070000,PI,IP,001,11,14395,14563,4382,168,PERF
42255326070000,PI,IP,001,12,14643,14822,4382,179,PERF
42255326070000,PI,IP,001,13,14890,15068,4382,178,PERF
42255326070000,PI,IP,001,14,15138,15315,4382,177,PERF
42255326070000,PI,IP,001,15,15385,15553,4382,168,PERF
42255326080000,PI,IP,001,1,11684,16512,5964,4828,PERF
42255326090000,PI,IP,001,1,11892,12065,4301,173,PERF
42255326090000,PI,IP,001,2,12135,12304,4301,169,PERF
42255326090000,PI,IP,001,3,12378,12554,4301,176,PERF
42255326090000,PI,IP,001,4,12621,12794,4301,173,PERF
42255326090000,PI,IP,001,5,12864,13037,4301,173,PERF
42255326090000,PI,IP,001,6,13107,13276,4301,169,PERF
42255326090000,PI,IP,001,7,13350,13523,4301,173,PERF
42255326090000,PI,IP,001,8,13593,13766,4301,173,PERF
42255326090000,PI,IP,001,9,13836,14010,4301,174,PERF
42255326090000,PI,IP,001,10,14080,14248,4301,168,PERF
42255326090000,PI,IP,001,11,14323,14500,4301,177,PERF
42255326090000,PI,IP,001,12,14566,14739,4301,173,PERF
42255326090000,PI,IP,001,13,14809,14982,4301,173,PERF
42255326090000,PI,IP,001,14,15052,15220,4301,168,PERF
42255326090000,PI,IP,001,15,15295,15469,4301,174,PERF
42255326090000,PI,IP,001,16,15540,15711,4301,171,PERF
42255326090000,PI,IP,001,17,15781,15954,4301,173,PERF
42255326100000,PI,IP,001,1,11940,12112,4646,172,PERF
42255326100000,PI,IP,001,2,12182,12340,4646,158,PERF
42255326100000,PI,IP,001,3,12434,12605,4646,171,PERF
42255326100000,PI,IP,001,4,12681,12858,4646,177,PERF
42255326100000,PI,IP,001,5,12928,13090,4646,162,PERF
42255326100000,PI,IP,001,6,13175,13352,4646,177,PERF
42255326100000,PI,IP,001,7,13422,13599,4646,177,PERF
42255326100000,PI,IP,001,8,13675,13846,4646,171,PERF
42255326100000,PI,IP,001,9,13916,14100,4646,184,PERF
42255326100000,PI,IP,001,10,14168,14341,4646,173,PERF
42255326100000,PI,IP,001,11,14411,14590,4646,179,PERF
42255326100000,PI,IP,001,12,14658,14835,4646,177,PERF
42255326100000,PI,IP,001,13,14905,15082,4646,177,PERF
42255326100000,PI,IP,001,14,15152,15326,4646,174,PERF
42255326100000,PI,IP,001,15,15399,15579,4646,180,PERF
42255326100000,PI,IP,001,16,15646,15823,4646,177,PERF
42255326100000,PI,IP,001,17,15891,16070,4646,179,PERF
42255326110000,PI,IP,001,1,10996,16996,6717,6000,PERF
42255326120000,PI,IP,001,1,10331,15728,5889,5397,PERF
42255326130100,PI,IP,001,1,12178,16660,5284,4482,PERF
42255326140000,PI,IP,001,1,11500,11812,,312,PERF
42255326140000,PI,IP,001,2,11985,12167,,182,PERF
42255326140000,PI,IP,001,3,12250,12522,,272,PERF
42255326140000,PI,IP,001,4,12605,12877,,272,PERF
42255326140000,PI,IP,001,5,12960,13232,,272,PERF
42255326140000,PI,IP,001,6,13315,13587,,272,PERF
42255326140000,PI,IP,001,7,13670,13852,,182,PERF
42255326140000,PI,IP,001,8,14025,14207,,182,PERF
42255326140000,PI,IP,001,9,14380,14652,,272,PERF
42255326140000,PI,IP,001,10,14735,15010,,275,PERF
42255326140000,PI,IP,001,11,15090,15362,,272,PERF
42255326140000,PI,IP,001,12,15445,15717,,272,PERF
42255326140000,PI,IP,001,13,15800,16069,,269,PERF
42255326140000,PI,IP,001,14,16155,16427,,272,PERF
42255326140000,PI,IP,001,15,16510,16782,,272,PERF
42255326140000,PI,IP,001,16,16865,17137,,272,PERF
42255326140000,PI,IP,001,17,17220,17492,,272,PERF
42255326140000,PI,IP,001,18,17575,17847,,272,PERF
42255326140000,PI,IP,001,19,17928,18032,,104,PERF
42255326150000,PI,IP,001,1,11736,11917,4508,181,PERF
42255326150000,PI,IP,001,2,11984,12168,4508,184,PERF
42255326150000,PI,IP,001,3,12238,12419,4508,181,PERF
42255326150000,PI,IP,001,4,12485,12669,4508,184,PERF
42255326150000,PI,IP,001,5,12740,12921,4508,181,PERF
42255326150000,PI,IP,001,6,12991,13176,4508,185,PERF
42255326150000,PI,IP,001,7,13242,13423,4508,181,PERF
42255326150000,PI,IP,001,8,13493,13679,4508,186,PERF
42255326150000,PI,IP,001,9,13744,13926,4508,182,PERF
42255326150000,PI,IP,001,10,13996,14177,4508,181,PERF
42255326150000,PI,IP,001,11,14247,14434,4508,187,PERF
42255326150000,PI,IP,001,12,14498,14676,4508,178,PERF
42255326150000,PI,IP,001,13,14749,14930,4508,181,PERF
42255326150000,PI,IP,001,14,15004,15181,4508,177,PERF
42255326150000,PI,IP,001,15,15251,15432,4508,181,PERF
42255326150000,PI,IP,001,16,15502,15683,4508,181,PERF
42255326150000,PI,IP,001,17,15753,15934,4508,181,PERF
42255326170000,PI,IP,001,1,12455,16410,5326,3955,PERF
42255326200000,PI,IP,001,1,13097,13330,4468,233,PERF
42255326200000,PI,IP,001,2,13408,13679,4468,271,PERF
42255326200000,PI,IP,001,3,13719,13952,4468,233,PERF
42255326200000,PI,IP,001,4,14030,14263,4468,233,PERF
42255326200000,PI,IP,001,5,14341,14572,4468,231,PERF
42255326200000,PI,IP,001,6,14652,14885,4468,233,PERF
42255326200000,PI,IP,001,7,14963,15194,4468,231,PERF
42255326200000,PI,IP,001,8,15274,15507,4468,233,PERF
42255326200000,PI,IP,001,9,15585,15818,4468,233,PERF
42255326200000,PI,IP,001,10,15896,16127,4468,231,PERF
42255326200000,PI,IP,001,11,16205,16477,4468,272,PERF
42255326210000,PI,IP,001,1,13527,19488,6553,5961,PERF
42255326220000,PI,IP,001,1,11373,17193,6427,5820,PERF
42255326230000,PI,IP,001,1,11440,17088,6463,5648,PERF
42255326240000,PI,IP,001,1,13672,19393,6719,5721,PERF
42255326250000,PI,IP,001,1,10230,16827,6871,6597,PERF
42255326260000,PI,IP,001,1,12625,17082,4980,4457,PERF
42255326320000,PI,IP,001,1,13736,20057,6914,6321,PERF
42255326340000,PI,IP,001,1,11592,16457,,4865,PERF
42255326350000,PI,IP,001,1,11400,11511,,111,PERF
42255326350000,PI,IP,001,2,11658,11912,,254,PERF
42255326350000,PI,IP,001,3,11990,12262,,272,PERF
42255326350000,PI,IP,001,4,12340,12612,,272,PERF
42255326350000,PI,IP,001,5,12668,12962,,294,PERF
42255326350000,PI,IP,001,6,13040,13312,,272,PERF
42255326350000,PI,IP,001,7,13390,13664,,274,PERF
42255326350000,PI,IP,001,8,13740,14012,,272,PERF
42255326350000,PI,IP,001,9,14090,14364,,274,PERF
42255326350000,PI,IP,001,10,14440,14712,,272,PERF
42255326350000,PI,IP,001,11,14790,15062,,272,PERF
42255326350000,PI,IP,001,12,15140,15367,,227,PERF
42255326350000,PI,IP,001,13,15435,15662,,227,PERF
42255326350000,PI,IP,001,14,15730,16002,,272,PERF
42255326360000,PI,IP,001,1,11387,16766,5930,5379,PERF
42255326370000,PI,IP,001,1,11488,16957,6031,5469,PERF
42255326380000,PI,IP,001,1,11515,11620,,105,PERF
42255326380000,PI,IP,001,2,11972,12287,,315,PERF
42255326380000,PI,IP,001,3,12365,12637,,272,PERF
42255326380000,PI,IP,001,4,12715,12982,,267,PERF
42255326380000,PI,IP,001,5,13065,13337,,272,PERF
42255326380000,PI,IP,001,6,13415,13687,,272,PERF
42255326380000,PI,IP,001,7,13765,14037,,272,PERF
42255326380000,PI,IP,001,8,14115,14387,,272,PERF
42255326380000,PI,IP,001,9,14465,14737,,272,PERF
42255326380000,PI,IP,001,10,14815,15087,,272,PERF
42255326380000,PI,IP,001,11,15165,15437,,272,PERF
42283317790100,PI,IP,001,1,10509,10511,4634,2,PERF
42283317790100,PI,IP,001,2,10554,10556,4634,2,PERF
42283317790100,PI,IP,001,3,10599,10601,4634,2,PERF
42283317790100,PI,IP,001,4,10644,10646,4634,2,PERF
42283317790100,PI,IP,001,5,10689,10691,4634,2,PERF
42283317790100,PI,IP,001,6,10734,10736,4634,2,PERF
42283317790100,PI,IP,001,7,10824,10826,4634,2,PERF
42283317790100,PI,IP,001,8,10869,10871,4634,2,PERF
42283317790100,PI,IP,001,9,10914,10916,4634,2,PERF
42283317790100,PI,IP,001,10,10959,10961,4634,2,PERF
42283317790100,PI,IP,001,11,11004,11006,4634,2,PERF
42283317790100,PI,IP,001,12,11049,11051,4634,2,PERF
42283317790100,PI,IP,001,13,11139,11141,4634,2,PERF
42283317790100,PI,IP,001,14,11184,11186,4634,2,PERF
42283317790100,PI,IP,001,15,11229,11231,4634,2,PERF
42283317790100,PI,IP,001,16,11274,11276,4634,2,PERF
42283317790100,PI,IP,001,17,11316,11321,4634,5,PERF
42283317790100,PI,IP,001,18,11364,11366,4634,2,PERF
42283317790100,PI,IP,001,19,11454,11456,4634,2,PERF
42283317790100,PI,IP,001,20,11499,11501,4634,2,PERF
42283317790100,PI,IP,001,21,11544,11546,4634,2,PERF
42283317790100,PI,IP,001,22,11589,11591,4634,2,PERF
42283317790100,PI,IP,001,23,11634,11636,4634,2,PERF
42283317790100,PI,IP,001,24,11379,11681,4634,302,PERF
42283317790100,PI,IP,001,25,11769,11771,4634,2,PERF
42283317790100,PI,IP,001,26,11814,11816,4634,2,PERF
42283317790100,PI,IP,001,27,11859,11861,4634,2,PERF
42283317790100,PI,IP,001,28,11904,11906,4634,2,PERF
42283317790100,PI,IP,001,29,11949,11951,4634,2,PERF
42283317790100,PI,IP,001,30,11994,11996,4634,2,PERF
42283317790100,PI,IP,001,31,12084,12086,4634,2,PERF
42283317790100,PI,IP,001,32,12129,12131,4634,2,PERF
42283317790100,PI,IP,001,33,12174,12176,4634,2,PERF
42283317790100,PI,IP,001,34,12219,12221,4634,2,PERF
42283317790100,PI,IP,001,35,12264,12266,4634,2,PERF
42283317790100,PI,IP,001,36,12309,12311,4634,2,PERF
42283317790100,PI,IP,001,37,12399,12401,4634,2,PERF
42283317790100,PI,IP,001,38,12444,12446,4634,2,PERF
42283317790100,PI,IP,001,39,12489,12491,4634,2,PERF
42283317790100,PI,IP,001,40,12534,12536,4634,2,PERF
42283317790100,PI,IP,001,41,12579,12581,4634,2,PERF
42283317790100,PI,IP,001,42,12624,12626,4634,2,PERF
42283317790100,PI,IP,001,43,12714,12716,4634,2,PERF
42283317790100,PI,IP,001,44,12759,12761,4634,2,PERF
42283317790100,PI,IP,001,45,12804,12806,4634,2,PERF
42283317790100,PI,IP,001,46,12849,12851,4634,2,PERF
42283317790100,PI,IP,001,47,12894,12896,4634,2,PERF
42283317790100,PI,IP,001,48,12939,12941,4634,2,PERF
42283317790100,PI,IP,001,49,13029,13031,4634,2,PERF
42283317790100,PI,IP,001,50,13074,13076,4634,2,PERF
42283317790100,PI,IP,001,51,13119,13121,4634,2,PERF
42283317790100,PI,IP,001,52,13164,13166,4634,2,PERF
42283317790100,PI,IP,001,53,13209,13211,4634,2,PERF
42283317790100,PI,IP,001,54,13254,13256,4634,2,PERF
42283317790100,PI,IP,001,55,13344,13346,4634,2,PERF
42283317790100,PI,IP,001,56,13389,13391,4634,2,PERF
42283317790100,PI,IP,001,57,13434,13436,4634,2,PERF
42283317790100,PI,IP,001,58,13479,13481,4634,2,PERF
42283317790100,PI,IP,001,59,13524,13526,4634,2,PERF
42283317790100,PI,IP,001,60,13569,13571,4634,2,PERF
42283317790100,PI,IP,001,61,13659,13661,4634,2,PERF
42283317790100,PI,IP,001,62,13704,13706,4634,2,PERF
42283317790100,PI,IP,001,63,13749,13751,4634,2,PERF
42283317790100,PI,IP,001,64,13794,13796,4634,2,PERF
42283317790100,PI,IP,001,65,13839,13841,4634,2,PERF
42283317790100,PI,IP,001,66,13884,13886,4634,2,PERF
42283317790100,PI,IP,001,67,13974,13976,4634,2,PERF
42283317790100,PI,IP,001,68,14019,14021,4634,2,PERF
42283317790100,PI,IP,001,69,14064,14066,4634,2,PERF
42283317790100,PI,IP,001,70,14109,14111,4634,2,PERF
42283317790100,PI,IP,001,71,14154,14156,4634,2,PERF
42283317790100,PI,IP,001,72,14199,14201,4634,2,PERF
42283321440100,PI,IP,001,1,11370,11503,3740,133,PERF
42283321440100,PI,IP,001,2,11530,11753,3740,223,PERF
42283321440100,PI,IP,001,3,11815,12113,3740,298,PERF
42283321440100,PI,IP,001,4,12170,12433,3740,263,PERF
42283321440100,PI,IP,001,5,12480,12770,3740,290,PERF
42283321440100,PI,IP,001,6,12820,13053,3740,233,PERF
42283321440100,PI,IP,001,7,13140,13450,3740,310,PERF
42283321440100,PI,IP,001,8,13497,13773,3740,276,PERF
42283321440100,PI,IP,001,9,13773,13970,3740,197,PERF
42283321440100,PI,IP,001,10,14145,14360,3740,215,PERF
42283321620100,PI,IP,001,1,11099,11372,4626,273,PERF
42283321620100,PI,IP,001,2,11460,11732,4626,272,PERF
42283321620100,PI,IP,001,3,11821,12091,4626,270,PERF
42283321620100,PI,IP,001,4,12181,12454,4626,273,PERF
42283321620100,PI,IP,001,5,12542,12815,4626,273,PERF
42283321620100,PI,IP,001,6,12903,13175,4626,272,PERF
42283321620100,PI,IP,001,7,13264,13536,4626,272,PERF
42283321620100,PI,IP,001,8,13624,13897,4626,273,PERF
42283321620100,PI,IP,001,9,13985,14258,4626,273,PERF
42283321620100,PI,IP,001,10,14346,14618,4626,272,PERF
42283321620100,PI,IP,001,11,14707,14979,4626,272,PERF
42283321620100,PI,IP,001,12,15067,15340,4626,273,PERF
42283321640000,PI,IP,001,1,7620,7660,,40,PERF
42283321840000,PI,IP,001,1,11315,11586,4115,271,PERF
42283321840000,PI,IP,001,2,11674,12036,4115,362,PERF
42283321840000,PI,IP,001,3,12124,12485,4115,361,PERF
42283321840000,PI,IP,001,4,12573,12935,4115,362,PERF
42283321840000,PI,IP,001,5,13022,13384,4115,362,PERF
42283321840000,PI,IP,001,6,13472,13833,4115,361,PERF
42283321840000,PI,IP,001,7,13921,14283,4115,362,PERF
42283321840000,PI,IP,001,8,14731,14732,4115,1,PERF
42283321850000,PI,IP,001,1,7431,10300,3406,2869,PERF
42283321870000,PI,IP,001,1,11605,11877,4051,272,PERF
42283321870000,PI,IP,001,2,11943,12215,4051,272,PERF
42283321870000,PI,IP,001,3,12280,12552,4051,272,PERF
42283321870000,PI,IP,001,4,12618,12890,4051,272,PERF
42283321870000,PI,IP,001,5,12955,13227,4051,272,PERF
42283321870000,PI,IP,001,6,13293,13565,4051,272,PERF
42283321870000,PI,IP,001,7,13630,13902,4051,272,PERF
42283321870000,PI,IP,001,8,13968,14240,4051,272,PERF
42283321870000,PI,IP,001,9,14305,14577,4051,272,PERF
42283321870000,PI,IP,001,10,14643,14915,4051,272,PERF
42283321880100,PI,IP,001,1,11590,14874,4390,3284,PERF
42283321900100,PI,IP,001,1,11503,15012,4746,3509,PERF
42283321910100,PI,IP,001,1,12405,12693,5353,288,PERF
42283321910100,PI,IP,001,2,12733,13021,5353,288,PERF
42283321910100,PI,IP,001,3,13061,13349,5353,288,PERF
42283321910100,PI,IP,001,4,13389,13677,5353,288,PERF
42283321910100,PI,IP,001,5,13717,14005,5353,288,PERF
42283321910100,PI,IP,001,6,14045,14333,5353,288,PERF
42283321910100,PI,IP,001,7,14343,14661,5353,318,PERF
42283321910100,PI,IP,001,8,14701,14989,5353,288,PERF
42283321910100,PI,IP,001,9,15029,15317,5353,288,PERF
42283321910100,PI,IP,001,10,15357,15645,5353,288,PERF
42283321910100,PI,IP,001,11,15685,15973,5353,288,PERF
42283321910100,PI,IP,001,12,16012,16302,5353,290,PERF
42283321930000,PI,IP,001,1,10800,11011,5055,211,PERF
42283321930000,PI,IP,001,2,11405,11735,5055,330,PERF
42283321930000,PI,IP,001,3,11781,12111,5055,330,PERF
42283321930000,PI,IP,001,4,12157,12487,5055,330,PERF
42283321930000,PI,IP,001,5,12533,12863,5055,330,PERF
42283321930000,PI,IP,001,6,12909,13239,5055,330,PERF
42283321930000,PI,IP,001,7,13285,13615,5055,330,PERF
42283321930000,PI,IP,001,8,13661,13991,5055,330,PERF
42283321930000,PI,IP,001,9,14037,14368,5055,331,PERF
42283321930000,PI,IP,001,10,14413,14743,5055,330,PERF
42283321930000,PI,IP,001,11,14789,15119,5055,330,PERF
42283321930000,PI,IP,001,12,15165,15465,5055,300,PERF
42283321940000,PI,IP,001,1,10873,11354,5063,481,PERF
42283321940000,PI,IP,001,2,11385,15450,5063,4065,PERF
42283321980000,PI,IP,001,1,11299,11566,5035,267,PERF
42283321980000,PI,IP,001,2,11603,11870,5035,267,PERF
42283321980000,PI,IP,001,3,12098,12173,5035,75,PERF
42283321980000,PI,IP,001,4,12211,12478,5035,267,PERF
42283321980000,PI,IP,001,5,12515,12782,5035,267,PERF
42283321980000,PI,IP,001,6,12972,13009,5035,37,PERF
42283321980000,PI,IP,001,7,13123,13390,5035,267,PERF
42283321980000,PI,IP,001,8,13427,13694,5035,267,PERF
42283321980000,PI,IP,001,9,13731,13998,5035,267,PERF
42283321980000,PI,IP,001,10,14035,14302,5035,267,PERF
42283321980000,PI,IP,001,11,14339,14454,5035,115,PERF
42283321980000,PI,IP,001,12,14643,14910,5035,267,PERF
42283321980000,PI,IP,001,13,14947,15214,5035,267,PERF
42283321980000,PI,IP,001,14,15251,15518,5035,267,PERF
42283321980000,PI,IP,001,15,15594,15821,5035,227,PERF
42283321990000,PI,IP,001,1,12972,17119,4757,4147,PERF
42283322000000,PI,IP,001,1,11649,11860,4635,211,PERF
42283322000000,PI,IP,001,2,11889,12100,4635,211,PERF
42283322000000,PI,IP,001,3,12129,12340,4635,211,PERF
42283322000000,PI,IP,001,4,12369,12580,4635,211,PERF
42283322000000,PI,IP,001,5,12609,12820,4635,211,PERF
42283322000000,PI,IP,001,6,12849,13060,4635,211,PERF
42283322000000,PI,IP,001,7,13089,13300,4635,211,PERF
42283322000000,PI,IP,001,8,13329,13540,4635,211,PERF
42283322000000,PI,IP,001,9,13569,13780,4635,211,PERF
42283322000000,PI,IP,001,10,14049,14260,4635,211,PERF
42283322000000,PI,IP,001,11,14289,14500,4635,211,PERF
42283322000000,PI,IP,001,12,14529,14740,4635,211,PERF
42283322000000,PI,IP,001,13,14769,14980,4635,211,PERF
42283322000000,PI,IP,001,14,15009,15220,4635,211,PERF
42283322000000,PI,IP,001,15,15249,15460,4635,211,PERF
42283322000000,PI,IP,001,16,15489,15700,4635,211,PERF
42283322000000,PI,IP,001,17,15729,15940,4635,211,PERF
42283322010000,PI,IP,001,1,11245,11450,4921,205,PERF
42283322010000,PI,IP,001,2,11483,11755,4921,272,PERF
42283322010000,PI,IP,001,3,11755,11994,4921,239,PERF
42283322010000,PI,IP,001,4,12027,12266,4921,239,PERF
42283322010000,PI,IP,001,5,12299,12538,4921,239,PERF
42283322010000,PI,IP,001,6,12571,12810,4921,239,PERF
42283322010000,PI,IP,001,7,12843,13082,4921,239,PERF
42283322010000,PI,IP,001,8,13115,13354,4921,239,PERF
42283322010000,PI,IP,001,9,13387,13626,4921,239,PERF
42283322010000,PI,IP,001,10,13659,13898,4921,239,PERF
42283322010000,PI,IP,001,11,14203,14442,4921,239,PERF
42283322010000,PI,IP,001,12,14475,14725,4921,250,PERF
42283322010000,PI,IP,001,13,14747,14986,4921,239,PERF
42283322010000,PI,IP,001,14,15019,15316,4921,297,PERF
42283322030000,PI,IP,001,1,11424,11663,4528,239,PERF
42283322030000,PI,IP,001,2,11693,11696,4528,3,PERF
42283322030000,PI,IP,001,3,11968,12207,4528,239,PERF
42283322030000,PI,IP,001,4,12240,12479,4528,239,PERF
42283322030000,PI,IP,001,5,12512,12751,4528,239,PERF
42283322030000,PI,IP,001,6,12784,13023,4528,239,PERF
42283322030000,PI,IP,001,7,13056,13295,4528,239,PERF
42283322030000,PI,IP,001,8,13328,13567,4528,239,PERF
42283322030000,PI,IP,001,9,13600,13839,4528,239,PERF
42283322030000,PI,IP,001,10,13872,14111,4528,239,PERF
42283322030000,PI,IP,001,11,14144,14383,4528,239,PERF
42283322030000,PI,IP,001,12,14416,14655,4528,239,PERF
42283322030000,PI,IP,001,13,14688,14927,4528,239,PERF
42283322030000,PI,IP,001,14,14960,15199,4528,239,PERF
42283322030000,PI,IP,001,15,15232,15569,4528,337,PERF
42283322040000,PI,IP,001,1,11185,11452,5024,267,PERF
42283322040000,PI,IP,001,2,11489,11756,5024,267,PERF
42283322040000,PI,IP,001,3,11793,12060,5024,267,PERF
42283322040000,PI,IP,001,4,12097,12364,5024,267,PERF
42283322040000,PI,IP,001,5,12401,12668,5024,267,PERF
42283322040000,PI,IP,001,6,12705,12972,5024,267,PERF
42283322040000,PI,IP,001,7,13009,13276,5024,267,PERF
42283322040000,PI,IP,001,8,13313,13580,5024,267,PERF
42283322040000,PI,IP,001,9,13617,13884,5024,267,PERF
42283322040000,PI,IP,001,10,13921,14188,5024,267,PERF
42283322040000,PI,IP,001,11,14225,14402,5024,177,PERF
42283322040000,PI,IP,001,12,14529,14796,5024,267,PERF
42283322040000,PI,IP,001,13,14833,15100,5024,267,PERF
42283322040000,PI,IP,001,14,15132,15404,5024,272,PERF
42283322040000,PI,IP,001,15,15441,15708,5024,267,PERF
42283322050000,PI,IP,001,1,11650,16452,5764,4802,PERF
42283322060000,PI,IP,001,1,11398,11665,5013,267,PERF
42283322060000,PI,IP,001,2,11702,11969,5013,267,PERF
42283322060000,PI,IP,001,3,12006,12273,5013,267,PERF
42283322060000,PI,IP,001,4,12310,12577,5013,267,PERF
42283322060000,PI,IP,001,5,12614,12881,5013,267,PERF
42283322060000,PI,IP,001,6,12918,13185,5013,267,PERF
42283322060000,PI,IP,001,7,13222,13489,5013,267,PERF
42283322060000,PI,IP,001,8,13526,13793,5013,267,PERF
42283322060000,PI,IP,001,9,13830,14097,5013,267,PERF
42283322060000,PI,IP,001,10,14134,14401,5013,267,PERF
42283322060000,PI,IP,001,11,14438,14705,5013,267,PERF
42283322060000,PI,IP,001,12,14742,15009,5013,267,PERF
42283322060000,PI,IP,001,13,15046,15313,5013,267,PERF
42283322060000,PI,IP,001,14,15350,15617,5013,267,PERF
42283322060000,PI,IP,001,15,15654,15921,5013,267,PERF
42283322090000,PI,IP,001,1,11667,11941,5253,274,PERF
42283322090000,PI,IP,001,2,11979,12253,5253,274,PERF
42283322090000,PI,IP,001,3,12291,12565,5253,274,PERF
42283322090000,PI,IP,001,4,12603,12877,5253,274,PERF
42283322090000,PI,IP,001,5,12915,13189,5253,274,PERF
42283322090000,PI,IP,001,6,13227,13501,5253,274,PERF
42283322090000,PI,IP,001,7,13539,13813,5253,274,PERF
42283322090000,PI,IP,001,8,13851,14125,5253,274,PERF
42283322090000,PI,IP,001,9,14163,14437,5253,274,PERF
42283322090000,PI,IP,001,10,14475,14749,5253,274,PERF
42283322090000,PI,IP,001,11,14787,15061,5253,274,PERF
42283322090000,PI,IP,001,12,15099,15373,5253,274,PERF
42283322090000,PI,IP,001,13,15411,15685,5253,274,PERF
42283322090000,PI,IP,001,14,15723,15997,5253,274,PERF
42283322110000,PI,IP,001,1,12555,12557,4137,2,PERF
42283322110000,PI,IP,001,2,12581,12583,4137,2,PERF
42283322110000,PI,IP,001,3,12638,12640,4137,2,PERF
42283322110000,PI,IP,001,4,12708,12710,4137,2,PERF
42283322110000,PI,IP,001,5,12752,12754,4137,2,PERF
42283322110000,PI,IP,001,6,12800,12802,4137,2,PERF
42283322110000,PI,IP,001,7,12890,12893,4137,3,PERF
42283322110000,PI,IP,001,8,12945,12948,4137,3,PERF
42283322110000,PI,IP,001,9,13000,13003,4137,3,PERF
42283322110000,PI,IP,001,10,13055,13058,4137,3,PERF
42283322110000,PI,IP,001,11,13140,13143,4137,3,PERF
42283322110000,PI,IP,001,12,13195,13198,4137,3,PERF
42283322110000,PI,IP,001,13,13250,13253,4137,3,PERF
42283322110000,PI,IP,001,14,13305,13308,4137,3,PERF
42283322110000,PI,IP,001,15,13390,13393,4137,3,PERF
42283322110000,PI,IP,001,16,13445,13448,4137,3,PERF
42283322110000,PI,IP,001,17,13500,13503,4137,3,PERF
42283322110000,PI,IP,001,18,13555,13558,4137,3,PERF
42283322110000,PI,IP,001,19,13640,13643,4137,3,PERF
42283322110000,PI,IP,001,20,13695,13698,4137,3,PERF
42283322110000,PI,IP,001,21,13750,13753,4137,3,PERF
42283322110000,PI,IP,001,22,13805,13808,4137,3,PERF
42283322110000,PI,IP,001,23,13894,13897,4137,3,PERF
42283322110000,PI,IP,001,24,13937,13940,4137,3,PERF
42283322110000,PI,IP,001,25,13980,13983,4137,3,PERF
42283322110000,PI,IP,001,26,14055,14058,4137,3,PERF
42283322110000,PI,IP,001,27,14146,14149,4137,3,PERF
42283322110000,PI,IP,001,28,14204,14207,4137,3,PERF
42283322110000,PI,IP,001,29,14245,14248,4137,3,PERF
42283322110000,PI,IP,001,30,14309,14312,4137,3,PERF
42283322110000,PI,IP,001,31,14400,14403,4137,3,PERF
42283322110000,PI,IP,001,32,14445,14448,4137,3,PERF
42283322110000,PI,IP,001,33,14488,14491,4137,3,PERF
42283322110000,PI,IP,001,34,14540,14543,4137,3,PERF
42283322110000,PI,IP,001,35,14640,14643,4137,3,PERF
42283322110000,PI,IP,001,36,14704,14707,4137,3,PERF
42283322110000,PI,IP,001,37,14748,14751,4137,3,PERF
42283322110000,PI,IP,001,38,14812,14815,4137,3,PERF
42283322110000,PI,IP,001,39,14890,14893,4137,3,PERF
42283322110000,PI,IP,001,40,14940,14943,4137,3,PERF
42283322110000,PI,IP,001,41,15000,15003,4137,3,PERF
42283322110000,PI,IP,001,42,15055,15058,4137,3,PERF
42283322110000,PI,IP,001,43,15140,15143,4137,3,PERF
42283322110000,PI,IP,001,44,15198,15201,4137,3,PERF
42283322110000,PI,IP,001,45,15250,15253,4137,3,PERF
42283322110000,PI,IP,001,46,15305,15308,4137,3,PERF
42283322110000,PI,IP,001,47,15390,15393,4137,3,PERF
42283322110000,PI,IP,001,48,15445,15448,4137,3,PERF
42283322110000,PI,IP,001,49,15500,15503,4137,3,PERF
42283322110000,PI,IP,001,50,15555,15558,4137,3,PERF
42283322110000,PI,IP,001,51,15640,15643,4137,3,PERF
42283322110000,PI,IP,001,52,15695,15698,4137,3,PERF
42283322110000,PI,IP,001,53,15750,15753,4137,3,PERF
42283322110000,PI,IP,001,54,15792,15795,4137,3,PERF
42283322110000,PI,IP,001,55,15890,15893,4137,3,PERF
42283322110000,PI,IP,001,56,15931,15934,4137,3,PERF
42283322110000,PI,IP,001,57,15990,15993,4137,3,PERF
42283322110000,PI,IP,001,58,16064,16067,4137,3,PERF
42283322110000,PI,IP,001,59,16146,16149,4137,3,PERF
42283322110000,PI,IP,001,60,16195,16198,4137,3,PERF
42283322110000,PI,IP,001,61,16260,16263,4137,3,PERF
42283322110000,PI,IP,001,62,16305,16308,4137,3,PERF
42283322110000,PI,IP,001,63,16390,16393,4137,3,PERF
42283322110000,PI,IP,001,64,16445,16448,4137,3,PERF
42283322110000,PI,IP,001,65,16500,16503,4137,3,PERF
42283322110000,PI,IP,001,66,16555,16558,4137,3,PERF
42283322120000,PI,IP,001,1,11446,11706,5024,260,PERF
42283322120000,PI,IP,001,2,11742,12002,5024,260,PERF
42283322120000,PI,IP,001,3,12038,12298,5024,260,PERF
42283322120000,PI,IP,001,4,12334,12594,5024,260,PERF
42283322120000,PI,IP,001,5,12630,12890,5024,260,PERF
42283322120000,PI,IP,001,6,12926,13186,5024,260,PERF
42283322120000,PI,IP,001,7,13222,13482,5024,260,PERF
42283322120000,PI,IP,001,8,13518,13778,5024,260,PERF
42283322120000,PI,IP,001,9,13814,14074,5024,260,PERF
42283322120000,PI,IP,001,10,14110,14380,5024,270,PERF
42283322120000,PI,IP,001,11,14406,14666,5024,260,PERF
42283322120000,PI,IP,001,12,14702,14962,5024,260,PERF
42283322120000,PI,IP,001,13,14998,15258,5024,260,PERF
42283322120000,PI,IP,001,14,15294,15554,5024,260,PERF
42283322120000,PI,IP,001,15,15576,15811,5024,235,PERF
42283322130000,PI,IP,001,1,14317,14556,5321,239,PERF
42283322130000,PI,IP,001,2,14589,14828,5321,239,PERF
42283322130000,PI,IP,001,3,14861,15100,5321,239,PERF
42283322130000,PI,IP,001,4,15133,15372,5321,239,PERF
42283322130000,PI,IP,001,5,15405,15610,5321,205,PERF
42283322140000,PI,IP,001,1,11411,16604,6074,5193,PERF
42283322150000,PI,IP,001,1,12855,17452,5621,4597,PERF
42283322160100,PI,IP,001,1,11533,11535,5318,2,PERF
42283322160100,PI,IP,001,2,11574,11576,5318,2,PERF
42283322160100,PI,IP,001,3,11615,11617,5318,2,PERF
42283322160100,PI,IP,001,4,11656,11658,5318,2,PERF
42283322160100,PI,IP,001,5,11697,11699,5318,2,PERF
42283322160100,PI,IP,001,6,11738,11740,5318,2,PERF
42283322160100,PI,IP,001,7,11823,11825,5318,2,PERF
42283322160100,PI,IP,001,8,11864,11866,5318,2,PERF
42283322160100,PI,IP,001,9,11905,11907,5318,2,PERF
42283322160100,PI,IP,001,10,11946,11948,5318,2,PERF
42283322160100,PI,IP,001,11,11987,11989,5318,2,PERF
42283322160100,PI,IP,001,12,12028,12030,5318,2,PERF
42283322160100,PI,IP,001,13,12113,12115,5318,2,PERF
42283322160100,PI,IP,001,14,12154,12156,5318,2,PERF
42283322160100,PI,IP,001,15,12195,12197,5318,2,PERF
42283322160100,PI,IP,001,16,12236,12238,5318,2,PERF
42283322160100,PI,IP,001,17,12277,12279,5318,2,PERF
42283322160100,PI,IP,001,18,12318,12320,5318,2,PERF
42283322160100,PI,IP,001,19,12403,12405,5318,2,PERF
42283322160100,PI,IP,001,20,12444,12446,5318,2,PERF
42283322160100,PI,IP,001,21,12485,12487,5318,2,PERF
42283322160100,PI,IP,001,22,12526,12528,5318,2,PERF
42283322160100,PI,IP,001,23,12567,12569,5318,2,PERF
42283322160100,PI,IP,001,24,12608,12610,5318,2,PERF
42283322160100,PI,IP,001,25,12693,12695,5318,2,PERF
42283322160100,PI,IP,001,26,12734,12736,5318,2,PERF
42283322160100,PI,IP,001,27,12775,12777,5318,2,PERF
42283322160100,PI,IP,001,28,12816,12818,5318,2,PERF
42283322160100,PI,IP,001,29,12857,12859,5318,2,PERF
42283322160100,PI,IP,001,30,12898,12900,5318,2,PERF
42283322160100,PI,IP,001,31,12983,12985,5318,2,PERF
42283322160100,PI,IP,001,32,13024,13026,5318,2,PERF
42283322160100,PI,IP,001,33,13065,13067,5318,2,PERF
42283322160100,PI,IP,001,34,13106,13108,5318,2,PERF
42283322160100,PI,IP,001,35,13147,13149,5318,2,PERF
42283322160100,PI,IP,001,36,13188,13190,5318,2,PERF
42283322160100,PI,IP,001,37,13273,13275,5318,2,PERF
42283322160100,PI,IP,001,38,13314,13316,5318,2,PERF
42283322160100,PI,IP,001,39,13355,13357,5318,2,PERF
42283322160100,PI,IP,001,40,13396,13398,5318,2,PERF
42283322160100,PI,IP,001,41,13437,13439,5318,2,PERF
42283322160100,PI,IP,001,42,13478,13480,5318,2,PERF
42283322160100,PI,IP,001,43,13563,13565,5318,2,PERF
42283322160100,PI,IP,001,44,13604,13606,5318,2,PERF
42283322160100,PI,IP,001,45,13645,13647,5318,2,PERF
42283322160100,PI,IP,001,46,13686,13688,5318,2,PERF
42283322160100,PI,IP,001,47,13727,13729,5318,2,PERF
42283322160100,PI,IP,001,48,13768,13770,5318,2,PERF
42283322160100,PI,IP,001,49,13853,13855,5318,2,PERF
42283322160100,PI,IP,001,50,13894,13896,5318,2,PERF
42283322160100,PI,IP,001,51,13935,13937,5318,2,PERF
42283322160100,PI,IP,001,52,13976,13978,5318,2,PERF
42283322160100,PI,IP,001,53,14017,14019,5318,2,PERF
42283322160100,PI,IP,001,54,14058,14060,5318,2,PERF
42283322160100,PI,IP,001,55,14143,14145,5318,2,PERF
42283322160100,PI,IP,001,56,14184,14186,5318,2,PERF
42283322160100,PI,IP,001,57,14225,14227,5318,2,PERF
42283322160100,PI,IP,001,58,14266,14268,5318,2,PERF
42283322160100,PI,IP,001,59,14307,14309,5318,2,PERF
42283322160100,PI,IP,001,60,14348,14350,5318,2,PERF
42283322160100,PI,IP,001,61,14433,14435,5318,2,PERF
42283322160100,PI,IP,001,62,14474,14476,5318,2,PERF
42283322160100,PI,IP,001,63,14515,14517,5318,2,PERF
42283322160100,PI,IP,001,64,14556,14558,5318,2,PERF
42283322160100,PI,IP,001,65,14597,14599,5318,2,PERF
42283322160100,PI,IP,001,66,14638,14640,5318,2,PERF
42283322160100,PI,IP,001,67,14723,14725,5318,2,PERF
42283322160100,PI,IP,001,68,14764,14766,5318,2,PERF
42283322160100,PI,IP,001,69,14805,14807,5318,2,PERF
42283322160100,PI,IP,001,70,14846,14848,5318,2,PERF
42283322160100,PI,IP,001,71,14887,14889,5318,2,PERF
42283322160100,PI,IP,001,72,14928,14930,5318,2,PERF
42283322160100,PI,IP,001,73,15013,15015,5318,2,PERF
42283322160100,PI,IP,001,74,15054,15056,5318,2,PERF
42283322160100,PI,IP,001,75,15095,15097,5318,2,PERF
42283322160100,PI,IP,001,76,15136,15138,5318,2,PERF
42283322160100,PI,IP,001,77,15177,15179,5318,2,PERF
42283322160100,PI,IP,001,78,15218,15220,5318,2,PERF
42283322160100,PI,IP,001,79,15303,15305,5318,2,PERF
42283322160100,PI,IP,001,80,15344,15346,5318,2,PERF
42283322160100,PI,IP,001,81,15385,15387,5318,2,PERF
42283322160100,PI,IP,001,82,15426,15428,5318,2,PERF
42283322160100,PI,IP,001,83,15467,15469,5318,2,PERF
42283322160100,PI,IP,001,84,15508,15510,5318,2,PERF
42283322180000,PI,IP,001,1,11184,15080,4521,3896,PERF
42283322190000,PI,IP,001,1,13195,13197,4331,2,PERF
42283322190000,PI,IP,001,2,13255,13257,4331,2,PERF
42283322190000,PI,IP,001,3,13315,13317,4331,2,PERF
42283322190000,PI,IP,001,4,13375,13377,4331,2,PERF
42283322190000,PI,IP,001,5,13460,13462,4331,2,PERF
42283322190000,PI,IP,001,6,13520,13522,4331,2,PERF
42283322190000,PI,IP,001,7,13580,13582,4331,2,PERF
42283322190000,PI,IP,001,8,13640,13642,4331,2,PERF
42283322190000,PI,IP,001,9,13735,13737,4331,2,PERF
42283322190000,PI,IP,001,10,13795,13797,4331,2,PERF
42283322190000,PI,IP,001,11,13855,13857,4331,2,PERF
42283322190000,PI,IP,001,12,13915,13917,4331,2,PERF
42283322190000,PI,IP,001,13,14010,14012,4331,2,PERF
42283322190000,PI,IP,001,14,14070,14072,4331,2,PERF
42283322190000,PI,IP,001,15,14130,14132,4331,2,PERF
42283322190000,PI,IP,001,16,14190,14192,4331,2,PERF
42283322190000,PI,IP,001,17,14285,14287,4331,2,PERF
42283322190000,PI,IP,001,18,14345,14347,4331,2,PERF
42283322190000,PI,IP,001,19,14405,14407,4331,2,PERF
42283322190000,PI,IP,001,20,14465,14467,4331,2,PERF
42283322190000,PI,IP,001,21,14543,14546,4331,3,PERF
42283322190000,PI,IP,001,22,14628,14631,4331,3,PERF
42283322190000,PI,IP,001,23,14713,14716,4331,3,PERF
42283322190000,PI,IP,001,24,14793,14796,4331,3,PERF
42283322190000,PI,IP,001,25,14878,14881,4331,3,PERF
42283322190000,PI,IP,001,26,14963,14966,4331,3,PERF
42283322190000,PI,IP,001,27,15018,15021,4331,3,PERF
42283322190000,PI,IP,001,28,15103,15106,4331,3,PERF
42283322190000,PI,IP,001,29,15188,15191,4331,3,PERF
42283322190000,PI,IP,001,30,15243,15246,4331,3,PERF
42283322190000,PI,IP,001,31,15328,15331,4331,3,PERF
42283322190000,PI,IP,001,32,15413,15416,4331,3,PERF
42283322190000,PI,IP,001,33,15468,15471,4331,3,PERF
42283322190000,PI,IP,001,34,15553,15556,4331,3,PERF
42283322190000,PI,IP,001,35,15638,15641,4331,3,PERF
42283322190000,PI,IP,001,36,15693,15696,4331,3,PERF
42283322190000,PI,IP,001,37,15778,15781,4331,3,PERF
42283322190000,PI,IP,001,38,15863,15866,4331,3,PERF
42283322190000,PI,IP,001,39,15943,15946,4331,3,PERF
42283322190000,PI,IP,001,40,16028,16031,4331,3,PERF
42283322190000,PI,IP,001,41,16096,16099,4331,3,PERF
42283322190000,PI,IP,001,42,16126,16128,4331,2,PERF
42283322190000,PI,IP,001,43,16181,16183,4331,2,PERF
42283322190000,PI,IP,001,44,16236,16238,4331,2,PERF
42283322190000,PI,IP,001,45,16291,16293,4331,2,PERF
42283322190000,PI,IP,001,46,16346,16348,4331,2,PERF
42283322200000,PI,IP,001,1,11497,15867,5023,4370,PERF
42283322210000,PI,IP,001,1,11230,11231,4957,1,PERF
42283322210000,PI,IP,001,2,11276,11277,4957,1,PERF
42283322210000,PI,IP,001,3,11320,11321,4957,1,PERF
42283322210000,PI,IP,001,4,11364,11365,4957,1,PERF
42283322210000,PI,IP,001,5,11408,11409,4957,1,PERF
42283322210000,PI,IP,001,6,11452,11453,4957,1,PERF
42283322210000,PI,IP,001,7,11496,11497,4957,1,PERF
42283322210000,PI,IP,001,8,11538,11539,4957,1,PERF
42283322210000,PI,IP,001,9,11584,11585,4957,1,PERF
42283322210000,PI,IP,001,10,11628,11629,4957,1,PERF
42283322210000,PI,IP,001,11,11672,11673,4957,1,PERF
42283322210000,PI,IP,001,12,11716,11717,4957,1,PERF
42283322210000,PI,IP,001,13,11760,11761,4957,1,PERF
42283322210000,PI,IP,001,14,11802,11803,4957,1,PERF
42283322210000,PI,IP,001,15,11848,11849,4957,1,PERF
42283322210000,PI,IP,001,16,11892,11893,4957,1,PERF
42283322210000,PI,IP,001,17,11936,11937,4957,1,PERF
42283322210000,PI,IP,001,18,11980,11981,4957,1,PERF
42283322210000,PI,IP,001,19,12024,12025,4957,1,PERF
42283322210000,PI,IP,001,20,12068,12069,4957,1,PERF
42283322210000,PI,IP,001,21,12112,12113,4957,1,PERF
42283322210000,PI,IP,001,22,12156,12157,4957,1,PERF
42283322210000,PI,IP,001,23,12200,12201,4957,1,PERF
42283322210000,PI,IP,001,24,12244,12245,4957,1,PERF
42283322210000,PI,IP,001,25,12288,12289,4957,1,PERF
42283322210000,PI,IP,001,26,12332,12333,4957,1,PERF
42283322210000,PI,IP,001,27,12376,12377,4957,1,PERF
42283322210000,PI,IP,001,28,12422,12423,4957,1,PERF
42283322210000,PI,IP,001,29,12464,12465,4957,1,PERF
42283322210000,PI,IP,001,30,12508,12509,4957,1,PERF
42283322210000,PI,IP,001,31,12552,12553,4957,1,PERF
42283322210000,PI,IP,001,32,12596,12597,4957,1,PERF
42283322210000,PI,IP,001,33,12640,12641,4957,1,PERF
42283322210000,PI,IP,001,34,12685,12686,4957,1,PERF
42283322210000,PI,IP,001,35,12728,12729,4957,1,PERF
42283322210000,PI,IP,001,36,12772,12773,4957,1,PERF
42283322210000,PI,IP,001,37,12816,12817,4957,1,PERF
42283322210000,PI,IP,001,38,12860,12861,4957,1,PERF
42283322210000,PI,IP,001,39,12903,12904,4957,1,PERF
42283322210000,PI,IP,001,40,12948,12949,4957,1,PERF
42283322210000,PI,IP,001,41,12992,12993,4957,1,PERF
42283322210000,PI,IP,001,42,13036,13037,4957,1,PERF
42283322210000,PI,IP,001,43,13080,13081,4957,1,PERF
42283322210000,PI,IP,001,44,13124,13125,4957,1,PERF
42283322210000,PI,IP,001,45,13169,13170,4957,1,PERF
42283322210000,PI,IP,001,46,13212,13213,4957,1,PERF
42283322210000,PI,IP,001,47,13256,13257,4957,1,PERF
42283322210000,PI,IP,001,48,13300,13301,4957,1,PERF
42283322210000,PI,IP,001,49,13344,13345,4957,1,PERF
42283322210000,PI,IP,001,50,13385,13386,4957,1,PERF
42283322210000,PI,IP,001,51,13432,13433,4957,1,PERF
42283322210000,PI,IP,001,52,13476,13477,4957,1,PERF
42283322210000,PI,IP,001,53,13520,13521,4957,1,PERF
42283322210000,PI,IP,001,54,13564,13565,4957,1,PERF
42283322210000,PI,IP,001,55,13608,13609,4957,1,PERF
42283322210000,PI,IP,001,56,13650,13651,4957,1,PERF
42283322210000,PI,IP,001,57,13696,13697,4957,1,PERF
42283322210000,PI,IP,001,58,13740,13741,4957,1,PERF
42283322210000,PI,IP,001,59,13784,13785,4957,1,PERF
42283322210000,PI,IP,001,60,13828,13829,4957,1,PERF
42283322210000,PI,IP,001,61,13872,13873,4957,1,PERF
42283322210000,PI,IP,001,62,13916,13917,4957,1,PERF
42283322210000,PI,IP,001,63,13960,13961,4957,1,PERF
42283322210000,PI,IP,001,64,14004,14005,4957,1,PERF
42283322210000,PI,IP,001,65,14048,14049,4957,1,PERF
42283322210000,PI,IP,001,66,14092,14093,4957,1,PERF
42283322210000,PI,IP,001,67,14136,14137,4957,1,PERF
42283322210000,PI,IP,001,68,14180,14181,4957,1,PERF
42283322210000,PI,IP,001,69,14224,14225,4957,1,PERF
42283322210000,PI,IP,001,70,14265,14266,4957,1,PERF
42283322210000,PI,IP,001,71,14312,14313,4957,1,PERF
42283322210000,PI,IP,001,72,14356,14357,4957,1,PERF
42283322210000,PI,IP,001,73,14400,14401,4957,1,PERF
42283322210000,PI,IP,001,74,14444,14445,4957,1,PERF
42283322210000,PI,IP,001,75,14488,14489,4957,1,PERF
42283322210000,PI,IP,001,76,14532,14533,4957,1,PERF
42283322210000,PI,IP,001,77,14576,14577,4957,1,PERF
42283322210000,PI,IP,001,78,14620,14621,4957,1,PERF
42283322210000,PI,IP,001,79,14664,14665,4957,1,PERF
42283322210000,PI,IP,001,80,14708,14709,4957,1,PERF
42283322210000,PI,IP,001,81,14752,14753,4957,1,PERF
42283322210000,PI,IP,001,82,14796,14797,4957,1,PERF
42283322210000,PI,IP,001,83,14840,14841,4957,1,PERF
42283322210000,PI,IP,001,84,14884,14885,4957,1,PERF
42283322210000,PI,IP,001,85,14928,14929,4957,1,PERF
42283322210000,PI,IP,001,86,14972,14973,4957,1,PERF
42283322210000,PI,IP,001,87,15016,15017,4957,1,PERF
42283322210000,PI,IP,001,88,15060,15061,4957,1,PERF
42283322210000,PI,IP,001,89,15104,15105,4957,1,PERF
42283322210000,PI,IP,001,90,15148,15149,4957,1,PERF
42283322210000,PI,IP,001,91,15192,15193,4957,1,PERF
42283322210000,PI,IP,001,92,15236,15237,4957,1,PERF
42283322210000,PI,IP,001,93,15280,15281,4957,1,PERF
42283322210000,PI,IP,001,94,15324,15325,4957,1,PERF
42283322210000,PI,IP,001,95,15368,15369,4957,1,PERF
42283322210000,PI,IP,001,96,15412,15413,4957,1,PERF
42283322220100,PI,IP,001,1,11132,11134,4647,2,PERF
42283322220100,PI,IP,001,2,11172,11174,4647,2,PERF
42283322220100,PI,IP,001,3,11212,11214,4647,2,PERF
42283322220100,PI,IP,001,4,11252,11254,4647,2,PERF
42283322220100,PI,IP,001,5,11292,11294,4647,2,PERF
42283322220100,PI,IP,001,6,11332,11334,4647,2,PERF
42283322220100,PI,IP,001,7,11422,11424,4647,2,PERF
42283322220100,PI,IP,001,8,11462,11464,4647,2,PERF
42283322220100,PI,IP,001,9,11502,11504,4647,2,PERF
42283322220100,PI,IP,001,10,11542,11544,4647,2,PERF
42283322220100,PI,IP,001,11,11582,11584,4647,2,PERF
42283322220100,PI,IP,001,12,11622,11624,4647,2,PERF
42283322220100,PI,IP,001,13,11712,11714,4647,2,PERF
42283322220100,PI,IP,001,14,11752,11754,4647,2,PERF
42283322220100,PI,IP,001,15,11792,11794,4647,2,PERF
42283322220100,PI,IP,001,16,11832,11834,4647,2,PERF
42283322220100,PI,IP,001,17,11872,11874,4647,2,PERF
42283322220100,PI,IP,001,18,11912,11914,4647,2,PERF
42283322220100,PI,IP,001,19,12002,12004,4647,2,PERF
42283322220100,PI,IP,001,20,12042,12044,4647,2,PERF
42283322220100,PI,IP,001,21,12082,12084,4647,2,PERF
42283322220100,PI,IP,001,22,12122,12124,4647,2,PERF
42283322220100,PI,IP,001,23,12162,12164,4647,2,PERF
42283322220100,PI,IP,001,24,12202,12204,4647,2,PERF
42283322220100,PI,IP,001,25,12292,12294,4647,2,PERF
42283322220100,PI,IP,001,26,12332,12334,4647,2,PERF
42283322220100,PI,IP,001,27,12372,13274,4647,902,PERF
42283322220100,PI,IP,001,28,12412,12414,4647,2,PERF
42283322220100,PI,IP,001,29,12452,12454,4647,2,PERF
42283322220100,PI,IP,001,30,12492,12494,4647,2,PERF
42283322220100,PI,IP,001,31,12582,12584,4647,2,PERF
42283322220100,PI,IP,001,32,12622,12624,4647,2,PERF
42283322220100,PI,IP,001,33,12662,12664,4647,2,PERF
42283322220100,PI,IP,001,34,12702,12704,4647,2,PERF
42283322220100,PI,IP,001,35,12742,12744,4647,2,PERF
42283322220100,PI,IP,001,36,12782,12784,4647,2,PERF
42283322220100,PI,IP,001,37,12872,12874,4647,2,PERF
42283322220100,PI,IP,001,38,12912,12914,4647,2,PERF
42283322220100,PI,IP,001,39,12952,12954,4647,2,PERF
42283322220100,PI,IP,001,40,12992,12994,4647,2,PERF
42283322220100,PI,IP,001,41,13032,13034,4647,2,PERF
42283322220100,PI,IP,001,42,13072,13074,4647,2,PERF
42283322220100,PI,IP,001,43,13162,13164,4647,2,PERF
42283322220100,PI,IP,001,44,13202,13204,4647,2,PERF
42283322220100,PI,IP,001,45,13242,13244,4647,2,PERF
42283322220100,PI,IP,001,46,13282,13284,4647,2,PERF
42283322220100,PI,IP,001,47,13322,13324,4647,2,PERF
42283322220100,PI,IP,001,48,13362,13364,4647,2,PERF
42283322220100,PI,IP,001,49,13452,13454,4647,2,PERF
42283322220100,PI,IP,001,50,13492,13494,4647,2,PERF
42283322220100,PI,IP,001,51,13532,13534,4647,2,PERF
42283322220100,PI,IP,001,52,13572,13574,4647,2,PERF
42283322220100,PI,IP,001,53,13612,13614,4647,2,PERF
42283322220100,PI,IP,001,54,13652,13654,4647,2,PERF
42283322220100,PI,IP,001,55,13742,13744,4647,2,PERF
42283322220100,PI,IP,001,56,13782,13784,4647,2,PERF
42283322220100,PI,IP,001,57,13822,13824,4647,2,PERF
42283322220100,PI,IP,001,58,13862,13864,4647,2,PERF
42283322220100,PI,IP,001,59,13902,13904,4647,2,PERF
42283322220100,PI,IP,001,60,13942,13944,4647,2,PERF
42283322220100,PI,IP,001,61,14032,14034,4647,2,PERF
42283322220100,PI,IP,001,62,14072,14074,4647,2,PERF
42283322220100,PI,IP,001,63,14112,14114,4647,2,PERF
42283322220100,PI,IP,001,64,14152,14154,4647,2,PERF
42283322220100,PI,IP,001,65,14192,14194,4647,2,PERF
42283322220100,PI,IP,001,66,14232,14234,4647,2,PERF
42283322220100,PI,IP,001,67,14322,14324,4647,2,PERF
42283322220100,PI,IP,001,68,14362,14364,4647,2,PERF
42283322220100,PI,IP,001,69,14402,14404,4647,2,PERF
42283322220100,PI,IP,001,70,14442,14444,4647,2,PERF
42283322220100,PI,IP,001,71,14482,14484,4647,2,PERF
42283322220100,PI,IP,001,72,14522,14524,4647,2,PERF
42283322220100,PI,IP,001,73,14612,14614,4647,2,PERF
42283322220100,PI,IP,001,74,14652,14654,4647,2,PERF
42283322220100,PI,IP,001,75,14692,14694,4647,2,PERF
42283322220100,PI,IP,001,76,14732,14734,4647,2,PERF
42283322220100,PI,IP,001,77,14772,14774,4647,2,PERF
42283322220100,PI,IP,001,78,14812,14814,4647,2,PERF
42283322250000,PI,PT,001,1,12703,12709,,6,PERF
42283322250000,PI,PT,002,2,12550,12660,,110,PERF
42283322250100,PI,IP,001,1,9820,9823,6033,3,PERF
42283322250100,PI,IP,001,2,9920,9923,6033,3,PERF
42283322250100,PI,IP,001,3,10020,10026,6033,6,PERF
42283322250100,PI,IP,001,4,10230,10233,6033,3,PERF
42283322250100,PI,IP,001,5,10330,10336,6033,6,PERF
42283322250100,PI,IP,001,6,10440,10443,6033,3,PERF
42283322250100,PI,IP,001,7,10540,10543,6033,3,PERF
42283322250100,PI,IP,001,8,10634,10640,6033,6,PERF
42283322250100,PI,IP,001,9,10750,10753,6033,3,PERF
42283322250100,PI,IP,001,10,10850,10853,6033,3,PERF
42283322250100,PI,IP,001,11,10950,10956,6033,6,PERF
42283322250100,PI,IP,001,12,11066,11069,6033,3,PERF
42283322250100,PI,IP,001,13,11160,11163,6033,3,PERF
42283322250100,PI,IP,001,14,11260,11263,6033,3,PERF
42283322250100,PI,IP,001,15,11370,11373,6033,3,PERF
42283322250100,PI,IP,001,16,11460,11463,6033,3,PERF
42283322250100,PI,IP,001,17,11570,11576,6033,6,PERF
42283322250100,PI,IP,001,18,11680,11683,6033,3,PERF
42283322250100,PI,IP,001,19,11780,11783,6033,3,PERF
42283322250100,PI,IP,001,20,11870,11876,6033,6,PERF
42283322250100,PI,IP,001,21,11994,11997,6033,3,PERF
42283322250100,PI,IP,001,22,12090,12093,6033,3,PERF
42283322250100,PI,IP,001,23,12190,12196,6033,6,PERF
42283322250100,PI,IP,001,24,12310,12313,6033,3,PERF
42283322250100,PI,IP,001,25,12400,12403,6033,3,PERF
42283322250100,PI,IP,001,26,12500,12506,6033,6,PERF
42283322250100,PI,IP,001,27,12610,12613,6033,3,PERF
42283322250100,PI,IP,001,28,12707,12710,6033,3,PERF
42283322250100,PI,IP,001,29,12820,12826,6033,6,PERF
42283322250100,PI,IP,001,30,12920,12923,6033,3,PERF
42283322250100,PI,IP,001,31,13020,13023,6033,3,PERF
42283322250100,PI,IP,001,32,13120,13126,6033,6,PERF
42283322250100,PI,IP,001,33,13240,13243,6033,3,PERF
42283322250100,PI,IP,001,34,13330,13333,6033,3,PERF
42283322250100,PI,IP,001,35,13430,13436,6033,6,PERF
42283322250100,PI,IP,001,36,13540,13543,6033,3,PERF
42283322250100,PI,IP,001,37,13630,13633,6033,3,PERF
42283322250100,PI,IP,001,38,13750,13756,6033,6,PERF
42283322250100,PI,IP,001,39,13850,13853,6033,3,PERF
42283322250100,PI,IP,001,40,13950,13953,6033,3,PERF
42283322250100,PI,IP,001,41,14050,14056,6033,6,PERF
42283322250100,PI,IP,001,42,14150,14153,6033,3,PERF
42283322250100,PI,IP,001,43,14260,14263,6033,3,PERF
42283322250100,PI,IP,001,44,14360,14366,6033,6,PERF
42283322250100,PI,IP,001,45,14470,14473,6033,3,PERF
42283322250100,PI,IP,001,46,14570,14573,6033,3,PERF
42283322250100,PI,IP,001,47,14670,14676,6033,6,PERF
42283322250100,PI,IP,001,48,14782,14785,6033,3,PERF
42283322250100,PI,IP,001,49,14882,14885,6033,3,PERF
42283322250100,PI,IP,001,50,14982,14988,6033,6,PERF
42283322260000,PI,IP,001,1,11721,17309,6515,5588,PERF
42283322270000,PI,IP,001,1,11504,11506,5313,2,PERF
42283322270000,PI,IP,001,2,11549,11551,5313,2,PERF
42283322270000,PI,IP,001,3,11594,11596,5313,2,PERF
42283322270000,PI,IP,001,4,11639,11641,5313,2,PERF
42283322270000,PI,IP,001,5,11684,11686,5313,2,PERF
42283322270000,PI,IP,001,6,11729,11731,5313,2,PERF
42283322270000,PI,IP,001,7,11819,11821,5313,2,PERF
42283322270000,PI,IP,001,8,11864,11866,5313,2,PERF
42283322270000,PI,IP,001,9,11909,11911,5313,2,PERF
42283322270000,PI,IP,001,10,11954,11956,5313,2,PERF
42283322270000,PI,IP,001,11,11999,12001,5313,2,PERF
42283322270000,PI,IP,001,12,12044,12046,5313,2,PERF
42283322270000,PI,IP,001,13,12134,12136,5313,2,PERF
42283322270000,PI,IP,001,14,12179,12181,5313,2,PERF
42283322270000,PI,IP,001,15,12224,12226,5313,2,PERF
42283322270000,PI,IP,001,16,12269,12271,5313,2,PERF
42283322270000,PI,IP,001,17,12314,12316,5313,2,PERF
42283322270000,PI,IP,001,18,12359,12361,5313,2,PERF
42283322270000,PI,IP,001,19,12449,12451,5313,2,PERF
42283322270000,PI,IP,001,20,12494,12496,5313,2,PERF
42283322270000,PI,IP,001,21,12539,12541,5313,2,PERF
42283322270000,PI,IP,001,22,12584,12586,5313,2,PERF
42283322270000,PI,IP,001,23,12629,12631,5313,2,PERF
42283322270000,PI,IP,001,24,12674,12676,5313,2,PERF
42283322270000,PI,IP,001,25,12764,12766,5313,2,PERF
42283322270000,PI,IP,001,26,12809,12811,5313,2,PERF
42283322270000,PI,IP,001,27,12854,12856,5313,2,PERF
42283322270000,PI,IP,001,28,12899,12901,5313,2,PERF
42283322270000,PI,IP,001,29,12944,12946,5313,2,PERF
42283322270000,PI,IP,001,30,12989,12991,5313,2,PERF
42283322270000,PI,IP,001,31,13078,13081,5313,3,PERF
42283322270000,PI,IP,001,32,13124,13126,5313,2,PERF
42283322270000,PI,IP,001,33,13169,13171,5313,2,PERF
42283322270000,PI,IP,001,34,13214,13216,5313,2,PERF
42283322270000,PI,IP,001,35,13259,13261,5313,2,PERF
42283322270000,PI,IP,001,36,13304,13306,5313,2,PERF
42283322270000,PI,IP,001,37,13394,13396,5313,2,PERF
42283322270000,PI,IP,001,38,13439,13441,5313,2,PERF
42283322270000,PI,IP,001,39,13484,13486,5313,2,PERF
42283322270000,PI,IP,001,40,13529,13531,5313,2,PERF
42283322270000,PI,IP,001,41,13574,13576,5313,2,PERF
42283322270000,PI,IP,001,42,13619,13621,5313,2,PERF
42283322270000,PI,IP,001,43,13709,13711,5313,2,PERF
42283322270000,PI,IP,001,44,13754,13756,5313,2,PERF
42283322270000,PI,IP,001,45,13799,13801,5313,2,PERF
42283322270000,PI,IP,001,46,13844,13846,5313,2,PERF
42283322270000,PI,IP,001,47,13889,13891,5313,2,PERF
42283322270000,PI,IP,001,48,13934,13936,5313,2,PERF
42283322270000,PI,IP,001,49,14024,14026,5313,2,PERF
42283322270000,PI,IP,001,50,14069,14071,5313,2,PERF
42283322270000,PI,IP,001,51,14114,14116,5313,2,PERF
42283322270000,PI,IP,001,52,14159,14161,5313,2,PERF
42283322270000,PI,IP,001,53,14204,14206,5313,2,PERF
42283322270000,PI,IP,001,54,14249,14251,5313,2,PERF
42283322270000,PI,IP,001,55,14339,14341,5313,2,PERF
42283322270000,PI,IP,001,56,14384,14386,5313,2,PERF
42283322270000,PI,IP,001,57,14429,14431,5313,2,PERF
42283322270000,PI,IP,001,58,14474,14476,5313,2,PERF
42283322270000,PI,IP,001,59,14519,14521,5313,2,PERF
42283322270000,PI,IP,001,60,14564,14566,5313,2,PERF
42283322270000,PI,IP,001,61,14654,14656,5313,2,PERF
42283322270000,PI,IP,001,62,14699,14701,5313,2,PERF
42283322270000,PI,IP,001,63,14744,14746,5313,2,PERF
42283322270000,PI,IP,001,64,14789,14791,5313,2,PERF
42283322270000,PI,IP,001,65,14834,14836,5313,2,PERF
42283322270000,PI,IP,001,66,14879,14881,5313,2,PERF
42283322270000,PI,IP,001,67,14969,14971,5313,2,PERF
42283322270000,PI,IP,001,68,15014,15016,5313,2,PERF
42283322270000,PI,IP,001,69,15059,15061,5313,2,PERF
42283322270000,PI,IP,001,70,15104,15106,5313,2,PERF
42283322270000,PI,IP,001,71,15149,15151,5313,2,PERF
42283322270000,PI,IP,001,72,15194,15196,5313,2,PERF
42283322270000,PI,IP,001,73,15284,15286,5313,2,PERF
42283322270000,PI,IP,001,74,15329,15331,5313,2,PERF
42283322270000,PI,IP,001,75,15374,15376,5313,2,PERF
42283322270000,PI,IP,001,76,15419,15421,5313,2,PERF
42283322270000,PI,IP,001,77,15464,15466,5313,2,PERF
42283322270000,PI,IP,001,78,15509,15511,5313,2,PERF
42283322270000,PI,IP,001,79,15599,15601,5313,2,PERF
42283322270000,PI,IP,001,80,15644,15646,5313,2,PERF
42283322270000,PI,IP,001,81,15689,15691,5313,2,PERF
42283322270000,PI,IP,001,82,15734,15736,5313,2,PERF
42283322270000,PI,IP,001,83,15779,15781,5313,2,PERF
42283322270000,PI,IP,001,84,15824,15826,5313,2,PERF
42283322270000,PI,IP,001,85,15914,15916,5313,2,PERF
42283322270000,PI,IP,001,86,15959,15961,5313,2,PERF
42283322270000,PI,IP,001,87,16004,16006,5313,2,PERF
42283322270000,PI,IP,001,88,16049,16051,5313,2,PERF
42283322270000,PI,IP,001,89,16094,16096,5313,2,PERF
42283322270000,PI,IP,001,90,16139,16141,5313,2,PERF
42283322280000,PI,IP,001,1,10752,15095,4796,4343,PERF
42283322290000,PI,IP,001,1,12068,17730,6482,5662,PERF
42283322310000,PI,IP,001,1,11666,17637,6413,5971,PERF
42283322320000,PI,IP,001,1,11090,16071,5906,4981,PERF
42283322330000,PI,IP,001,1,9630,9636,5724,6,PERF
42283322330000,PI,IP,001,2,9820,9826,5724,6,PERF
42283322330000,PI,IP,001,3,10042,10046,5724,4,PERF
42283322330000,PI,IP,001,4,10260,10266,5724,6,PERF
42283322330000,PI,IP,001,5,10460,10466,5724,6,PERF
42283322330000,PI,IP,001,6,10684,10690,5724,6,PERF
42283322330000,PI,IP,001,7,10898,10904,5724,6,PERF
42283322330000,PI,IP,001,8,11120,11126,5724,6,PERF
42283322330000,PI,IP,001,9,11310,11316,5724,6,PERF
42283322330000,PI,IP,001,10,11530,11536,5724,6,PERF
42283322330000,PI,IP,001,11,11754,11760,5724,6,PERF
42283322330000,PI,IP,001,12,11968,11974,5724,6,PERF
42283322330000,PI,IP,001,13,12190,12196,5724,6,PERF
42283322330000,PI,IP,001,14,12390,12396,5724,6,PERF
42283322330000,PI,IP,001,15,12610,12616,5724,6,PERF
42283322330000,PI,IP,001,16,12824,12830,5724,6,PERF
42283322330000,PI,IP,001,17,13026,13032,5724,6,PERF
42283322330000,PI,IP,001,18,13248,13254,5724,6,PERF
42283322330000,PI,IP,001,19,13466,13472,5724,6,PERF
42283322330000,PI,IP,001,20,13686,13692,5724,6,PERF
42283322330000,PI,IP,001,21,13884,13890,5724,6,PERF
42283322330000,PI,IP,001,22,14108,14114,5724,6,PERF
42283322330000,PI,IP,001,23,14322,14328,5724,6,PERF
42283322330000,PI,IP,001,24,14536,14542,5724,6,PERF
42283322330000,PI,IP,001,25,14750,14756,5724,6,PERF
42283322340000,PI,IP,002,1,10061,10063,4680,2,PERF
42283322340000,PI,IP,002,2,10116,10118,4680,2,PERF
42283322340000,PI,IP,002,3,10171,10173,4680,2,PERF
42283322340000,PI,IP,002,4,10226,10228,4680,2,PERF
42283322340000,PI,IP,002,5,10281,10283,4680,2,PERF
42283322340000,PI,IP,002,6,10336,10338,4680,2,PERF
42283322340000,PI,IP,002,7,10417,10420,4680,3,PERF
42283322340000,PI,IP,002,8,10485,10488,4680,3,PERF
42283322340000,PI,IP,002,9,10553,10556,4680,3,PERF
42283322340000,PI,IP,002,10,10621,10624,4680,3,PERF
42283322340000,PI,IP,002,11,10702,10705,4680,3,PERF
42283322340000,PI,IP,002,12,10770,10773,4680,3,PERF
42283322340000,PI,IP,002,13,10838,10841,4680,3,PERF
42283322340000,PI,IP,002,14,10906,10909,4680,3,PERF
42283322340000,PI,IP,002,15,10987,10990,4680,3,PERF
42283322340000,PI,IP,002,16,11055,11058,4680,3,PERF
42283322340000,PI,IP,002,17,11123,11126,4680,3,PERF
42283322340000,PI,IP,002,18,11191,11194,4680,3,PERF
42283322340000,PI,IP,002,19,11272,11275,4680,3,PERF
42283322340000,PI,IP,002,20,11340,11343,4680,3,PERF
42283322340000,PI,IP,002,21,11408,11411,4680,3,PERF
42283322340000,PI,IP,002,22,11476,11479,4680,3,PERF
42283322340000,PI,IP,002,23,11557,11560,4680,3,PERF
42283322340000,PI,IP,002,24,11625,11628,4680,3,PERF
42283322340000,PI,IP,002,25,11693,11696,4680,3,PERF
42283322340000,PI,IP,002,26,11761,11764,4680,3,PERF
42283322340000,PI,IP,002,27,11842,11845,4680,3,PERF
42283322340000,PI,IP,002,28,11910,11913,4680,3,PERF
42283322340000,PI,IP,002,29,11978,11981,4680,3,PERF
42283322340000,PI,IP,002,30,12046,12049,4680,3,PERF
42283322340000,PI,IP,002,31,12127,12130,4680,3,PERF
42283322340000,PI,IP,002,32,12195,12198,4680,3,PERF
42283322340000,PI,IP,002,33,12263,12266,4680,3,PERF
42283322340000,PI,IP,002,34,12331,12334,4680,3,PERF
42283322340000,PI,IP,002,35,12412,12415,4680,3,PERF
42283322340000,PI,IP,002,36,12480,12483,4680,3,PERF
42283322340000,PI,IP,002,37,12548,12551,4680,3,PERF
42283322340000,PI,IP,002,38,12616,12619,4680,3,PERF
42283322340000,PI,IP,002,39,12697,12700,4680,3,PERF
42283322340000,PI,IP,002,40,12765,12768,4680,3,PERF
42283322340000,PI,IP,002,41,12833,12836,4680,3,PERF
42283322340000,PI,IP,002,42,12901,12904,4680,3,PERF
42283322340000,PI,IP,002,43,12982,12985,4680,3,PERF
42283322340000,PI,IP,002,44,13050,13053,4680,3,PERF
42283322340000,PI,IP,002,45,13118,13121,4680,3,PERF
42283322340000,PI,IP,002,46,13186,13189,4680,3,PERF
42283322340000,PI,IP,002,47,13267,13270,4680,3,PERF
42283322340000,PI,IP,002,48,13335,13338,4680,3,PERF
42283322340000,PI,IP,002,49,13403,13406,4680,3,PERF
42283322340000,PI,IP,002,50,13471,13474,4680,3,PERF
42283322340000,PI,IP,002,51,13552,13555,4680,3,PERF
42283322340000,PI,IP,002,52,13620,13620,4680,0,PERF
42283322340000,PI,IP,002,53,13688,13691,4680,3,PERF
42283322340000,PI,IP,002,54,13756,13759,4680,3,PERF
42283322340000,PI,IP,002,55,13837,13840,4680,3,PERF
42283322340000,PI,IP,002,56,13905,13908,4680,3,PERF
42283322340000,PI,IP,002,57,13973,13976,4680,3,PERF
42283322340000,PI,IP,002,58,14041,14044,4680,3,PERF
42283322350000,PI,IP,001,1,12458,12460,5743,2,PERF
42283322350000,PI,IP,001,2,12540,12542,5743,2,PERF
42283322350000,PI,IP,001,3,12615,12617,5743,2,PERF
42283322350000,PI,IP,001,4,12687,12690,5743,3,PERF
42283322350000,PI,IP,001,5,12775,12777,5743,2,PERF
42283322350000,PI,IP,001,6,12850,12852,5743,2,PERF
42283322350000,PI,IP,001,7,12933,12935,5743,2,PERF
42283322350000,PI,IP,001,8,13000,13003,5743,3,PERF
42283322350000,PI,IP,001,9,13085,13087,5743,2,PERF
42283322350000,PI,IP,001,10,13160,13162,5743,2,PERF
42283322350000,PI,IP,001,11,13235,13237,5743,2,PERF
42283322350000,PI,IP,001,12,13310,13313,5743,3,PERF
42283322350000,PI,IP,001,13,13395,13397,5743,2,PERF
42283322350000,PI,IP,001,14,13470,13472,5743,2,PERF
42283322350000,PI,IP,001,15,13545,13547,5743,2,PERF
42283322350000,PI,IP,001,16,13620,13623,5743,3,PERF
42283322350000,PI,IP,001,17,13700,13702,5743,2,PERF
42283322350000,PI,IP,001,18,13780,13782,5743,2,PERF
42283322350000,PI,IP,001,19,13855,13857,5743,2,PERF
42283322350000,PI,IP,001,20,13930,13933,5743,3,PERF
42283322350000,PI,IP,001,21,14015,14017,5743,2,PERF
42283322350000,PI,IP,001,22,14090,14092,5743,2,PERF
42283322350000,PI,IP,001,23,14160,14162,5743,2,PERF
42283322350000,PI,IP,001,24,14240,14243,5743,3,PERF
42283322350000,PI,IP,001,25,14325,14327,5743,2,PERF
42283322350000,PI,IP,001,26,14440,14442,5743,2,PERF
42283322350000,PI,IP,001,27,14475,14477,5743,2,PERF
42283322350000,PI,IP,001,28,14550,14553,5743,3,PERF
42283322350000,PI,IP,001,29,14742,14748,5743,6,PERF
42283322370000,PI,IP,001,1,11436,15972,5428,4536,PERF
42283322380000,PI,IP,001,1,11251,16222,5112,4971,PERF
42283322390000,PI,IP,001,1,11574,16391,5396,4817,PERF
42283322400000,PI,IP,001,1,11046,17262,6523,6216,PERF
42283322410000,PI,IP,001,1,9616,9619,5097,3,PERF
42283322410000,PI,IP,001,2,9716,9719,5097,3,PERF
42283322410000,PI,IP,001,3,9816,9822,5097,6,PERF
42283322410000,PI,IP,001,4,9926,9929,5097,3,PERF
42283322410000,PI,IP,001,5,10020,10023,5097,3,PERF
42283322410000,PI,IP,001,6,10126,10132,5097,6,PERF
42283322410000,PI,IP,001,7,10236,10239,5097,3,PERF
42283322410000,PI,IP,001,8,10336,10339,5097,3,PERF
42283322410000,PI,IP,001,9,10434,10440,5097,6,PERF
42283322410000,PI,IP,001,10,10546,10549,5097,3,PERF
42283322410000,PI,IP,001,11,10646,10649,5097,3,PERF
42283322410000,PI,IP,001,12,10746,10752,5097,6,PERF
42283322410000,PI,IP,001,13,10856,10859,5097,3,PERF
42283322410000,PI,IP,001,14,10956,10959,5097,3,PERF
42283322410000,PI,IP,001,15,11056,11062,5097,6,PERF
42283322410000,PI,IP,001,16,11166,11169,5097,3,PERF
42283322410000,PI,IP,001,17,11268,11271,5097,3,PERF
42283322410000,PI,IP,001,18,11366,11372,5097,6,PERF
42283322410000,PI,IP,001,19,11476,11479,5097,3,PERF
42283322410000,PI,IP,001,20,11576,11579,5097,3,PERF
42283322410000,PI,IP,001,21,11676,11682,5097,6,PERF
42283322410000,PI,IP,001,22,11786,11789,5097,3,PERF
42283322410000,PI,IP,001,23,11886,11889,5097,3,PERF
42283322410000,PI,IP,001,24,11980,11986,5097,6,PERF
42283322410000,PI,IP,001,25,12096,12099,5097,3,PERF
42283322410000,PI,IP,001,26,12196,12199,5097,3,PERF
42283322410000,PI,IP,001,27,12296,12302,5097,6,PERF
42283322410000,PI,IP,001,28,12406,12409,5097,3,PERF
42283322410000,PI,IP,001,29,12506,12509,5097,3,PERF
42283322410000,PI,IP,001,30,12606,12612,5097,6,PERF
42283322410000,PI,IP,001,31,12716,12719,5097,3,PERF
42283322410000,PI,IP,001,32,12816,12819,5097,3,PERF
42283322410000,PI,IP,001,33,12916,12922,5097,6,PERF
42283322410000,PI,IP,001,34,13020,13023,5097,3,PERF
42283322410000,PI,IP,001,35,13126,13129,5097,3,PERF
42283322410000,PI,IP,001,36,13226,13232,5097,6,PERF
42283322410000,PI,IP,001,37,13336,13339,5097,3,PERF
42283322410000,PI,IP,001,38,13436,13439,5097,3,PERF
42283322410000,PI,IP,001,39,13536,13542,5097,6,PERF
42283322410000,PI,IP,001,40,13646,13649,5097,3,PERF
42283322410000,PI,IP,001,41,13746,13749,5097,3,PERF
42283322410000,PI,IP,001,42,13846,13852,5097,6,PERF
42283322410000,PI,IP,001,43,13956,13959,5097,3,PERF
42283322410000,PI,IP,001,44,14056,14062,5097,6,PERF
42283322430000,PI,IP,001,1,11220,11222,4990,2,PERF
42283322430000,PI,IP,001,2,11265,11267,4990,2,PERF
42283322430000,PI,IP,001,3,11310,11312,4990,2,PERF
42283322430000,PI,IP,001,4,11355,11357,4990,2,PERF
42283322430000,PI,IP,001,5,11400,11402,4990,2,PERF
42283322430000,PI,IP,001,6,11445,11447,4990,2,PERF
42283322430000,PI,IP,001,7,11530,11532,4990,2,PERF
42283322430000,PI,IP,001,8,11575,11577,4990,2,PERF
42283322430000,PI,IP,001,9,11620,11622,4990,2,PERF
42283322430000,PI,IP,001,10,11665,11667,4990,2,PERF
42283322430000,PI,IP,001,11,11710,11712,4990,2,PERF
42283322430000,PI,IP,001,12,11755,11757,4990,2,PERF
42283322430000,PI,IP,001,13,11840,11842,4990,2,PERF
42283322430000,PI,IP,001,14,11885,11887,4990,2,PERF
42283322430000,PI,IP,001,15,11930,11932,4990,2,PERF
42283322430000,PI,IP,001,16,11975,11977,4990,2,PERF
42283322430000,PI,IP,001,17,12020,12022,4990,2,PERF
42283322430000,PI,IP,001,18,12065,12067,4990,2,PERF
42283322430000,PI,IP,001,19,12150,12152,4990,2,PERF
42283322430000,PI,IP,001,20,12195,12197,4990,2,PERF
42283322430000,PI,IP,001,21,12240,12242,4990,2,PERF
42283322430000,PI,IP,001,22,12285,12287,4990,2,PERF
42283322430000,PI,IP,001,23,12330,12332,4990,2,PERF
42283322430000,PI,IP,001,24,12375,12377,4990,2,PERF
42283322430000,PI,IP,001,25,12460,12462,4990,2,PERF
42283322430000,PI,IP,001,26,12505,12507,4990,2,PERF
42283322430000,PI,IP,001,27,12550,12552,4990,2,PERF
42283322430000,PI,IP,001,28,12595,12597,4990,2,PERF
42283322430000,PI,IP,001,29,12640,12642,4990,2,PERF
42283322430000,PI,IP,001,30,12685,12687,4990,2,PERF
42283322430000,PI,IP,001,31,12770,12772,4990,2,PERF
42283322430000,PI,IP,001,32,12815,12817,4990,2,PERF
42283322430000,PI,IP,001,33,12860,12862,4990,2,PERF
42283322430000,PI,IP,001,34,12905,12907,4990,2,PERF
42283322430000,PI,IP,001,35,12950,12952,4990,2,PERF
42283322430000,PI,IP,001,36,12995,12997,4990,2,PERF
42283322430000,PI,IP,001,37,13080,13082,4990,2,PERF
42283322430000,PI,IP,001,38,13125,13127,4990,2,PERF
42283322430000,PI,IP,001,39,13170,13172,4990,2,PERF
42283322430000,PI,IP,001,40,13215,13217,4990,2,PERF
42283322430000,PI,IP,001,41,13260,13262,4990,2,PERF
42283322430000,PI,IP,001,42,13305,13307,4990,2,PERF
42283322430000,PI,IP,001,43,13390,13392,4990,2,PERF
42283322430000,PI,IP,001,44,13435,13437,4990,2,PERF
42283322430000,PI,IP,001,45,13480,13482,4990,2,PERF
42283322430000,PI,IP,001,46,13525,13527,4990,2,PERF
42283322430000,PI,IP,001,47,13570,13572,4990,2,PERF
42283322430000,PI,IP,001,48,13615,13617,4990,2,PERF
42283322430000,PI,IP,001,49,13700,13702,4990,2,PERF
42283322430000,PI,IP,001,50,13745,13747,4990,2,PERF
42283322430000,PI,IP,001,51,13790,13792,4990,2,PERF
42283322430000,PI,IP,001,52,13835,13837,4990,2,PERF
42283322430000,PI,IP,001,53,13880,13882,4990,2,PERF
42283322430000,PI,IP,001,54,13925,13927,4990,2,PERF
42283322430000,PI,IP,001,55,14010,14012,4990,2,PERF
42283322430000,PI,IP,001,56,14055,14057,4990,2,PERF
42283322430000,PI,IP,001,57,14100,14102,4990,2,PERF
42283322430000,PI,IP,001,58,14145,14147,4990,2,PERF
42283322430000,PI,IP,001,59,14190,14192,4990,2,PERF
42283322430000,PI,IP,001,60,14235,14237,4990,2,PERF
42283322430000,PI,IP,001,61,14320,14322,4990,2,PERF
42283322430000,PI,IP,001,62,14365,14367,4990,2,PERF
42283322430000,PI,IP,001,63,14410,14412,4990,2,PERF
42283322430000,PI,IP,001,64,14455,14457,4990,2,PERF
42283322430000,PI,IP,001,65,14500,14502,4990,2,PERF
42283322430000,PI,IP,001,66,14545,14547,4990,2,PERF
42283322430000,PI,IP,001,67,14630,14632,4990,2,PERF
42283322430000,PI,IP,001,68,14675,14677,4990,2,PERF
42283322430000,PI,IP,001,69,14720,14722,4990,2,PERF
42283322430000,PI,IP,001,70,14765,14767,4990,2,PERF
42283322430000,PI,IP,001,71,14810,14812,4990,2,PERF
42283322430000,PI,IP,001,72,14855,14857,4990,2,PERF
42283322430000,PI,IP,001,73,14940,14942,4990,2,PERF
42283322430000,PI,IP,001,74,14985,14987,4990,2,PERF
42283322430000,PI,IP,001,75,15030,15032,4990,2,PERF
42283322430000,PI,IP,001,76,15075,15077,4990,2,PERF
42283322430000,PI,IP,001,77,15120,15122,4990,2,PERF
42283322430000,PI,IP,001,78,15165,15167,4990,2,PERF
42283322440000,PI,IP,001,1,12670,12672,4971,2,PERF
42283322440000,PI,IP,001,2,12730,12732,4971,2,PERF
42283322440000,PI,IP,001,3,12789,12791,4971,2,PERF
42283322440000,PI,IP,001,4,12848,12850,4971,2,PERF
42283322440000,PI,IP,001,5,12890,12892,4971,2,PERF
42283322440000,PI,IP,001,6,12986,12988,4971,2,PERF
42283322440000,PI,IP,001,7,13082,13084,4971,2,PERF
42283322440000,PI,IP,001,8,13178,13180,4971,2,PERF
42283322440000,PI,IP,001,9,13361,13363,4971,2,PERF
42283322440000,PI,IP,001,10,13460,13462,4971,2,PERF
42283322440000,PI,IP,001,11,13559,13561,4971,2,PERF
42283322440000,PI,IP,001,12,13658,13660,4971,2,PERF
42283322440000,PI,IP,001,13,13735,13737,4971,2,PERF
42283322440000,PI,IP,001,14,13841,13843,4971,2,PERF
42283322440000,PI,IP,001,15,13947,13949,4971,2,PERF
42283322440000,PI,IP,001,16,14053,14055,4971,2,PERF
42283322440000,PI,IP,001,17,14143,14145,4971,2,PERF
42283322440000,PI,IP,001,18,14237,14239,4971,2,PERF
42283322440000,PI,IP,001,19,14331,14333,4971,2,PERF
42283322440000,PI,IP,001,20,14425,14427,4971,2,PERF
42283322440000,PI,IP,001,21,14515,14517,4971,2,PERF
42283322440000,PI,IP,001,22,14621,14623,4971,2,PERF
42283322440000,PI,IP,001,23,14727,14729,4971,2,PERF
42283322440000,PI,IP,001,24,14833,14835,4971,2,PERF
42283322440000,PI,IP,001,25,14910,14912,4971,2,PERF
42283322440000,PI,IP,001,26,14986,14988,4971,2,PERF
42283322440000,PI,IP,001,27,15062,15064,4971,2,PERF
42283322440000,PI,IP,001,28,15138,15140,4971,2,PERF
42283322440000,PI,IP,001,29,15202,15204,4971,2,PERF
42283322440000,PI,IP,001,30,15294,15296,4971,2,PERF
42283322440000,PI,IP,001,31,15386,15388,4971,2,PERF
42283322440000,PI,IP,001,32,15478,15480,4971,2,PERF
42283322440000,PI,IP,001,33,15540,15542,4971,2,PERF
42283322440000,PI,IP,001,34,15629,15631,4971,2,PERF
42283322440000,PI,IP,001,35,15718,15720,4971,2,PERF
42283322440000,PI,IP,001,36,15780,15782,4971,2,PERF
42283322440000,PI,IP,001,37,15849,15851,4971,2,PERF
42283322440000,PI,IP,001,38,15918,15920,4971,2,PERF
42283322440000,PI,IP,001,39,15979,15981,4971,2,PERF
42283322440000,PI,IP,001,40,16062,16064,4971,2,PERF
42283322440000,PI,IP,001,41,16145,16147,4971,2,PERF
42283322440000,PI,IP,001,42,16228,16230,4971,2,PERF
42283322440000,PI,IP,001,43,16305,16307,4971,2,PERF
42283322440000,PI,IP,001,44,16411,16413,4971,2,PERF
42283322440000,PI,IP,001,45,16517,16519,4971,2,PERF
42283322440000,PI,IP,001,46,16623,16625,4971,2,PERF
42283322440000,PI,IP,001,47,16702,16704,4971,2,PERF
42283322440000,PI,IP,001,48,16804,16806,4971,2,PERF
42283322440000,PI,IP,001,49,16906,16908,4971,2,PERF
42283322440000,PI,IP,001,50,17008,17010,4971,2,PERF
42283322440000,PI,IP,001,51,17132,17134,4971,2,PERF
42283322440000,PI,IP,001,52,17195,17197,4971,2,PERF
42283322440000,PI,IP,001,53,17258,17260,4971,2,PERF
42283322440000,PI,IP,001,54,17321,17323,4971,2,PERF
42283322470100,PI,IP,001,1,10564,10566,4727,2,PERF
42283322470100,PI,IP,001,2,10609,10611,4727,2,PERF
42283322470100,PI,IP,001,3,10654,10656,4727,2,PERF
42283322470100,PI,IP,001,4,10699,10701,4727,2,PERF
42283322470100,PI,IP,001,5,10744,10746,4727,2,PERF
42283322470100,PI,IP,001,6,10789,10791,4727,2,PERF
42283322470100,PI,IP,001,7,10874,10876,4727,2,PERF
42283322470100,PI,IP,001,8,10919,10921,4727,2,PERF
42283322470100,PI,IP,001,9,10964,10966,4727,2,PERF
42283322470100,PI,IP,001,10,11009,11011,4727,2,PERF
42283322470100,PI,IP,001,11,11054,11056,4727,2,PERF
42283322470100,PI,IP,001,12,11099,11101,4727,2,PERF
42283322470100,PI,IP,001,13,11184,11186,4727,2,PERF
42283322470100,PI,IP,001,14,11229,11231,4727,2,PERF
42283322470100,PI,IP,001,15,11274,11276,4727,2,PERF
42283322470100,PI,IP,001,16,11319,11321,4727,2,PERF
42283322470100,PI,IP,001,17,11364,11366,4727,2,PERF
42283322470100,PI,IP,001,18,11409,11411,4727,2,PERF
42283322470100,PI,IP,001,19,11494,11496,4727,2,PERF
42283322470100,PI,IP,001,20,11539,11541,4727,2,PERF
42283322470100,PI,IP,001,21,11584,11586,4727,2,PERF
42283322470100,PI,IP,001,22,11629,11631,4727,2,PERF
42283322470100,PI,IP,001,23,11674,11676,4727,2,PERF
42283322470100,PI,IP,001,24,11719,11721,4727,2,PERF
42283322470100,PI,IP,001,25,11804,11806,4727,2,PERF
42283322470100,PI,IP,001,26,11849,11851,4727,2,PERF
42283322470100,PI,IP,001,27,11894,11896,4727,2,PERF
42283322470100,PI,IP,001,28,11939,11941,4727,2,PERF
42283322470100,PI,IP,001,29,11984,11986,4727,2,PERF
42283322470100,PI,IP,001,30,12029,12031,4727,2,PERF
42283322470100,PI,IP,001,31,12114,12116,4727,2,PERF
42283322470100,PI,IP,001,32,12159,12161,4727,2,PERF
42283322470100,PI,IP,001,33,12204,12206,4727,2,PERF
42283322470100,PI,IP,001,34,12249,12251,4727,2,PERF
42283322470100,PI,IP,001,35,12294,12296,4727,2,PERF
42283322470100,PI,IP,001,36,12339,12341,4727,2,PERF
42283322470100,PI,IP,001,37,12424,12426,4727,2,PERF
42283322470100,PI,IP,001,38,12469,12471,4727,2,PERF
42283322470100,PI,IP,001,39,12514,12516,4727,2,PERF
42283322470100,PI,IP,001,40,12559,12561,4727,2,PERF
42283322470100,PI,IP,001,41,12604,12606,4727,2,PERF
42283322470100,PI,IP,001,42,12649,12651,4727,2,PERF
42283322470100,PI,IP,001,43,12734,12736,4727,2,PERF
42283322470100,PI,IP,001,44,12779,12781,4727,2,PERF
42283322470100,PI,IP,001,45,12824,12826,4727,2,PERF
42283322470100,PI,IP,001,46,12869,12871,4727,2,PERF
42283322470100,PI,IP,001,47,12914,12916,4727,2,PERF
42283322470100,PI,IP,001,48,12959,12961,4727,2,PERF
42283322470100,PI,IP,001,49,13044,13046,4727,2,PERF
42283322470100,PI,IP,001,50,13089,13091,4727,2,PERF
42283322470100,PI,IP,001,51,13134,13136,4727,2,PERF
42283322470100,PI,IP,001,52,13179,13181,4727,2,PERF
42283322470100,PI,IP,001,53,13224,13226,4727,2,PERF
42283322470100,PI,IP,001,54,13269,13271,4727,2,PERF
42283322470100,PI,IP,001,55,13354,13356,4727,2,PERF
42283322470100,PI,IP,001,56,13399,13401,4727,2,PERF
42283322470100,PI,IP,001,57,13444,13446,4727,2,PERF
42283322470100,PI,IP,001,58,13489,13491,4727,2,PERF
42283322470100,PI,IP,001,59,13534,13536,4727,2,PERF
42283322470100,PI,IP,001,60,13579,13581,4727,2,PERF
42283322470100,PI,IP,001,61,13664,13666,4727,2,PERF
42283322470100,PI,IP,001,62,13709,13711,4727,2,PERF
42283322470100,PI,IP,001,63,13754,13756,4727,2,PERF
42283322470100,PI,IP,001,64,13799,13801,4727,2,PERF
42283322470100,PI,IP,001,65,13844,13846,4727,2,PERF
42283322470100,PI,IP,001,66,13889,13891,4727,2,PERF
42283322470100,PI,IP,001,67,13974,13976,4727,2,PERF
42283322470100,PI,IP,001,68,14019,14021,4727,2,PERF
42283322470100,PI,IP,001,69,14064,14066,4727,2,PERF
42283322470100,PI,IP,001,70,14109,14111,4727,2,PERF
42283322470100,PI,IP,001,71,14154,14156,4727,2,PERF
42283322470100,PI,IP,001,72,14199,14201,4727,2,PERF
42283322470100,PI,IP,001,73,14284,14286,4727,2,PERF
42283322470100,PI,IP,001,74,14329,14331,4727,2,PERF
42283322470100,PI,IP,001,75,14374,14376,4727,2,PERF
42283322470100,PI,IP,001,76,14419,14421,4727,2,PERF
42283322470100,PI,IP,001,77,14464,14466,4727,2,PERF
42283322470100,PI,IP,001,78,14509,14511,4727,2,PERF
42283322470100,PI,IP,001,79,14594,14596,4727,2,PERF
42283322470100,PI,IP,001,80,14639,14641,4727,2,PERF
42283322470100,PI,IP,001,81,14684,14686,4727,2,PERF
42283322470100,PI,IP,001,82,14729,14731,4727,2,PERF
42283322470100,PI,IP,001,83,14774,14776,4727,2,PERF
42283322470100,PI,IP,001,84,14819,14821,4727,2,PERF
42283322480000,PI,IP,001,1,11617,16943,6126,5326,PERF
42283322490000,PI,IP,001,1,11453,16859,6028,5406,PERF
42283322500100,PI,IP,001,1,12000,12250,5844,250,PERF
42283322500100,PI,IP,001,2,12300,12550,5844,250,PERF
42283322500100,PI,IP,001,3,12600,12850,5844,250,PERF
42283322500100,PI,IP,001,4,12900,13150,5844,250,PERF
42283322500100,PI,IP,001,5,13200,13450,5844,250,PERF
42283322500100,PI,IP,001,6,13500,13750,5844,250,PERF
42283322500100,PI,IP,001,7,13800,14050,5844,250,PERF
42283322500100,PI,IP,001,8,14100,14350,5844,250,PERF
42283322500100,PI,IP,001,9,14400,14650,5844,250,PERF
42283322500100,PI,IP,001,10,14700,14950,5844,250,PERF
42283322500100,PI,IP,001,11,15000,15250,5844,250,PERF
42283322500100,PI,IP,001,12,15300,15550,5844,250,PERF
42283322500100,PI,IP,001,13,15600,15850,5844,250,PERF
42283322500100,PI,IP,001,14,15900,16150,5844,250,PERF
42283322500100,PI,IP,001,15,16200,16450,5844,250,PERF
42283322500100,PI,IP,001,16,16500,16750,5844,250,PERF
42283322510000,PI,IP,001,1,12892,12895,4778,3,PERF
42283322510000,PI,IP,001,2,12932,12935,4778,3,PERF
42283322510000,PI,IP,001,3,12972,12975,4778,3,PERF
42283322510000,PI,IP,001,4,13012,13015,4778,3,PERF
42283322510000,PI,IP,001,5,13052,13055,4778,3,PERF
42283322510000,PI,IP,001,6,13092,13095,4778,3,PERF
42283322510000,PI,IP,001,7,13171,13174,4778,3,PERF
42283322510000,PI,IP,001,8,13211,13214,4778,3,PERF
42283322510000,PI,IP,001,9,13251,13254,4778,3,PERF
42283322510000,PI,IP,001,10,13291,13294,4778,3,PERF
42283322510000,PI,IP,001,11,13331,13334,4778,3,PERF
42283322510000,PI,IP,001,12,13371,13374,4778,3,PERF
42283322510000,PI,IP,001,13,13450,13453,4778,3,PERF
42283322510000,PI,IP,001,14,13490,13493,4778,3,PERF
42283322510000,PI,IP,001,15,13530,13533,4778,3,PERF
42283322510000,PI,IP,001,16,13570,13573,4778,3,PERF
42283322510000,PI,IP,001,17,13610,13613,4778,3,PERF
42283322510000,PI,IP,001,18,13650,13653,4778,3,PERF
42283322510000,PI,IP,001,19,13729,13732,4778,3,PERF
42283322510000,PI,IP,001,20,13769,13772,4778,3,PERF
42283322510000,PI,IP,001,21,13809,13812,4778,3,PERF
42283322510000,PI,IP,001,22,13849,13852,4778,3,PERF
42283322510000,PI,IP,001,23,13889,13892,4778,3,PERF
42283322510000,PI,IP,001,24,13929,13932,4778,3,PERF
42283322510000,PI,IP,001,25,14001,14004,4778,3,PERF
42283322510000,PI,IP,001,26,14048,14051,4778,3,PERF
42283322510000,PI,IP,001,27,14088,14091,4778,3,PERF
42283322510000,PI,IP,001,28,14128,14131,4778,3,PERF
42283322510000,PI,IP,001,29,14168,14171,4778,3,PERF
42283322510000,PI,IP,001,30,14208,14211,4778,3,PERF
42283322510000,PI,IP,001,31,14287,14290,4778,3,PERF
42283322510000,PI,IP,001,32,14327,14330,4778,3,PERF
42283322510000,PI,IP,001,33,14367,14370,4778,3,PERF
42283322510000,PI,IP,001,34,14407,14410,4778,3,PERF
42283322510000,PI,IP,001,35,14447,14450,4778,3,PERF
42283322510000,PI,IP,001,36,14487,14490,4778,3,PERF
42283322510000,PI,IP,001,37,14566,14569,4778,3,PERF
42283322510000,PI,IP,001,38,14606,14609,4778,3,PERF
42283322510000,PI,IP,001,39,14646,14649,4778,3,PERF
42283322510000,PI,IP,001,40,14686,14689,4778,3,PERF
42283322510000,PI,IP,001,41,14726,14729,4778,3,PERF
42283322510000,PI,IP,001,42,14766,14769,4778,3,PERF
42283322510000,PI,IP,001,43,14845,14848,4778,3,PERF
42283322510000,PI,IP,001,44,14885,14888,4778,3,PERF
42283322510000,PI,IP,001,45,14926,14929,4778,3,PERF
42283322510000,PI,IP,001,46,14967,14970,4778,3,PERF
42283322510000,PI,IP,001,47,15000,15003,4778,3,PERF
42283322510000,PI,IP,001,48,15050,15053,4778,3,PERF
42283322510000,PI,IP,001,49,15124,15127,4778,3,PERF
42283322510000,PI,IP,001,50,15164,15167,4778,3,PERF
42283322510000,PI,IP,001,51,15204,15207,4778,3,PERF
42283322510000,PI,IP,001,52,15244,15247,4778,3,PERF
42283322510000,PI,IP,001,53,15284,15287,4778,3,PERF
42283322510000,PI,IP,001,54,15324,15327,4778,3,PERF
42283322510000,PI,IP,001,55,15403,15406,4778,3,PERF
42283322510000,PI,IP,001,56,15443,15446,4778,3,PERF
42283322510000,PI,IP,001,57,15483,15486,4778,3,PERF
42283322510000,PI,IP,001,58,15523,15526,4778,3,PERF
42283322510000,PI,IP,001,59,15563,15566,4778,3,PERF
42283322510000,PI,IP,001,60,15603,15606,4778,3,PERF
42283322510000,PI,IP,001,61,15682,15685,4778,3,PERF
42283322510000,PI,IP,001,62,15722,15725,4778,3,PERF
42283322510000,PI,IP,001,63,15762,15765,4778,3,PERF
42283322510000,PI,IP,001,64,15797,15800,4778,3,PERF
42283322510000,PI,IP,001,65,15837,15840,4778,3,PERF
42283322510000,PI,IP,001,66,15879,15882,4778,3,PERF
42283322510000,PI,IP,001,67,15961,15964,4778,3,PERF
42283322510000,PI,IP,001,68,16001,16004,4778,3,PERF
42283322510000,PI,IP,001,69,16041,16044,4778,3,PERF
42283322510000,PI,IP,001,70,16081,16084,4778,3,PERF
42283322510000,PI,IP,001,71,16121,16124,4778,3,PERF
42283322510000,PI,IP,001,72,16161,16164,4778,3,PERF
42283322510000,PI,IP,001,73,16240,16243,4778,3,PERF
42283322510000,PI,IP,001,74,16271,16274,4778,3,PERF
42283322510000,PI,IP,001,75,16303,16306,4778,3,PERF
42283322510000,PI,IP,001,76,16335,16338,4778,3,PERF
42283322510000,PI,IP,001,77,16366,16369,4778,3,PERF
42283322510000,PI,IP,001,78,16398,16401,4778,3,PERF
42283322510000,PI,IP,001,79,16519,16522,4778,3,PERF
42283322510000,PI,IP,001,80,16559,16562,4778,3,PERF
42283322510000,PI,IP,001,81,16599,16602,4778,3,PERF
42283322510000,PI,IP,001,82,16639,16642,4778,3,PERF
42283322510000,PI,IP,001,83,16679,16682,4778,3,PERF
42283322510000,PI,IP,001,84,16719,16722,4778,3,PERF
42283322520000,PI,IP,001,1,13289,15818,3615,2529,PERF
42283322540000,PI,IP,001,1,11299,11301,5894,2,PERF
42283322540000,PI,IP,001,2,11342,11344,5894,2,PERF
42283322540000,PI,IP,001,3,11385,11387,5894,2,PERF
42283322540000,PI,IP,001,4,11428,11430,5894,2,PERF
42283322540000,PI,IP,001,5,11471,11473,5894,2,PERF
42283322540000,PI,IP,001,6,11514,11516,5894,2,PERF
42283322540000,PI,IP,001,7,11602,11604,5894,2,PERF
42283322540000,PI,IP,001,8,11645,11647,5894,2,PERF
42283322540000,PI,IP,001,9,11688,11690,5894,2,PERF
42283322540000,PI,IP,001,10,11731,11733,5894,2,PERF
42283322540000,PI,IP,001,11,11774,11776,5894,2,PERF
42283322540000,PI,IP,001,12,11817,11819,5894,2,PERF
42283322540000,PI,IP,001,13,11905,11907,5894,2,PERF
42283322540000,PI,IP,001,14,11948,11950,5894,2,PERF
42283322540000,PI,IP,001,15,11991,11993,5894,2,PERF
42283322540000,PI,IP,001,16,12034,12036,5894,2,PERF
42283322540000,PI,IP,001,17,12077,12079,5894,2,PERF
42283322540000,PI,IP,001,18,12120,12122,5894,2,PERF
42283322540000,PI,IP,001,19,12208,12210,5894,2,PERF
42283322540000,PI,IP,001,20,12281,12283,5894,2,PERF
42283322540000,PI,IP,001,21,12294,12296,5894,2,PERF
42283322540000,PI,IP,001,22,12337,12339,5894,2,PERF
42283322540000,PI,IP,001,23,12380,12382,5894,2,PERF
42283322540000,PI,IP,001,24,12423,12425,5894,2,PERF
42283322540000,PI,IP,001,25,12511,12513,5894,2,PERF
42283322540000,PI,IP,001,26,12554,12556,5894,2,PERF
42283322540000,PI,IP,001,27,12597,12599,5894,2,PERF
42283322540000,PI,IP,001,28,12640,12642,5894,2,PERF
42283322540000,PI,IP,001,29,12683,12685,5894,2,PERF
42283322540000,PI,IP,001,30,12726,12728,5894,2,PERF
42283322540000,PI,IP,001,31,12814,12816,5894,2,PERF
42283322540000,PI,IP,001,32,12857,12859,5894,2,PERF
42283322540000,PI,IP,001,33,12900,12902,5894,2,PERF
42283322540000,PI,IP,001,34,12943,12945,5894,2,PERF
42283322540000,PI,IP,001,35,12986,12988,5894,2,PERF
42283322540000,PI,IP,001,36,13029,13031,5894,2,PERF
42283322540000,PI,IP,001,37,13117,13119,5894,2,PERF
42283322540000,PI,IP,001,38,13160,13162,5894,2,PERF
42283322540000,PI,IP,001,39,13203,13205,5894,2,PERF
42283322540000,PI,IP,001,40,13246,13248,5894,2,PERF
42283322540000,PI,IP,001,41,13289,13291,5894,2,PERF
42283322540000,PI,IP,001,42,13332,13334,5894,2,PERF
42283322540000,PI,IP,001,43,13420,13422,5894,2,PERF
42283322540000,PI,IP,001,44,13463,13465,5894,2,PERF
42283322540000,PI,IP,001,45,13506,13508,5894,2,PERF
42283322540000,PI,IP,001,46,13549,13551,5894,2,PERF
42283322540000,PI,IP,001,47,13592,13594,5894,2,PERF
42283322540000,PI,IP,001,48,13635,13637,5894,2,PERF
42283322540000,PI,IP,001,49,13723,13725,5894,2,PERF
42283322540000,PI,IP,001,50,13766,13768,5894,2,PERF
42283322540000,PI,IP,001,51,13809,13811,5894,2,PERF
42283322540000,PI,IP,001,52,13852,13854,5894,2,PERF
42283322540000,PI,IP,001,53,13895,13897,5894,2,PERF
42283322540000,PI,IP,001,54,13938,13940,5894,2,PERF
42283322540000,PI,IP,001,55,14026,14028,5894,2,PERF
42283322540000,PI,IP,001,56,14069,14074,5894,5,PERF
42283322540000,PI,IP,001,57,14112,14114,5894,2,PERF
42283322540000,PI,IP,001,58,14155,14157,5894,2,PERF
42283322540000,PI,IP,001,59,14198,14200,5894,2,PERF
42283322540000,PI,IP,001,60,14241,14243,5894,2,PERF
42283322540000,PI,IP,001,61,14329,14331,5894,2,PERF
42283322540000,PI,IP,001,62,14372,14374,5894,2,PERF
42283322540000,PI,IP,001,63,14415,14417,5894,2,PERF
42283322540000,PI,IP,001,64,14458,14460,5894,2,PERF
42283322540000,PI,IP,001,65,14501,14503,5894,2,PERF
42283322540000,PI,IP,001,66,14544,14546,5894,2,PERF
42283322540000,PI,IP,001,67,14632,14634,5894,2,PERF
42283322540000,PI,IP,001,68,14675,14677,5894,2,PERF
42283322540000,PI,IP,001,69,14718,14720,5894,2,PERF
42283322540000,PI,IP,001,70,14761,14763,5894,2,PERF
42283322540000,PI,IP,001,71,14804,14806,5894,2,PERF
42283322540000,PI,IP,001,72,14847,14849,5894,2,PERF
42283322540000,PI,IP,001,73,14935,14937,5894,2,PERF
42283322540000,PI,IP,001,74,14978,14980,5894,2,PERF
42283322540000,PI,IP,001,75,15021,15023,5894,2,PERF
42283322540000,PI,IP,001,76,15064,15066,5894,2,PERF
42283322540000,PI,IP,001,77,15107,15109,5894,2,PERF
42283322540000,PI,IP,001,78,15150,15152,5894,2,PERF
42283322540000,PI,IP,001,79,15238,15240,5894,2,PERF
42283322540000,PI,IP,001,80,15281,15283,5894,2,PERF
42283322540000,PI,IP,001,81,15324,15326,5894,2,PERF
42283322540000,PI,IP,001,82,15367,15369,5894,2,PERF
42283322540000,PI,IP,001,83,15410,15412,5894,2,PERF
42283322540000,PI,IP,001,84,15453,15455,5894,2,PERF
42283322540000,PI,IP,001,85,15541,15543,5894,2,PERF
42283322540000,PI,IP,001,86,15584,15586,5894,2,PERF
42283322540000,PI,IP,001,87,15627,15629,5894,2,PERF
42283322540000,PI,IP,001,88,15670,15672,5894,2,PERF
42283322540000,PI,IP,001,89,15713,15715,5894,2,PERF
42283322540000,PI,IP,001,90,15756,15758,5894,2,PERF
42283322550000,PI,IP,001,1,12300,17911,6526,5611,PERF
42283322560000,PI,IP,001,1,10032,10035,5515,3,PERF
42283322560000,PI,IP,001,2,10072,10075,5515,3,PERF
42283322560000,PI,IP,001,3,10112,10115,5515,3,PERF
42283322560000,PI,IP,001,4,10152,10155,5515,3,PERF
42283322560000,PI,IP,001,5,10192,10195,5515,3,PERF
42283322560000,PI,IP,001,6,10232,10235,5515,3,PERF
42283322560000,PI,IP,001,7,10307,10310,5515,3,PERF
42283322560000,PI,IP,001,8,10347,10350,5515,3,PERF
42283322560000,PI,IP,001,9,10387,10390,5515,3,PERF
42283322560000,PI,IP,001,10,10427,10430,5515,3,PERF
42283322560000,PI,IP,001,11,10467,10470,5515,3,PERF
42283322560000,PI,IP,001,12,10507,10510,5515,3,PERF
42283322560000,PI,IP,001,13,10582,10585,5515,3,PERF
42283322560000,PI,IP,001,14,10622,10625,5515,3,PERF
42283322560000,PI,IP,001,15,10662,10665,5515,3,PERF
42283322560000,PI,IP,001,16,10702,10705,5515,3,PERF
42283322560000,PI,IP,001,17,10742,10745,5515,3,PERF
42283322560000,PI,IP,001,18,10782,10785,5515,3,PERF
42283322560000,PI,IP,001,19,10857,10860,5515,3,PERF
42283322560000,PI,IP,001,20,10890,10897,5515,7,PERF
42283322560000,PI,IP,001,21,10937,10940,5515,3,PERF
42283322560000,PI,IP,001,22,10977,10980,5515,3,PERF
42283322560000,PI,IP,001,23,11017,11020,5515,3,PERF
42283322560000,PI,IP,001,24,11057,11060,5515,3,PERF
42283322560000,PI,IP,001,25,11132,11135,5515,3,PERF
42283322560000,PI,IP,001,26,11172,11175,5515,3,PERF
42283322560000,PI,IP,001,27,11212,11215,5515,3,PERF
42283322560000,PI,IP,001,28,11252,11255,5515,3,PERF
42283322560000,PI,IP,001,29,11292,11295,5515,3,PERF
42283322560000,PI,IP,001,30,11332,11335,5515,3,PERF
42283322560000,PI,IP,001,31,11407,11410,5515,3,PERF
42283322560000,PI,IP,001,32,11447,11450,5515,3,PERF
42283322560000,PI,IP,001,33,11487,11490,5515,3,PERF
42283322560000,PI,IP,001,34,11527,11530,5515,3,PERF
42283322560000,PI,IP,001,35,11567,11570,5515,3,PERF
42283322560000,PI,IP,001,36,11607,11610,5515,3,PERF
42283322560000,PI,IP,001,37,11682,11685,5515,3,PERF
42283322560000,PI,IP,001,38,11722,11725,5515,3,PERF
42283322560000,PI,IP,001,39,11762,11765,5515,3,PERF
42283322560000,PI,IP,001,40,11802,11805,5515,3,PERF
42283322560000,PI,IP,001,41,11842,11845,5515,3,PERF
42283322560000,PI,IP,001,42,11882,11885,5515,3,PERF
42283322560000,PI,IP,001,43,11957,11960,5515,3,PERF
42283322560000,PI,IP,001,44,11997,12000,5515,3,PERF
42283322560000,PI,IP,001,45,12037,12040,5515,3,PERF
42283322560000,PI,IP,001,46,12077,12080,5515,3,PERF
42283322560000,PI,IP,001,47,12117,12120,5515,3,PERF
42283322560000,PI,IP,001,48,12157,12160,5515,3,PERF
42283322560000,PI,IP,001,49,12223,12226,5515,3,PERF
42283322560000,PI,IP,001,50,12264,12267,5515,3,PERF
42283322560000,PI,IP,001,51,12307,12310,5515,3,PERF
42283322560000,PI,IP,001,52,12347,12350,5515,3,PERF
42283322560000,PI,IP,001,53,12387,12390,5515,3,PERF
42283322560000,PI,IP,001,54,12427,12430,5515,3,PERF
42283322560000,PI,IP,001,55,12507,12510,5515,3,PERF
42283322560000,PI,IP,001,56,12547,12550,5515,3,PERF
42283322560000,PI,IP,001,57,12587,12590,5515,3,PERF
42283322560000,PI,IP,001,58,12627,12630,5515,3,PERF
42283322560000,PI,IP,001,59,12667,12670,5515,3,PERF
42283322560000,PI,IP,001,60,12707,12710,5515,3,PERF
42283322560000,PI,IP,001,61,12782,12785,5515,3,PERF
42283322560000,PI,IP,001,62,12822,12825,5515,3,PERF
42283322560000,PI,IP,001,63,12862,12865,5515,3,PERF
42283322560000,PI,IP,001,64,12902,12905,5515,3,PERF
42283322560000,PI,IP,001,65,12942,12945,5515,3,PERF
42283322560000,PI,IP,001,66,12982,12985,5515,3,PERF
42283322560000,PI,IP,001,67,13057,13060,5515,3,PERF
42283322560000,PI,IP,001,68,13097,13100,5515,3,PERF
42283322560000,PI,IP,001,69,13137,13140,5515,3,PERF
42283322560000,PI,IP,001,70,13177,13180,5515,3,PERF
42283322560000,PI,IP,001,71,13217,13220,5515,3,PERF
42283322560000,PI,IP,001,72,13257,13260,5515,3,PERF
42283322560000,PI,IP,001,73,13332,13335,5515,3,PERF
42283322560000,PI,IP,001,74,13372,13375,5515,3,PERF
42283322560000,PI,IP,001,75,13412,13415,5515,3,PERF
42283322560000,PI,IP,001,76,13452,13455,5515,3,PERF
42283322560000,PI,IP,001,77,13492,13495,5515,3,PERF
42283322560000,PI,IP,001,78,13532,13535,5515,3,PERF
42283322560000,PI,IP,001,79,13602,13605,5515,3,PERF
42283322560000,PI,IP,001,80,13642,13645,5515,3,PERF
42283322560000,PI,IP,001,81,13682,13685,5515,3,PERF
42283322560000,PI,IP,001,82,13721,13724,5515,3,PERF
42283322560000,PI,IP,001,83,13767,13770,5515,3,PERF
42283322560000,PI,IP,001,84,13812,13815,5515,3,PERF
42283322560000,PI,IP,001,85,13882,13885,5515,3,PERF
42283322560000,PI,IP,001,86,13922,13925,5515,3,PERF
42283322560000,PI,IP,001,87,13962,13965,5515,3,PERF
42283322560000,PI,IP,001,88,14002,14005,5515,3,PERF
42283322560000,PI,IP,001,89,14042,14045,5515,3,PERF
42283322560000,PI,IP,001,90,14082,14085,5515,3,PERF
42283322560000,PI,IP,001,91,14157,14160,5515,3,PERF
42283322560000,PI,IP,001,92,14197,14200,5515,3,PERF
42283322560000,PI,IP,001,93,14237,14240,5515,3,PERF
42283322560000,PI,IP,001,94,14277,14280,5515,3,PERF
42283322560000,PI,IP,001,95,14317,14320,5515,3,PERF
42283322560000,PI,IP,001,96,14357,14360,5515,3,PERF
42283322560000,PI,IP,001,97,14432,14435,5515,3,PERF
42283322560000,PI,IP,001,98,14472,14475,5515,3,PERF
42283322560000,PI,IP,001,99,14512,14515,5515,3,PERF
42283322560000,PI,IP,001,100,14552,14555,5515,3,PERF
42283322560000,PI,IP,001,101,14592,14595,5515,3,PERF
42283322560000,PI,IP,001,102,14632,14635,5515,3,PERF
42283322560000,PI,IP,001,103,14690,14693,5515,3,PERF
42283322560000,PI,IP,001,104,14707,14710,5515,3,PERF
42283322560000,PI,IP,001,105,14727,14730,5515,3,PERF
42283322560000,PI,IP,001,106,14747,14750,5515,3,PERF
42283322560000,PI,IP,001,107,14767,14770,5515,3,PERF
42283322560000,PI,IP,001,108,14787,14790,5515,3,PERF
42283322560000,PI,IP,001,109,14807,14810,5515,3,PERF
42283322560000,PI,IP,001,110,14827,14830,5515,3,PERF
42283322560000,PI,IP,001,111,14847,14850,5515,3,PERF
42283322560000,PI,IP,001,112,14867,14870,5515,3,PERF
42283322560000,PI,IP,001,113,14907,14910,5515,3,PERF
42283322570000,PI,IP,002,1,10134,13685,,3551,PERF
42283322570000,PI,PT,001,1,10134,10137,,3,PERF
42283322570000,PI,PT,001,2,10174,10177,,3,PERF
42283322570000,PI,PT,001,3,10214,10217,,3,PERF
42283322570000,PI,PT,001,4,10254,10257,,3,PERF
42283322570000,PI,PT,001,5,10294,10297,,3,PERF
42283322570000,PI,PT,001,6,10334,10337,,3,PERF
42283322570000,PI,PT,001,7,10413,10416,,3,PERF
42283322570000,PI,PT,001,8,10453,10456,,3,PERF
42283322570000,PI,PT,001,9,10493,10496,,3,PERF
42283322570000,PI,PT,001,10,10533,10536,,3,PERF
42283322570000,PI,PT,001,11,10573,10576,,3,PERF
42283322570000,PI,PT,001,12,10613,10616,,3,PERF
42283322570000,PI,PT,001,13,10692,10695,,3,PERF
42283322570000,PI,PT,001,14,10732,10735,,3,PERF
42283322570000,PI,PT,001,15,10772,10775,,3,PERF
42283322570000,PI,PT,001,16,10812,10815,,3,PERF
42283322570000,PI,PT,001,17,10852,10855,,3,PERF
42283322570000,PI,PT,001,18,10894,10897,,3,PERF
42283322570000,PI,PT,001,19,10967,10970,,3,PERF
42283322570000,PI,PT,001,20,11008,11011,,3,PERF
42283322570000,PI,PT,001,21,11050,11053,,3,PERF
42283322570000,PI,PT,001,22,11091,11094,,3,PERF
42283322570000,PI,PT,001,23,11131,11134,,3,PERF
42283322570000,PI,PT,001,24,11171,11174,,3,PERF
42283322570000,PI,PT,001,25,11250,11253,,3,PERF
42283322570000,PI,PT,001,26,11290,11293,,3,PERF
42283322570000,PI,PT,001,27,11330,11333,,3,PERF
42283322570000,PI,PT,001,28,11370,11373,,3,PERF
42283322570000,PI,PT,001,29,11410,11413,,3,PERF
42283322570000,PI,PT,001,30,11450,11453,,3,PERF
42283322570000,PI,PT,001,31,11529,11532,,3,PERF
42283322570000,PI,PT,001,32,11569,11572,,3,PERF
42283322570000,PI,PT,001,33,11609,11612,,3,PERF
42283322570000,PI,PT,001,34,11649,11652,,3,PERF
42283322570000,PI,PT,001,35,11689,11692,,3,PERF
42283322570000,PI,PT,001,36,11729,11732,,3,PERF
42283322570000,PI,PT,001,37,11808,11811,,3,PERF
42283322570000,PI,PT,001,38,11848,11851,,3,PERF
42283322570000,PI,PT,001,39,11888,11891,,3,PERF
42283322570000,PI,PT,001,40,11928,11931,,3,PERF
42283322570000,PI,PT,001,41,11968,11971,,3,PERF
42283322570000,PI,PT,001,42,12008,12011,,3,PERF
42283322570000,PI,PT,001,43,12087,12090,,3,PERF
42283322570000,PI,PT,001,44,12129,12132,,3,PERF
42283322570000,PI,PT,001,45,12166,12169,,3,PERF
42283322570000,PI,PT,001,46,12206,12209,,3,PERF
42283322570000,PI,PT,001,47,12247,12250,,3,PERF
42283322570000,PI,PT,001,48,12287,12290,,3,PERF
42283322570000,PI,PT,001,49,12366,12369,,3,PERF
42283322570000,PI,PT,001,50,12406,12409,,3,PERF
42283322570000,PI,PT,001,51,12446,12449,,3,PERF
42283322570000,PI,PT,001,52,12486,12489,,3,PERF
42283322570000,PI,PT,001,53,12526,12529,,3,PERF
42283322570000,PI,PT,001,54,12566,12569,,3,PERF
42283322570000,PI,PT,001,55,12645,12648,,3,PERF
42283322570000,PI,PT,001,56,12685,12688,,3,PERF
42283322570000,PI,PT,001,57,12725,12728,,3,PERF
42283322570000,PI,PT,001,58,12765,12768,,3,PERF
42283322570000,PI,PT,001,59,12805,12808,,3,PERF
42283322570000,PI,PT,001,60,12845,12848,,3,PERF
42283322570000,PI,PT,001,61,12924,12927,,3,PERF
42283322570000,PI,PT,001,62,12964,12967,,3,PERF
42283322570000,PI,PT,001,63,13004,13007,,3,PERF
42283322570000,PI,PT,001,64,13044,13047,,3,PERF
42283322570000,PI,PT,001,65,13084,13087,,3,PERF
42283322570000,PI,PT,001,66,13124,13127,,3,PERF
42283322570000,PI,PT,001,67,13203,13206,,3,PERF
42283322570000,PI,PT,001,68,13243,13246,,3,PERF
42283322570000,PI,PT,001,69,13283,13286,,3,PERF
42283322570000,PI,PT,001,70,13323,13326,,3,PERF
42283322570000,PI,PT,001,71,13352,13355,,3,PERF
42283322570000,PI,PT,001,72,13382,13385,,3,PERF
42283322570000,PI,PT,001,73,13482,13485,,3,PERF
42283322570000,PI,PT,001,74,13502,13505,,3,PERF
42283322570000,PI,PT,001,75,13522,13525,,3,PERF
42283322570000,PI,PT,001,76,13542,13545,,3,PERF
42283322570000,PI,PT,001,77,13562,13565,,3,PERF
42283322570000,PI,PT,001,78,13582,13585,,3,PERF
42283322570000,PI,PT,001,79,13602,13605,,3,PERF
42283322570000,PI,PT,001,80,13622,13625,,3,PERF
42283322570000,PI,PT,001,81,13642,13645,,3,PERF
42283322570000,PI,PT,001,82,13662,13665,,3,PERF
42283322570000,PI,PT,001,83,13682,13685,,3,PERF
42283322580000,PI,IP,001,1,9590,9593,4624,3,PERF
42283322580000,PI,IP,001,2,9690,9693,4624,3,PERF
42283322580000,PI,IP,001,3,9794,9800,4624,6,PERF
42283322580000,PI,IP,001,4,9915,9918,4624,3,PERF
42283322580000,PI,IP,001,5,10015,10018,4624,3,PERF
42283322580000,PI,IP,001,6,10120,10126,4624,6,PERF
42283322580000,PI,IP,001,7,10240,10243,4624,3,PERF
42283322580000,PI,IP,001,8,10338,10341,4624,3,PERF
42283322580000,PI,IP,001,9,10444,10450,4624,6,PERF
42283322580000,PI,IP,001,10,10565,10568,4624,3,PERF
42283322580000,PI,IP,001,11,10660,10663,4624,3,PERF
42283322580000,PI,IP,001,12,10765,10771,4624,6,PERF
42283322580000,PI,IP,001,13,10888,10891,4624,3,PERF
42283322580000,PI,IP,001,14,10993,10996,4624,3,PERF
42283322580000,PI,IP,001,15,11090,11096,4624,6,PERF
42283322580000,PI,IP,001,16,11211,11214,4624,3,PERF
42283322580000,PI,IP,001,17,11316,11319,4624,3,PERF
42283322580000,PI,IP,001,18,11415,11421,4624,6,PERF
42283322580000,PI,IP,001,19,11550,11553,4624,3,PERF
42283322580000,PI,IP,001,20,11640,11643,4624,3,PERF
42283322580000,PI,IP,001,21,11740,11746,4624,6,PERF
42283322580000,PI,IP,001,22,11980,11986,4624,6,PERF
42283322580000,PI,IP,001,23,12190,12196,4624,6,PERF
42283322580000,PI,IP,001,24,12385,12385,4624,0,PERF
42283322580000,PI,IP,001,25,12539,12539,4624,0,PERF
42283322590000,PI,IP,001,1,10434,14517,4636,4083,PERF
42283322600000,PI,IP,001,1,11447,13631,2913,2184,PERF
42283322610000,PI,IP,001,1,8701,12162,3894,3461,OPENHOLE
42283322620000,PI,IP,001,1,9576,9579,6008,3,PERF
42283322620000,PI,IP,001,2,9674,9677,6008,3,PERF
42283322620000,PI,IP,001,3,9776,9782,6008,6,PERF
42283322620000,PI,IP,001,4,9880,9883,6008,3,PERF
42283322620000,PI,IP,001,5,9972,9975,6008,3,PERF
42283322620000,PI,IP,001,6,10080,10086,6008,6,PERF
42283322620000,PI,IP,001,7,10184,10187,6008,3,PERF
42283322620000,PI,IP,001,8,10284,10287,6008,3,PERF
42283322620000,PI,IP,001,9,10385,10391,6008,6,PERF
42283322620000,PI,IP,001,10,10488,10491,6008,3,PERF
42283322620000,PI,IP,001,11,10588,10591,6008,3,PERF
42283322620000,PI,IP,001,12,10689,10695,6008,6,PERF
42283322620000,PI,IP,001,13,10792,10795,6008,3,PERF
42283322620000,PI,IP,001,14,10892,10895,6008,3,PERF
42283322620000,PI,IP,001,15,10996,11002,6008,6,PERF
42283322620000,PI,IP,001,16,11096,11099,6008,3,PERF
42283322620000,PI,IP,001,17,11196,11199,6008,3,PERF
42283322620000,PI,IP,001,18,11290,11296,6008,6,PERF
42283322620000,PI,IP,001,19,11400,11403,6008,3,PERF
42283322620000,PI,IP,001,20,11500,11503,6008,3,PERF
42283322620000,PI,IP,001,21,11594,11600,6008,6,PERF
42283322620000,PI,IP,001,22,11704,11707,6008,3,PERF
42283322620000,PI,IP,001,23,11804,11807,6008,3,PERF
42283322620000,PI,IP,001,24,11900,11906,6008,6,PERF
42283322620000,PI,IP,001,25,12008,12011,6008,3,PERF
42283322620000,PI,IP,001,26,12108,12111,6008,3,PERF
42283322620000,PI,IP,001,27,12208,12214,6008,6,PERF
42283322620000,PI,IP,001,28,12312,12315,6008,3,PERF
42283322620000,PI,IP,001,29,12412,12415,6008,3,PERF
42283322620000,PI,IP,001,30,12511,12517,6008,6,PERF
42283322620000,PI,IP,001,31,12616,12619,6008,3,PERF
42283322620000,PI,IP,001,32,12716,12719,6008,3,PERF
42283322620000,PI,IP,001,33,12816,12822,6008,6,PERF
42283322620000,PI,IP,001,34,12922,12925,6008,3,PERF
42283322620000,PI,IP,001,35,13020,13023,6008,3,PERF
42283322620000,PI,IP,001,36,13120,13126,6008,6,PERF
42283322620000,PI,IP,001,37,13219,13222,6008,3,PERF
42283322620000,PI,IP,001,38,13324,13327,6008,3,PERF
42283322620000,PI,IP,001,39,13424,13430,6008,6,PERF
42283322620000,PI,IP,001,40,13526,13529,6008,3,PERF
42283322620000,PI,IP,001,41,13628,13631,6008,3,PERF
42283322620000,PI,IP,001,42,13728,13734,6008,6,PERF
42283322620000,PI,IP,001,43,13832,13835,6008,3,PERF
42283322620000,PI,IP,001,44,13934,13937,6008,3,PERF
42283322620000,PI,IP,001,45,14032,14038,6008,6,PERF
42283322620000,PI,IP,001,46,14136,14139,6008,3,PERF
42283322620000,PI,IP,001,47,14238,14241,6008,3,PERF
42283322620000,PI,IP,001,48,14336,14342,6008,6,PERF
42283322620000,PI,IP,001,49,14440,14443,6008,3,PERF
42283322620000,PI,IP,001,50,14540,14543,6008,3,PERF
42283322620000,PI,IP,001,51,14640,14646,6008,6,PERF
42283322620000,PI,IP,001,52,14740,14743,6008,3,PERF
42283322620000,PI,IP,001,53,14840,14843,6008,3,PERF
42283322620000,PI,IP,001,54,14940,14946,6008,6,PERF
42283322630100,PI,IP,001,1,11720,11722,6095,2,PERF
42283322630100,PI,IP,001,2,11790,11792,6095,2,PERF
42283322630100,PI,IP,001,3,11860,11862,6095,2,PERF
42283322630100,PI,IP,001,4,11930,11932,6095,2,PERF
42283322630100,PI,IP,001,5,12270,12272,6095,2,PERF
42283322630100,PI,IP,001,6,12335,12337,6095,2,PERF
42283322630100,PI,IP,001,7,12400,12402,6095,2,PERF
42283322630100,PI,IP,001,8,12465,12467,6095,2,PERF
42283322630100,PI,IP,001,9,12836,12838,6095,2,PERF
42283322630100,PI,IP,001,10,12906,12908,6095,2,PERF
42283322630100,PI,IP,001,11,12976,12978,6095,2,PERF
42283322630100,PI,IP,001,12,13046,13048,6095,2,PERF
42283322630100,PI,IP,001,13,13150,13152,6095,2,PERF
42283322630100,PI,IP,001,14,13223,13225,6095,2,PERF
42283322630100,PI,IP,001,15,13293,13295,6095,2,PERF
42283322630100,PI,IP,001,16,13363,13365,6095,2,PERF
42283322630100,PI,IP,001,17,13470,13472,6095,2,PERF
42283322630100,PI,IP,001,18,13534,13536,6095,2,PERF
42283322630100,PI,IP,001,19,13610,13612,6095,2,PERF
42283322630100,PI,IP,001,20,13680,13682,6095,2,PERF
42283322630100,PI,IP,001,21,13787,13789,6095,2,PERF
42283322630100,PI,IP,001,22,13857,13859,6095,2,PERF
42283322630100,PI,IP,001,23,13927,13929,6095,2,PERF
42283322630100,PI,IP,001,24,13997,13999,6095,2,PERF
42283322630100,PI,IP,001,25,14104,14106,6095,2,PERF
42283322630100,PI,IP,001,26,14174,14176,6095,2,PERF
42283322630100,PI,IP,001,27,14244,14246,6095,2,PERF
42283322630100,PI,IP,001,28,14320,14322,6095,2,PERF
42283322630100,PI,IP,001,29,14421,14423,6095,2,PERF
42283322630100,PI,IP,001,30,14491,14493,6095,2,PERF
42283322630100,PI,IP,001,31,14561,14563,6095,2,PERF
42283322630100,PI,IP,001,32,14631,14633,6095,2,PERF
42283322630100,PI,IP,001,33,14738,14740,6095,2,PERF
42283322630100,PI,IP,001,34,14808,14810,6095,2,PERF
42283322630100,PI,IP,001,35,14870,14872,6095,2,PERF
42283322630100,PI,IP,001,36,14948,14950,6095,2,PERF
42283322630100,PI,IP,001,37,15055,15057,6095,2,PERF
42283322630100,PI,IP,001,38,15125,15127,6095,2,PERF
42283322630100,PI,IP,001,39,15195,15197,6095,2,PERF
42283322630100,PI,IP,001,40,15265,15267,6095,2,PERF
42283322630100,PI,IP,001,41,15372,15374,6095,2,PERF
42283322630100,PI,IP,001,42,15442,15444,6095,2,PERF
42283322630100,PI,IP,001,43,15512,15514,6095,2,PERF
42283322630100,PI,IP,001,44,15582,15584,6095,2,PERF
42283322640000,PI,IP,001,1,10928,15887,5519,4959,PERF
42283322650000,PI,IP,001,1,11828,18237,7014,6409,PERF
42283322660000,PI,IP,001,1,11340,16948,6104,5608,PERF
42283322700000,PI,IP,001,1,8263,8584,7579,321,PERF
42283322700000,PI,IP,001,2,8683,9004,7579,321,PERF
42283322700000,PI,IP,001,3,9103,9424,7579,321,PERF
42283322700000,PI,IP,001,4,9523,9843,7579,320,PERF
42283322700000,PI,IP,001,5,9943,9944,7579,1,PERF
42283322700000,PI,IP,001,6,10023,10264,7579,241,PERF
42283322700000,PI,IP,001,7,10363,10684,7579,321,PERF
42283322700000,PI,IP,001,8,10783,11104,7579,321,PERF
42283322700000,PI,IP,001,9,11203,11524,7579,321,PERF
42283322700000,PI,IP,001,10,11623,11944,7579,321,PERF
42283322700000,PI,IP,001,11,12043,12364,7579,321,PERF
42283322700000,PI,IP,001,12,12463,12784,7579,321,PERF
42283322700000,PI,IP,001,13,13303,13624,7579,321,PERF
42283322700000,PI,IP,001,14,13723,14044,7579,321,PERF
42283322700000,PI,IP,001,15,14143,14464,7579,321,PERF
42283322700000,PI,IP,001,16,14563,14884,7579,321,PERF
42283322700000,PI,IP,001,17,14983,15304,7579,321,PERF
42283322700000,PI,IP,001,18,15399,15594,7579,195,PERF
42283322710000,PI,IP,001,1,10027,10030,5699,3,PERF
42283322710000,PI,IP,001,2,10067,10070,5699,3,PERF
42283322710000,PI,IP,001,3,10107,10110,5699,3,PERF
42283322710000,PI,IP,001,4,10147,10150,5699,3,PERF
42283322710000,PI,IP,001,5,10187,10190,5699,3,PERF
42283322710000,PI,IP,001,6,10227,10230,5699,3,PERF
42283322710000,PI,IP,001,7,10302,10305,5699,3,PERF
42283322710000,PI,IP,001,8,10342,10345,5699,3,PERF
42283322710000,PI,IP,001,9,10382,10385,5699,3,PERF
42283322710000,PI,IP,001,10,10422,10425,5699,3,PERF
42283322710000,PI,IP,001,11,10462,10465,5699,3,PERF
42283322710000,PI,IP,001,12,10502,10505,5699,3,PERF
42283322710000,PI,IP,001,13,10571,10574,5699,3,PERF
42283322710000,PI,IP,001,14,10609,10611,5699,2,PERF
42283322710000,PI,IP,001,15,10650,10653,5699,3,PERF
42283322710000,PI,IP,001,16,10690,10693,5699,3,PERF
42283322710000,PI,IP,001,17,10730,10733,5699,3,PERF
42283322710000,PI,IP,001,18,10770,10773,5699,3,PERF
42283322710000,PI,IP,001,19,10852,10855,5699,3,PERF
42283322710000,PI,IP,001,20,10892,10895,5699,3,PERF
42283322710000,PI,IP,001,21,10932,10935,5699,3,PERF
42283322710000,PI,IP,001,22,10972,10975,5699,3,PERF
42283322710000,PI,IP,001,23,11012,11015,5699,3,PERF
42283322710000,PI,IP,001,24,11052,11055,5699,3,PERF
42283322710000,PI,IP,001,25,11127,11130,5699,3,PERF
42283322710000,PI,IP,001,26,11167,11170,5699,3,PERF
42283322710000,PI,IP,001,27,11207,11210,5699,3,PERF
42283322710000,PI,IP,001,28,11247,11250,5699,3,PERF
42283322710000,PI,IP,001,29,11287,11290,5699,3,PERF
42283322710000,PI,IP,001,30,11327,11330,5699,3,PERF
42283322710000,PI,IP,001,31,11402,11405,5699,3,PERF
42283322710000,PI,IP,001,32,11442,11445,5699,3,PERF
42283322710000,PI,IP,001,33,11484,11487,5699,3,PERF
42283322710000,PI,IP,001,34,11524,11527,5699,3,PERF
42283322710000,PI,IP,001,35,11565,11568,5699,3,PERF
42283322710000,PI,IP,001,36,11604,11607,5699,3,PERF
42283322710000,PI,IP,001,37,11661,11664,5699,3,PERF
42283322710000,PI,IP,001,38,11709,11712,5699,3,PERF
42283322710000,PI,IP,001,39,11750,11753,5699,3,PERF
42283322710000,PI,IP,001,40,11791,11794,5699,3,PERF
42283322710000,PI,IP,001,41,11834,11837,5699,3,PERF
42283322710000,PI,IP,001,42,11874,11877,5699,3,PERF
42283322710000,PI,IP,001,43,11952,11955,5699,3,PERF
42283322710000,PI,IP,001,44,11992,11995,5699,3,PERF
42283322710000,PI,IP,001,45,12032,12035,5699,3,PERF
42283322710000,PI,IP,001,46,12072,12075,5699,3,PERF
42283322710000,PI,IP,001,47,12112,12115,5699,3,PERF
42283322710000,PI,IP,001,48,12152,12155,5699,3,PERF
42283322710000,PI,IP,001,49,12227,12230,5699,3,PERF
42283322710000,PI,IP,001,50,12267,12270,5699,3,PERF
42283322710000,PI,IP,001,51,12307,12310,5699,3,PERF
42283322710000,PI,IP,001,52,12347,12350,5699,3,PERF
42283322710000,PI,IP,001,53,12387,12390,5699,3,PERF
42283322710000,PI,IP,001,54,12427,12430,5699,3,PERF
42283322710000,PI,IP,001,55,12502,12505,5699,3,PERF
42283322710000,PI,IP,001,56,12542,12545,5699,3,PERF
42283322710000,PI,IP,001,57,12582,12585,5699,3,PERF
42283322710000,PI,IP,001,58,12624,12627,5699,3,PERF
42283322710000,PI,IP,001,59,12666,12669,5699,3,PERF
42283322710000,PI,IP,001,60,12709,12712,5699,3,PERF
42283322710000,PI,IP,001,61,12773,12776,5699,3,PERF
42283322710000,PI,IP,001,62,12817,12820,5699,3,PERF
42283322710000,PI,IP,001,63,12857,12860,5699,3,PERF
42283322710000,PI,IP,001,64,12897,12900,5699,3,PERF
42283322710000,PI,IP,001,65,12937,12940,5699,3,PERF
42283322710000,PI,IP,001,66,12977,12980,5699,3,PERF
42283322710000,PI,IP,001,67,13052,13055,5699,3,PERF
42283322710000,PI,IP,001,68,13092,13095,5699,3,PERF
42283322710000,PI,IP,001,69,13132,13135,5699,3,PERF
42283322710000,PI,IP,001,70,13172,13175,5699,3,PERF
42283322710000,PI,IP,001,71,13212,13215,5699,3,PERF
42283322710000,PI,IP,001,72,13252,13255,5699,3,PERF
42283322710000,PI,IP,001,73,13327,13330,5699,3,PERF
42283322710000,PI,IP,001,74,13367,13370,5699,3,PERF
42283322710000,PI,IP,001,75,13407,13410,5699,3,PERF
42283322710000,PI,IP,001,76,13444,13447,5699,3,PERF
42283322710000,PI,IP,001,77,13490,13493,5699,3,PERF
42283322710000,PI,IP,001,78,13519,13522,5699,3,PERF
42283322710000,PI,IP,001,79,13602,13605,5699,3,PERF
42283322710000,PI,IP,001,80,13642,13645,5699,3,PERF
42283322710000,PI,IP,001,81,13682,13685,5699,3,PERF
42283322710000,PI,IP,001,82,13722,13725,5699,3,PERF
42283322710000,PI,IP,001,83,13762,13765,5699,3,PERF
42283322710000,PI,IP,001,84,13802,13805,5699,3,PERF
42283322710000,PI,IP,001,85,13877,13880,5699,3,PERF
42283322710000,PI,IP,001,86,13917,13920,5699,3,PERF
42283322710000,PI,IP,001,87,13957,13960,5699,3,PERF
42283322710000,PI,IP,001,88,13997,14000,5699,3,PERF
42283322710000,PI,IP,001,89,14037,14040,5699,3,PERF
42283322710000,PI,IP,001,90,14077,14080,5699,3,PERF
42283322710000,PI,IP,001,91,14152,14155,5699,3,PERF
42283322710000,PI,IP,001,92,14193,14196,5699,3,PERF
42283322710000,PI,IP,001,93,14236,14239,5699,3,PERF
42283322710000,PI,IP,001,94,14278,14281,5699,3,PERF
42283322710000,PI,IP,001,95,14318,14321,5699,3,PERF
42283322710000,PI,IP,001,96,14360,14363,5699,3,PERF
42283322710000,PI,IP,001,97,14427,14430,5699,3,PERF
42283322710000,PI,IP,001,98,14467,14470,5699,3,PERF
42283322710000,PI,IP,001,99,14507,14510,5699,3,PERF
42283322710000,PI,IP,001,100,14547,14550,5699,3,PERF
42283322710000,PI,IP,001,101,14587,14590,5699,3,PERF
42283322710000,PI,IP,001,102,14627,14630,5699,3,PERF
42283322710000,PI,IP,001,103,14702,14705,5699,3,PERF
42283322710000,PI,IP,001,104,14742,14745,5699,3,PERF
42283322710000,PI,IP,001,105,14782,14785,5699,3,PERF
42283322710000,PI,IP,001,106,14822,14825,5699,3,PERF
42283322710000,PI,IP,001,107,14862,14865,5699,3,PERF
42283322710000,PI,IP,001,108,14902,14905,5699,3,PERF
42283322710000,PI,IP,001,109,14951,14954,5699,3,PERF
42283322710000,PI,IP,001,110,14991,14994,5699,3,PERF
42283322710000,PI,IP,001,111,15031,15034,5699,3,PERF
42283322710000,PI,IP,001,112,15071,15074,5699,3,PERF
42283322710000,PI,IP,001,113,15111,15114,5699,3,PERF
42283322710000,PI,IP,001,114,15151,15154,5699,3,PERF
42283322720000,PI,IP,001,1,10868,16527,6201,5659,PERF
42283322730000,PI,IP,001,1,10287,10290,5202,3,PERF
42283322730000,PI,IP,001,2,10330,10333,5202,3,PERF
42283322730000,PI,IP,001,3,10370,10373,5202,3,PERF
42283322730000,PI,IP,001,4,10409,10412,5202,3,PERF
42283322730000,PI,IP,001,5,10448,10451,5202,3,PERF
42283322730000,PI,IP,001,6,10487,10490,5202,3,PERF
42283322730000,PI,IP,001,7,10562,10565,5202,3,PERF
42283322730000,PI,IP,001,8,10601,10604,5202,3,PERF
42283322730000,PI,IP,001,9,10640,10643,5202,3,PERF
42283322730000,PI,IP,001,10,10679,10682,5202,3,PERF
42283322730000,PI,IP,001,11,10718,10721,5202,3,PERF
42283322730000,PI,IP,001,12,10757,10760,5202,3,PERF
42283322730000,PI,IP,001,13,10823,10825,5202,2,PERF
42283322730000,PI,IP,001,14,10867,10870,5202,3,PERF
42283322730000,PI,IP,001,15,10910,10913,5202,3,PERF
42283322730000,PI,IP,001,16,10949,10952,5202,3,PERF
42283322730000,PI,IP,001,17,10988,10991,5202,3,PERF
42283322730000,PI,IP,001,18,11027,11030,5202,3,PERF
42283322730000,PI,IP,001,19,11102,11105,5202,3,PERF
42283322730000,PI,IP,001,20,11141,11144,5202,3,PERF
42283322730000,PI,IP,001,21,11180,11183,5202,3,PERF
42283322730000,PI,IP,001,22,11219,11222,5202,3,PERF
42283322730000,PI,IP,001,23,11258,11261,5202,3,PERF
42283322730000,PI,IP,001,24,11297,11300,5202,3,PERF
42283322730000,PI,IP,001,25,11361,11364,5202,3,PERF
42283322730000,PI,IP,001,26,11401,11404,5202,3,PERF
42283322730000,PI,IP,001,27,11443,11447,5202,4,PERF
42283322730000,PI,IP,001,28,11485,11488,5202,3,PERF
42283322730000,PI,IP,001,29,11523,11562,5202,39,PERF
42283322730000,PI,IP,001,30,11561,11564,5202,3,PERF
42283322730000,PI,IP,001,31,11642,11645,5202,3,PERF
42283322730000,PI,IP,001,32,11681,11683,5202,2,PERF
42283322730000,PI,IP,001,33,11720,11723,5202,3,PERF
42283322730000,PI,IP,001,34,11759,11762,5202,3,PERF
42283322730000,PI,IP,001,35,11798,11801,5202,3,PERF
42283322730000,PI,IP,001,36,11837,11840,5202,3,PERF
42283322730000,PI,IP,001,37,11897,11900,5202,3,PERF
42283322730000,PI,IP,001,38,11930,11933,5202,3,PERF
42283322730000,PI,IP,001,39,11970,11973,5202,3,PERF
42283322730000,PI,IP,001,40,12020,12023,5202,3,PERF
42283322730000,PI,IP,001,41,12060,12063,5202,3,PERF
42283322730000,PI,IP,001,42,12107,12110,5202,3,PERF
42283322730000,PI,IP,001,43,12182,12185,5202,3,PERF
42283322730000,PI,IP,001,44,12221,12224,5202,3,PERF
42283322730000,PI,IP,001,45,12260,12263,5202,3,PERF
42283322730000,PI,IP,001,46,12299,12302,5202,3,PERF
42283322730000,PI,IP,001,47,12338,12341,5202,3,PERF
42283322730000,PI,IP,001,48,12377,12380,5202,3,PERF
42283322730000,PI,IP,001,49,12452,12455,5202,3,PERF
42283322730000,PI,IP,001,50,12491,12494,5202,3,PERF
42283322730000,PI,IP,001,51,12530,12533,5202,3,PERF
42283322730000,PI,IP,001,52,12580,12583,5202,3,PERF
42283322730000,PI,IP,001,53,12620,12623,5202,3,PERF
42283322730000,PI,IP,001,54,12657,12660,5202,3,PERF
42283322730000,PI,IP,001,55,12722,12725,5202,3,PERF
42283322730000,PI,IP,001,56,12761,12764,5202,3,PERF
42283322730000,PI,IP,001,57,12800,12803,5202,3,PERF
42283322730000,PI,IP,001,58,12839,12842,5202,3,PERF
42283322730000,PI,IP,001,59,12878,12881,5202,3,PERF
42283322730000,PI,IP,001,60,12917,12920,5202,3,PERF
42283322730000,PI,IP,001,61,12970,12973,5202,3,PERF
42283322730000,PI,IP,001,62,13010,13013,5202,3,PERF
42283322730000,PI,IP,001,63,13057,13060,5202,3,PERF
42283322730000,PI,IP,001,64,13097,13100,5202,3,PERF
42283322730000,PI,IP,001,65,13137,13140,5202,3,PERF
42283322730000,PI,IP,001,66,13177,13180,5202,3,PERF
42283322730000,PI,IP,001,67,13262,13265,5202,3,PERF
42283322730000,PI,IP,001,68,13301,13304,5202,3,PERF
42283322730000,PI,IP,001,69,13340,13343,5202,3,PERF
42283322730000,PI,IP,001,70,13379,13382,5202,3,PERF
42283322730000,PI,IP,001,71,13418,13421,5202,3,PERF
42283322730000,PI,IP,001,72,13457,13460,5202,3,PERF
42283322730000,PI,IP,001,73,13532,13535,5202,3,PERF
42283322730000,PI,IP,001,74,13571,13574,5202,3,PERF
42283322730000,PI,IP,001,75,13610,13613,5202,3,PERF
42283322730000,PI,IP,001,76,13649,13652,5202,3,PERF
42283322730000,PI,IP,001,77,13688,13691,5202,3,PERF
42283322730000,PI,IP,001,78,13727,13730,5202,3,PERF
42283322730000,PI,IP,001,79,13802,13805,5202,3,PERF
42283322730000,PI,IP,001,80,13841,13844,5202,3,PERF
42283322730000,PI,IP,001,81,13880,13883,5202,3,PERF
42283322730000,PI,IP,001,82,13919,13922,5202,3,PERF
42283322730000,PI,IP,001,83,13958,13961,5202,3,PERF
42283322730000,PI,IP,001,84,13997,14000,5202,3,PERF
42283322730000,PI,IP,001,85,14072,14075,5202,3,PERF
42283322730000,PI,IP,001,86,14111,14114,5202,3,PERF
42283322730000,PI,IP,001,87,14150,14153,5202,3,PERF
42283322730000,PI,IP,001,88,14189,14192,5202,3,PERF
42283322730000,PI,IP,001,89,14228,14231,5202,3,PERF
42283322730000,PI,IP,001,90,14267,14270,5202,3,PERF
42283322730000,PI,IP,001,91,14342,14345,5202,3,PERF
42283322730000,PI,IP,001,92,14381,14384,5202,3,PERF
42283322730000,PI,IP,001,93,14420,14423,5202,3,PERF
42283322730000,PI,IP,001,94,14459,14462,5202,3,PERF
42283322730000,PI,IP,001,95,14498,14501,5202,3,PERF
42283322730000,PI,IP,001,96,14537,14540,5202,3,PERF
42283322740000,PI,IP,001,1,10195,15056,5669,4861,PERF
42283322750000,PI,IP,001,1,9595,9598,5076,3,PERF
42283322750000,PI,IP,001,2,9685,9688,5076,3,PERF
42283322750000,PI,IP,001,3,9775,9781,5076,6,PERF
42283322750000,PI,IP,001,4,9870,9873,5076,3,PERF
42283322750000,PI,IP,001,5,9965,9968,5076,3,PERF
42283322750000,PI,IP,001,6,10058,10064,5076,6,PERF
42283322750000,PI,IP,001,7,10158,10161,5076,3,PERF
42283322750000,PI,IP,001,8,10250,10253,5076,3,PERF
42283322750000,PI,IP,001,9,10345,10351,5076,6,PERF
42283322750000,PI,IP,001,10,10440,10443,5076,3,PERF
42283322750000,PI,IP,001,11,10535,10538,5076,3,PERF
42283322750000,PI,IP,001,12,10630,10636,5076,6,PERF
42283322750000,PI,IP,001,13,10725,10728,5076,3,PERF
42283322750000,PI,IP,001,14,10820,10823,5076,3,PERF
42283322750000,PI,IP,001,15,10915,10921,5076,6,PERF
42283322750000,PI,IP,001,16,11010,11013,5076,3,PERF
42283322750000,PI,IP,001,17,11100,11103,5076,3,PERF
42283322750000,PI,IP,001,18,11203,11209,5076,6,PERF
42283322750000,PI,IP,001,19,11295,11298,5076,3,PERF
42283322750000,PI,IP,001,20,11390,11393,5076,3,PERF
42283322750000,PI,IP,001,21,11485,11491,5076,6,PERF
42283322750000,PI,IP,001,22,11790,11793,5076,3,PERF
42283322750000,PI,IP,001,23,11894,11897,5076,3,PERF
42283322750000,PI,IP,001,24,11994,12000,5076,6,PERF
42283322750000,PI,IP,001,25,12304,12306,5076,2,PERF
42283322750000,PI,IP,001,26,12582,12584,5076,2,PERF
42283322750000,PI,IP,001,27,12911,12913,5076,2,PERF
42283322750000,PI,IP,001,28,13244,13246,5076,2,PERF
42283322750000,PI,IP,001,29,13533,13535,5076,2,PERF
42283322760000,PI,IP,001,1,11362,17615,6868,6253,PERF
42283322770000,PI,IP,001,1,11501,15032,4535,3531,PERF
42283322780000,PI,IP,001,1,9707,15124,6338,5417,PERF
42283322790000,PI,IP,001,1,9181,12931,4859,3750,PERF
42283322800000,PI,IP,001,1,9190,12923,5018,3733,PERF
42283322810000,PI,IP,001,1,9425,14831,5515,5406,PERF
42283322820000,PI,IP,001,1,10145,14263,4875,4118,PERF
42283322840000,PI,IP,001,1,9047,9050,4849,3,PERF
42283322840000,PI,IP,001,2,9087,9090,4849,3,PERF
42283322840000,PI,IP,001,3,9127,9130,4849,3,PERF
42283322840000,PI,IP,001,4,9167,9170,4849,3,PERF
42283322840000,PI,IP,001,5,9207,9210,4849,3,PERF
42283322840000,PI,IP,001,6,9247,9250,4849,3,PERF
42283322840000,PI,IP,001,7,9322,9325,4849,3,PERF
42283322840000,PI,IP,001,8,9362,9365,4849,3,PERF
42283322840000,PI,IP,001,9,9402,9405,4849,3,PERF
42283322840000,PI,IP,001,10,9442,9445,4849,3,PERF
42283322840000,PI,IP,001,11,9482,9485,4849,3,PERF
42283322840000,PI,IP,001,12,9522,9525,4849,3,PERF
42283322840000,PI,IP,001,13,9597,9600,4849,3,PERF
42283322840000,PI,IP,001,14,9637,9640,4849,3,PERF
42283322840000,PI,IP,001,15,9677,9680,4849,3,PERF
42283322840000,PI,IP,001,16,9717,9720,4849,3,PERF
42283322840000,PI,IP,001,17,9757,9760,4849,3,PERF
42283322840000,PI,IP,001,18,9797,9800,4849,3,PERF
42283322840000,PI,IP,001,19,9872,9875,4849,3,PERF
42283322840000,PI,IP,001,20,9912,9915,4849,3,PERF
42283322840000,PI,IP,001,21,9952,9955,4849,3,PERF
42283322840000,PI,IP,001,22,9992,9995,4849,3,PERF
42283322840000,PI,IP,001,23,10032,10035,4849,3,PERF
42283322840000,PI,IP,001,24,10072,10075,4849,3,PERF
42283322840000,PI,IP,001,25,10147,10150,4849,3,PERF
42283322840000,PI,IP,001,26,10187,10190,4849,3,PERF
42283322840000,PI,IP,001,27,10227,10230,4849,3,PERF
42283322840000,PI,IP,001,28,10267,10270,4849,3,PERF
42283322840000,PI,IP,001,29,10307,10310,4849,3,PERF
42283322840000,PI,IP,001,30,10347,10350,4849,3,PERF
42283322840000,PI,IP,001,31,10422,10425,4849,3,PERF
42283322840000,PI,IP,001,32,10462,10465,4849,3,PERF
42283322840000,PI,IP,001,33,10502,10505,4849,3,PERF
42283322840000,PI,IP,001,34,10542,10545,4849,3,PERF
42283322840000,PI,IP,001,35,10582,10585,4849,3,PERF
42283322840000,PI,IP,001,36,10622,10625,4849,3,PERF
42283322840000,PI,IP,001,37,10697,10700,4849,3,PERF
42283322840000,PI,IP,001,38,10737,10740,4849,3,PERF
42283322840000,PI,IP,001,39,10777,10780,4849,3,PERF
42283322840000,PI,IP,001,40,10817,10820,4849,3,PERF
42283322840000,PI,IP,001,41,10857,10860,4849,3,PERF
42283322840000,PI,IP,001,42,10897,10900,4849,3,PERF
42283322840000,PI,IP,001,43,10972,10975,4849,3,PERF
42283322840000,PI,IP,001,44,11012,11015,4849,3,PERF
42283322840000,PI,IP,001,45,11052,11055,4849,3,PERF
42283322840000,PI,IP,001,46,11092,11095,4849,3,PERF
42283322840000,PI,IP,001,47,11132,11135,4849,3,PERF
42283322840000,PI,IP,001,48,11172,11175,4849,3,PERF
42283322840000,PI,IP,001,49,11247,11250,4849,3,PERF
42283322840000,PI,IP,001,50,11287,11290,4849,3,PERF
42283322840000,PI,IP,001,51,11327,11330,4849,3,PERF
42283322840000,PI,IP,001,52,11367,11370,4849,3,PERF
42283322840000,PI,IP,001,53,11407,11410,4849,3,PERF
42283322840000,PI,IP,001,54,11447,11450,4849,3,PERF
42283322840000,PI,IP,001,55,11522,11525,4849,3,PERF
42283322840000,PI,IP,001,56,11562,11565,4849,3,PERF
42283322840000,PI,IP,001,57,11602,11605,4849,3,PERF
42283322840000,PI,IP,001,58,11642,11645,4849,3,PERF
42283322840000,PI,IP,001,59,11682,11685,4849,3,PERF
42283322840000,PI,IP,001,60,11722,11725,4849,3,PERF
42283322840000,PI,IP,001,61,11797,11800,4849,3,PERF
42283322840000,PI,IP,001,62,11837,11840,4849,3,PERF
42283322840000,PI,IP,001,63,11877,11880,4849,3,PERF
42283322840000,PI,IP,001,64,11917,11920,4849,3,PERF
42283322840000,PI,IP,001,65,11957,11960,4849,3,PERF
42283322840000,PI,IP,001,66,11997,12000,4849,3,PERF
42283322840000,PI,IP,001,67,12072,12075,4849,3,PERF
42283322840000,PI,IP,001,68,12112,12115,4849,3,PERF
42283322840000,PI,IP,001,69,12152,12155,4849,3,PERF
42283322840000,PI,IP,001,70,12192,12195,4849,3,PERF
42283322840000,PI,IP,001,71,12232,12235,4849,3,PERF
42283322840000,PI,IP,001,72,12272,12275,4849,3,PERF
42283322840000,PI,IP,001,73,12347,12350,4849,3,PERF
42283322840000,PI,IP,001,74,12387,12390,4849,3,PERF
42283322840000,PI,IP,001,75,12427,12430,4849,3,PERF
42283322840000,PI,IP,001,76,12467,12470,4849,3,PERF
42283322840000,PI,IP,001,77,12507,12510,4849,3,PERF
42283322840000,PI,IP,001,78,12547,12550,4849,3,PERF
42283322840000,PI,IP,001,79,12622,12625,4849,3,PERF
42283322840000,PI,IP,001,80,12662,12665,4849,3,PERF
42283322840000,PI,IP,001,81,12702,12705,4849,3,PERF
42283322840000,PI,IP,001,82,12742,12745,4849,3,PERF
42283322840000,PI,IP,001,83,12782,12785,4849,3,PERF
42283322840000,PI,IP,001,84,12822,12825,4849,3,PERF
42283322840000,PI,IP,001,85,12897,12900,4849,3,PERF
42283322840000,PI,IP,001,86,12937,12940,4849,3,PERF
42283322840000,PI,IP,001,87,12977,12980,4849,3,PERF
42283322840000,PI,IP,001,88,13017,13020,4849,3,PERF
42283322840000,PI,IP,001,89,13057,13060,4849,3,PERF
42283322840000,PI,IP,001,90,13097,13100,4849,3,PERF
42283322850000,PI,IP,001,1,11138,17081,6228,5943,PERF
42283322860000,PI,IP,001,1,9904,15353,6394,5449,PERF
42283322870000,PI,IP,001,1,9157,13755,5108,4598,PERF
42283322880000,PI,IP,001,1,9101,14428,6420,5327,PERF
42283322900000,PI,IP,001,1,10875,16588,6410,5713,PERF
42283322910000,PI,IP,001,1,10275,12264,3530,1989,PERF
42283322950000,PI,IP,001,1,7974,12480,5020,4506,PERF
42283322980000,PI,IP,001,1,11044,17814,7315,6770,PERF
42283322990100,PI,IP,001,1,10198,10201,4614,3,PERF
42283322990100,PI,IP,001,2,10237,10240,4614,3,PERF
42283322990100,PI,IP,001,3,10276,10279,4614,3,PERF
42283322990100,PI,IP,001,4,10314,10317,4614,3,PERF
42283322990100,PI,IP,001,5,10353,10356,4614,3,PERF
42283322990100,PI,IP,001,6,10392,10395,4614,3,PERF
42283322990100,PI,IP,001,7,10471,10474,4614,3,PERF
42283322990100,PI,IP,001,8,10510,10513,4614,3,PERF
42283322990100,PI,IP,001,9,10544,10547,4614,3,PERF
42283322990100,PI,IP,001,10,10573,10576,4614,3,PERF
42283322990100,PI,IP,001,11,10614,10617,4614,3,PERF
42283322990100,PI,IP,001,12,10659,10662,4614,3,PERF
42283322990100,PI,IP,001,13,10741,10744,4614,3,PERF
42283322990100,PI,IP,001,14,10781,10784,4614,3,PERF
42283322990100,PI,IP,001,15,10819,10822,4614,3,PERF
42283322990100,PI,IP,001,16,10861,10864,4614,3,PERF
42283322990100,PI,IP,001,17,10899,10902,4614,3,PERF
42283322990100,PI,IP,001,18,10938,10941,4614,3,PERF
42283322990100,PI,IP,001,19,11017,11020,4614,3,PERF
42283322990100,PI,IP,001,20,11056,11059,4614,3,PERF
42283322990100,PI,IP,001,21,11095,11098,4614,3,PERF
42283322990100,PI,IP,001,22,11134,11137,4614,3,PERF
42283322990100,PI,IP,001,23,11172,11175,4614,3,PERF
42283322990100,PI,IP,001,24,11211,11214,4614,3,PERF
42283322990100,PI,IP,001,25,11290,11293,4614,3,PERF
42283322990100,PI,IP,001,26,11329,11332,4614,3,PERF
42283322990100,PI,IP,001,27,11368,11371,4614,3,PERF
42283322990100,PI,IP,001,28,11407,11410,4614,3,PERF
42283322990100,PI,IP,001,29,11446,11449,4614,3,PERF
42283322990100,PI,IP,001,30,11484,11487,4614,3,PERF
42283322990100,PI,IP,001,31,11563,11566,4614,3,PERF
42283322990100,PI,IP,001,32,11602,11605,4614,3,PERF
42283322990100,PI,IP,001,33,11644,11647,4614,3,PERF
42283322990100,PI,IP,001,34,11684,11687,4614,3,PERF
42283322990100,PI,IP,001,35,11722,11725,4614,3,PERF
42283322990100,PI,IP,001,36,11764,11767,4614,3,PERF
42283322990100,PI,IP,001,37,11833,11836,4614,3,PERF
42283322990100,PI,IP,001,38,11875,11878,4614,3,PERF
42283322990100,PI,IP,001,39,11914,11917,4614,3,PERF
42283322990100,PI,IP,001,40,11953,11956,4614,3,PERF
42283322990100,PI,IP,001,41,11992,11995,4614,3,PERF
42283322990100,PI,IP,001,42,12030,12033,4614,3,PERF
42283322990100,PI,IP,001,43,12109,12112,4614,3,PERF
42283322990100,PI,IP,001,44,12148,12151,4614,3,PERF
42283322990100,PI,IP,001,45,12187,12190,4614,3,PERF
42283322990100,PI,IP,001,46,12226,12229,4614,3,PERF
42283322990100,PI,IP,001,47,12265,12268,4614,3,PERF
42283322990100,PI,IP,001,48,12304,12307,4614,3,PERF
42283322990100,PI,IP,001,49,12383,12386,4614,3,PERF
42283322990100,PI,IP,001,50,12421,12424,4614,3,PERF
42283322990100,PI,IP,001,51,12460,12463,4614,3,PERF
42283322990100,PI,IP,001,52,12499,12502,4614,3,PERF
42283322990100,PI,IP,001,53,12540,12543,4614,3,PERF
42283322990100,PI,IP,001,54,12581,12584,4614,3,PERF
42283322990100,PI,IP,001,55,12650,12653,4614,3,PERF
42283322990100,PI,IP,001,56,12694,12697,4614,3,PERF
42283322990100,PI,IP,001,57,12733,12736,4614,3,PERF
42283322990100,PI,IP,001,58,12772,12775,4614,3,PERF
42283322990100,PI,IP,001,59,12811,12814,4614,3,PERF
42283322990100,PI,IP,001,60,12850,12853,4614,3,PERF
42283322990100,PI,IP,001,61,12929,12932,4614,3,PERF
42283322990100,PI,IP,001,62,12967,12970,4614,3,PERF
42283322990100,PI,IP,001,63,13006,13009,4614,3,PERF
42283322990100,PI,IP,001,64,13045,13048,4614,3,PERF
42283322990100,PI,IP,001,65,13084,13087,4614,3,PERF
42283322990100,PI,IP,001,66,13123,13126,4614,3,PERF
42283322990100,PI,IP,001,67,13202,13205,4614,3,PERF
42283322990100,PI,IP,001,68,13241,13244,4614,3,PERF
42283322990100,PI,IP,001,69,13279,13282,4614,3,PERF
42283322990100,PI,IP,001,70,13318,13321,4614,3,PERF
42283322990100,PI,IP,001,71,13357,13360,4614,3,PERF
42283322990100,PI,IP,001,72,13396,13399,4614,3,PERF
42283322990100,PI,IP,001,73,13475,13478,4614,3,PERF
42283322990100,PI,IP,001,74,13514,13517,4614,3,PERF
42283322990100,PI,IP,001,75,13556,13559,4614,3,PERF
42283322990100,PI,IP,001,76,13596,13599,4614,3,PERF
42283322990100,PI,IP,001,77,13636,13639,4614,3,PERF
42283322990100,PI,IP,001,78,13674,13677,4614,3,PERF
42283322990100,PI,IP,001,79,13748,13751,4614,3,PERF
42283322990100,PI,IP,001,80,13787,13790,4614,3,PERF
42283322990100,PI,IP,001,81,13825,13828,4614,3,PERF
42283322990100,PI,IP,001,82,13864,13867,4614,3,PERF
42283322990100,PI,IP,001,83,13903,13906,4614,3,PERF
42283322990100,PI,IP,001,84,13942,13945,4614,3,PERF
42283322990100,PI,IP,001,85,14021,14024,4614,3,PERF
42283322990100,PI,IP,001,86,14060,14063,4614,3,PERF
42283322990100,PI,IP,001,87,14099,14102,4614,3,PERF
42283322990100,PI,IP,001,88,14137,14140,4614,3,PERF
42283322990100,PI,IP,001,89,14176,14179,4614,3,PERF
42283322990100,PI,IP,001,90,14215,14218,4614,3,PERF
42283323000000,PI,IP,001,1,11394,11604,4518,210,PERF
42283323000000,PI,IP,001,2,11790,11982,4518,192,PERF
42283323000000,PI,IP,001,3,12098,12438,4518,340,PERF
42283323000000,PI,IP,001,4,12492,12786,4518,294,PERF
42283323000000,PI,IP,001,5,12908,13252,4518,344,PERF
42283323000000,PI,IP,001,6,13368,13760,4518,392,PERF
42283323000000,PI,IP,001,7,13880,14158,4518,278,PERF
42283323000000,PI,IP,001,8,14268,14588,4518,320,PERF
42283323010000,PI,IP,001,1,10718,14492,4850,3774,PERF
42283323020100,PI,IP,001,1,11313,16654,6247,5341,PERF
42283323040000,PI,IP,002,1,9526,15871,7554,6345,PERF
42283323040000,PI,PT,001,1,15726,15871,7554,145,PERF
42283323050000,PI,IP,001,1,7873,7876,5273,3,PERF
42283323050000,PI,IP,001,2,7913,7916,5273,3,PERF
42283323050000,PI,IP,001,3,7953,7956,5273,3,PERF
42283323050000,PI,IP,001,4,7993,7996,5273,3,PERF
42283323050000,PI,IP,001,5,8033,8036,5273,3,PERF
42283323050000,PI,IP,001,6,8073,8076,5273,3,PERF
42283323050000,PI,IP,001,7,8148,8151,5273,3,PERF
42283323050000,PI,IP,001,8,8188,8191,5273,3,PERF
42283323050000,PI,IP,001,9,8228,8231,5273,3,PERF
42283323050000,PI,IP,001,10,8268,8271,5273,3,PERF
42283323050000,PI,IP,001,11,8308,8311,5273,3,PERF
42283323050000,PI,IP,001,12,8348,8351,5273,3,PERF
42283323050000,PI,IP,001,13,8423,8426,5273,3,PERF
42283323050000,PI,IP,001,14,8463,8466,5273,3,PERF
42283323050000,PI,IP,001,15,8503,8506,5273,3,PERF
42283323050000,PI,IP,001,16,8543,8546,5273,3,PERF
42283323050000,PI,IP,001,17,8583,8586,5273,3,PERF
42283323050000,PI,IP,001,18,8623,8626,5273,3,PERF
42283323050000,PI,IP,001,19,8698,8701,5273,3,PERF
42283323050000,PI,IP,001,20,8738,8741,5273,3,PERF
42283323050000,PI,IP,001,21,8778,8781,5273,3,PERF
42283323050000,PI,IP,001,22,8818,8821,5273,3,PERF
42283323050000,PI,IP,001,23,8858,8861,5273,3,PERF
42283323050000,PI,IP,001,24,8898,8901,5273,3,PERF
42283323050000,PI,IP,001,25,8973,8976,5273,3,PERF
42283323050000,PI,IP,001,26,9013,9016,5273,3,PERF
42283323050000,PI,IP,001,27,9053,9056,5273,3,PERF
42283323050000,PI,IP,001,28,9093,9096,5273,3,PERF
42283323050000,PI,IP,001,29,9133,9136,5273,3,PERF
42283323050000,PI,IP,001,30,9173,9176,5273,3,PERF
42283323050000,PI,IP,001,31,9248,9251,5273,3,PERF
42283323050000,PI,IP,001,32,9288,9291,5273,3,PERF
42283323050000,PI,IP,001,33,9328,9331,5273,3,PERF
42283323050000,PI,IP,001,34,9368,9371,5273,3,PERF
42283323050000,PI,IP,001,35,9408,9411,5273,3,PERF
42283323050000,PI,IP,001,36,9523,9526,5273,3,PERF
42283323050000,PI,IP,001,37,9563,9566,5273,3,PERF
42283323050000,PI,IP,001,38,9603,9606,5273,3,PERF
42283323050000,PI,IP,001,39,9643,9646,5273,3,PERF
42283323050000,PI,IP,001,40,9683,9686,5273,3,PERF
42283323050000,PI,IP,001,41,9723,9726,5273,3,PERF
42283323050000,PI,IP,001,42,9798,9801,5273,3,PERF
42283323050000,PI,IP,001,43,9838,9841,5273,3,PERF
42283323050000,PI,IP,001,44,9878,9881,5273,3,PERF
42283323050000,PI,IP,001,45,9918,9921,5273,3,PERF
42283323050000,PI,IP,001,46,9958,9961,5273,3,PERF
42283323050000,PI,IP,001,47,9998,10001,5273,3,PERF
42283323050000,PI,IP,001,48,10073,10076,5273,3,PERF
42283323050000,PI,IP,001,49,10113,10116,5273,3,PERF
42283323050000,PI,IP,001,50,10153,10156,5273,3,PERF
42283323050000,PI,IP,001,51,10193,10196,5273,3,PERF
42283323050000,PI,IP,001,52,10233,10236,5273,3,PERF
42283323050000,PI,IP,001,53,10273,10276,5273,3,PERF
42283323050000,PI,IP,001,54,10348,10351,5273,3,PERF
42283323050000,PI,IP,001,55,10388,10391,5273,3,PERF
42283323050000,PI,IP,001,56,10428,10431,5273,3,PERF
42283323050000,PI,IP,001,57,10468,10471,5273,3,PERF
42283323050000,PI,IP,001,58,10508,10511,5273,3,PERF
42283323050000,PI,IP,001,59,10548,10551,5273,3,PERF
42283323050000,PI,IP,001,60,10623,10626,5273,3,PERF
42283323050000,PI,IP,001,61,10663,10666,5273,3,PERF
42283323050000,PI,IP,001,62,10703,10706,5273,3,PERF
42283323050000,PI,IP,001,63,10743,10746,5273,3,PERF
42283323050000,PI,IP,001,64,10783,10786,5273,3,PERF
42283323050000,PI,IP,001,65,10823,10826,5273,3,PERF
42283323050000,PI,IP,001,66,10898,10901,5273,3,PERF
42283323050000,PI,IP,001,67,10938,10941,5273,3,PERF
42283323050000,PI,IP,001,68,10978,10981,5273,3,PERF
42283323050000,PI,IP,001,69,11018,11021,5273,3,PERF
42283323050000,PI,IP,001,70,11058,11061,5273,3,PERF
42283323050000,PI,IP,001,71,11098,11101,5273,3,PERF
42283323050000,PI,IP,001,72,11173,11176,5273,3,PERF
42283323050000,PI,IP,001,73,11213,11216,5273,3,PERF
42283323050000,PI,IP,001,74,11253,11256,5273,3,PERF
42283323050000,PI,IP,001,75,11293,11296,5273,3,PERF
42283323050000,PI,IP,001,76,11333,11336,5273,3,PERF
42283323050000,PI,IP,001,77,11373,11376,5273,3,PERF
42283323050000,PI,IP,001,78,11448,11451,5273,3,PERF
42283323050000,PI,IP,001,79,11488,11491,5273,3,PERF
42283323050000,PI,IP,001,80,11528,11531,5273,3,PERF
42283323050000,PI,IP,001,81,11568,11571,5273,3,PERF
42283323050000,PI,IP,001,82,11608,11611,5273,3,PERF
42283323050000,PI,IP,001,83,11648,11651,5273,3,PERF
42283323050000,PI,IP,001,84,11723,11726,5273,3,PERF
42283323050000,PI,IP,001,85,11763,11766,5273,3,PERF
42283323050000,PI,IP,001,86,11803,11806,5273,3,PERF
42283323050000,PI,IP,001,87,11843,11846,5273,3,PERF
42283323050000,PI,IP,001,88,11883,11886,5273,3,PERF
42283323050000,PI,IP,001,89,11923,11926,5273,3,PERF
42283323050000,PI,IP,001,90,11998,12001,5273,3,PERF
42283323050000,PI,IP,001,91,12038,12041,5273,3,PERF
42283323050000,PI,IP,001,92,12078,12081,5273,3,PERF
42283323050000,PI,IP,001,93,12118,12121,5273,3,PERF
42283323050000,PI,IP,001,94,12158,12161,5273,3,PERF
42283323050000,PI,IP,001,95,12198,12201,5273,3,PERF
42283323050000,PI,IP,001,96,12273,12276,5273,3,PERF
42283323050000,PI,IP,001,97,12313,12316,5273,3,PERF
42283323050000,PI,IP,001,98,12353,12356,5273,3,PERF
42283323050000,PI,IP,001,99,12393,12396,5273,3,PERF
42283323050000,PI,IP,001,100,12433,12436,5273,3,PERF
42283323050000,PI,IP,001,101,12473,12476,5273,3,PERF
42283323060000,PI,IP,001,1,10110,10113,4623,3,PERF
42283323060000,PI,IP,001,2,10150,10153,4623,3,PERF
42283323060000,PI,IP,001,3,10190,10193,4623,3,PERF
42283323060000,PI,IP,001,4,10229,10232,4623,3,PERF
42283323060000,PI,IP,001,5,10269,10272,4623,3,PERF
42283323060000,PI,IP,001,6,10309,10312,4623,3,PERF
42283323060000,PI,IP,001,7,10388,10391,4623,3,PERF
42283323060000,PI,IP,001,8,10428,10431,4623,3,PERF
42283323060000,PI,IP,001,9,10468,10471,4623,3,PERF
42283323060000,PI,IP,001,10,10507,10510,4623,3,PERF
42283323060000,PI,IP,001,11,10547,10550,4623,3,PERF
42283323060000,PI,IP,001,12,10587,10590,4623,3,PERF
42283323060000,PI,IP,001,13,10666,10669,4623,3,PERF
42283323060000,PI,IP,001,14,10706,10709,4623,3,PERF
42283323060000,PI,IP,001,15,10746,10749,4623,3,PERF
42283323060000,PI,IP,001,16,10785,10788,4623,3,PERF
42283323060000,PI,IP,001,17,10825,10828,4623,3,PERF
42283323060000,PI,IP,001,18,10865,10868,4623,3,PERF
42283323060000,PI,IP,001,19,10944,10947,4623,3,PERF
42283323060000,PI,IP,001,20,10984,10987,4623,3,PERF
42283323060000,PI,IP,001,21,11024,11027,4623,3,PERF
42283323060000,PI,IP,001,22,11063,11066,4623,3,PERF
42283323060000,PI,IP,001,23,11103,11106,4623,3,PERF
42283323060000,PI,IP,001,24,11143,11146,4623,3,PERF
42283323060000,PI,IP,001,25,11222,11225,4623,3,PERF
42283323060000,PI,IP,001,26,11262,11265,4623,3,PERF
42283323060000,PI,IP,001,27,11302,11305,4623,3,PERF
42283323060000,PI,IP,001,28,11341,11344,4623,3,PERF
42283323060000,PI,IP,001,29,11381,11384,4623,3,PERF
42283323060000,PI,IP,001,30,11421,11424,4623,3,PERF
42283323060000,PI,IP,001,31,11500,11503,4623,3,PERF
42283323060000,PI,IP,001,32,11540,11543,4623,3,PERF
42283323060000,PI,IP,001,33,11580,11583,4623,3,PERF
42283323060000,PI,IP,001,34,11619,11622,4623,3,PERF
42283323060000,PI,IP,001,35,11659,11662,4623,3,PERF
42283323060000,PI,IP,001,36,11699,11702,4623,3,PERF
42283323060000,PI,IP,001,37,11778,11781,4623,3,PERF
42283323060000,PI,IP,001,38,11818,11821,4623,3,PERF
42283323060000,PI,IP,001,39,11858,11861,4623,3,PERF
42283323060000,PI,IP,001,40,11897,11900,4623,3,PERF
42283323060000,PI,IP,001,41,11937,11940,4623,3,PERF
42283323060000,PI,IP,001,42,11977,11980,4623,3,PERF
42283323060000,PI,IP,001,43,12056,12059,4623,3,PERF
42283323060000,PI,IP,001,44,12096,12099,4623,3,PERF
42283323060000,PI,IP,001,45,12136,12139,4623,3,PERF
42283323060000,PI,IP,001,46,12175,12178,4623,3,PERF
42283323060000,PI,IP,001,47,12215,12218,4623,3,PERF
42283323060000,PI,IP,001,48,12255,12258,4623,3,PERF
42283323060000,PI,IP,001,49,12334,12337,4623,3,PERF
42283323060000,PI,IP,001,50,12374,12377,4623,3,PERF
42283323060000,PI,IP,001,51,12414,12417,4623,3,PERF
42283323060000,PI,IP,001,52,12453,12456,4623,3,PERF
42283323060000,PI,IP,001,53,12493,12496,4623,3,PERF
42283323060000,PI,IP,001,54,12533,12536,4623,3,PERF
42283323060000,PI,IP,001,55,12612,12615,4623,3,PERF
42283323060000,PI,IP,001,56,12652,12655,4623,3,PERF
42283323060000,PI,IP,001,57,12692,12695,4623,3,PERF
42283323060000,PI,IP,001,58,12731,12734,4623,3,PERF
42283323060000,PI,IP,001,59,12771,12774,4623,3,PERF
42283323060000,PI,IP,001,60,12811,12814,4623,3,PERF
42283323060000,PI,IP,001,61,12890,12893,4623,3,PERF
42283323060000,PI,IP,001,62,12930,12933,4623,3,PERF
42283323060000,PI,IP,001,63,12970,12973,4623,3,PERF
42283323060000,PI,IP,001,64,13009,13012,4623,3,PERF
42283323060000,PI,IP,001,65,13049,13052,4623,3,PERF
42283323060000,PI,IP,001,66,13089,13092,4623,3,PERF
42283323060000,PI,IP,001,67,13168,13171,4623,3,PERF
42283323060000,PI,IP,001,68,13208,13211,4623,3,PERF
42283323060000,PI,IP,001,69,13248,13251,4623,3,PERF
42283323060000,PI,IP,001,70,13287,13290,4623,3,PERF
42283323060000,PI,IP,001,71,13327,13330,4623,3,PERF
42283323060000,PI,IP,001,72,13367,13370,4623,3,PERF
42283323060000,PI,IP,001,73,13446,13449,4623,3,PERF
42283323060000,PI,IP,001,74,13486,13489,4623,3,PERF
42283323060000,PI,IP,001,75,13526,13529,4623,3,PERF
42283323060000,PI,IP,001,76,13565,13568,4623,3,PERF
42283323060000,PI,IP,001,77,13605,13608,4623,3,PERF
42283323060000,PI,IP,001,78,13645,13648,4623,3,PERF
42283323060000,PI,IP,001,79,13724,13727,4623,3,PERF
42283323060000,PI,IP,001,80,13764,13767,4623,3,PERF
42283323060000,PI,IP,001,81,13804,13807,4623,3,PERF
42283323060000,PI,IP,001,82,13843,13846,4623,3,PERF
42283323060000,PI,IP,001,83,13883,13886,4623,3,PERF
42283323060000,PI,IP,001,84,13923,13926,4623,3,PERF
42283323060000,PI,IP,001,85,14002,14005,4623,3,PERF
42283323060000,PI,IP,001,86,14042,14045,4623,3,PERF
42283323060000,PI,IP,001,87,14082,14085,4623,3,PERF
42283323060000,PI,IP,001,88,14121,14124,4623,3,PERF
42283323060000,PI,IP,001,89,14161,14164,4623,3,PERF
42283323060000,PI,IP,001,90,14201,14204,4623,3,PERF
42283323070000,PI,IP,001,1,9303,9306,5133,3,PERF
42283323070000,PI,IP,001,2,9343,9346,5133,3,PERF
42283323070000,PI,IP,001,3,9382,9385,5133,3,PERF
42283323070000,PI,IP,001,4,9422,9425,5133,3,PERF
42283323070000,PI,IP,001,5,9462,9465,5133,3,PERF
42283323070000,PI,IP,001,6,9501,9504,5133,3,PERF
42283323070000,PI,IP,001,7,9580,9583,5133,3,PERF
42283323070000,PI,IP,001,8,9620,9623,5133,3,PERF
42283323070000,PI,IP,001,9,9660,9663,5133,3,PERF
42283323070000,PI,IP,001,10,9700,9703,5133,3,PERF
42283323070000,PI,IP,001,11,9739,9742,5133,3,PERF
42283323070000,PI,IP,001,12,9779,9782,5133,3,PERF
42283323070000,PI,IP,001,13,9858,9861,5133,3,PERF
42283323070000,PI,IP,001,14,9898,9901,5133,3,PERF
42283323070000,PI,IP,001,15,9937,9940,5133,3,PERF
42283323070000,PI,IP,001,16,9977,9980,5133,3,PERF
42283323070000,PI,IP,001,17,10017,10020,5133,3,PERF
42283323070000,PI,IP,001,18,10057,10060,5133,3,PERF
42283323070000,PI,IP,001,19,10136,10139,5133,3,PERF
42283323070000,PI,IP,001,20,10175,10178,5133,3,PERF
42283323070000,PI,IP,001,21,10215,10218,5133,3,PERF
42283323070000,PI,IP,001,22,10255,10258,5133,3,PERF
42283323070000,PI,IP,001,23,10294,10297,5133,3,PERF
42283323070000,PI,IP,001,24,10334,10337,5133,3,PERF
42283323070000,PI,IP,001,25,10413,10416,5133,3,PERF
42283323070000,PI,IP,001,26,10453,10456,5133,3,PERF
42283323070000,PI,IP,001,27,10492,10495,5133,3,PERF
42283323070000,PI,IP,001,28,10532,10535,5133,3,PERF
42283323070000,PI,IP,001,29,10572,10575,5133,3,PERF
42283323070000,PI,IP,001,30,10612,10615,5133,3,PERF
42283323070000,PI,IP,001,31,10691,10694,5133,3,PERF
42283323070000,PI,IP,001,32,10730,10733,5133,3,PERF
42283323070000,PI,IP,001,33,10770,10773,5133,3,PERF
42283323070000,PI,IP,001,34,10810,10813,5133,3,PERF
42283323070000,PI,IP,001,35,10849,10852,5133,3,PERF
42283323070000,PI,IP,001,36,10889,10892,5133,3,PERF
42283323070000,PI,IP,001,37,10968,10971,5133,3,PERF
42283323070000,PI,IP,001,38,11008,11011,5133,3,PERF
42283323070000,PI,IP,001,39,11047,11050,5133,3,PERF
42283323070000,PI,IP,001,40,11087,11090,5133,3,PERF
42283323070000,PI,IP,001,41,11127,11130,5133,3,PERF
42283323070000,PI,IP,001,42,11167,11170,5133,3,PERF
42283323070000,PI,IP,001,43,11246,11249,5133,3,PERF
42283323070000,PI,IP,001,44,11285,11288,5133,3,PERF
42283323070000,PI,IP,001,45,11325,11328,5133,3,PERF
42283323070000,PI,IP,001,46,11365,11368,5133,3,PERF
42283323070000,PI,IP,001,47,11404,11407,5133,3,PERF
42283323070000,PI,IP,001,48,11444,11447,5133,3,PERF
42283323070000,PI,IP,001,49,11523,11526,5133,3,PERF
42283323070000,PI,IP,001,50,11563,11566,5133,3,PERF
42283323070000,PI,IP,001,51,11602,11605,5133,3,PERF
42283323070000,PI,IP,001,52,11642,11645,5133,3,PERF
42283323070000,PI,IP,001,53,11682,11685,5133,3,PERF
42283323070000,PI,IP,001,54,11722,11725,5133,3,PERF
42283323070000,PI,IP,001,55,11801,11804,5133,3,PERF
42283323070000,PI,IP,001,56,11840,11843,5133,3,PERF
42283323070000,PI,IP,001,57,11880,11883,5133,3,PERF
42283323070000,PI,IP,001,58,11920,11923,5133,3,PERF
42283323070000,PI,IP,001,59,11959,11962,5133,3,PERF
42283323070000,PI,IP,001,60,11999,12007,5133,8,PERF
42283323070000,PI,IP,001,61,12073,12080,5133,7,PERF
42283323070000,PI,IP,001,62,12118,12121,5133,3,PERF
42283323070000,PI,IP,001,63,12157,12160,5133,3,PERF
42283323070000,PI,IP,001,64,12197,12200,5133,3,PERF
42283323070000,PI,IP,001,65,12237,12240,5133,3,PERF
42283323070000,PI,IP,001,66,12277,12280,5133,3,PERF
42283323070000,PI,IP,001,67,12356,12359,5133,3,PERF
42283323070000,PI,IP,001,68,12395,12398,5133,3,PERF
42283323070000,PI,IP,001,69,12435,12438,5133,3,PERF
42283323070000,PI,IP,001,70,12475,12478,5133,3,PERF
42283323070000,PI,IP,001,71,12514,12517,5133,3,PERF
42283323070000,PI,IP,001,72,12554,12557,5133,3,PERF
42283323070000,PI,IP,001,73,12633,12636,5133,3,PERF
42283323070000,PI,IP,001,74,12673,12676,5133,3,PERF
42283323070000,PI,IP,001,75,12712,12715,5133,3,PERF
42283323070000,PI,IP,001,76,12752,12755,5133,3,PERF
42283323070000,PI,IP,001,77,12792,12795,5133,3,PERF
42283323070000,PI,IP,001,78,12832,12835,5133,3,PERF
42283323070000,PI,IP,001,79,12898,12914,5133,16,PERF
42283323070000,PI,IP,001,80,12950,12953,5133,3,PERF
42283323070000,PI,IP,001,81,12990,12993,5133,3,PERF
42283323070000,PI,IP,001,82,13030,13033,5133,3,PERF
42283323070000,PI,IP,001,83,13069,13072,5133,3,PERF
42283323070000,PI,IP,001,84,13109,13112,5133,3,PERF
42283323070000,PI,IP,001,85,13188,13191,5133,3,PERF
42283323070000,PI,IP,001,86,13228,13231,5133,3,PERF
42283323070000,PI,IP,001,87,13267,13270,5133,3,PERF
42283323070000,PI,IP,001,88,13307,13310,5133,3,PERF
42283323070000,PI,IP,001,89,13347,13350,5133,3,PERF
42283323070000,PI,IP,001,90,13387,13390,5133,3,PERF
42283323070000,PI,IP,001,91,13466,13469,5133,3,PERF
42283323070000,PI,IP,001,92,13505,13508,5133,3,PERF
42283323070000,PI,IP,001,93,13545,13548,5133,3,PERF
42283323070000,PI,IP,001,94,13585,13588,5133,3,PERF
42283323070000,PI,IP,001,95,13624,13627,5133,3,PERF
42283323070000,PI,IP,001,96,13664,13667,5133,3,PERF
42283323100000,PI,IP,001,1,10311,15295,6108,4984,PERF
42283323130000,PI,IP,001,1,8345,12409,5083,4064,PERF
42283323140000,PI,IP,001,1,11048,16068,5562,5020,PERF
42283323150000,PI,IP,001,1,11262,16213,6530,4951,PERF
42283323160000,PI,IP,001,1,11408,18113,7321,6705,PERF
42283323170100,PI,IP,001,1,10831,16040,5739,5209,PERF
42283323180000,PI,IP,001,1,11238,16491,6210,5253,PERF
42283323190000,PI,IP,001,1,8622,8631,4810,9,PERF
42283323190000,PI,IP,001,2,8900,8909,4810,9,PERF
42283323190000,PI,IP,001,3,9190,9199,4810,9,PERF
42283323190000,PI,IP,001,4,9505,9507,4810,2,PERF
42283323190000,PI,IP,001,5,9821,9831,4810,10,PERF
42283323190000,PI,IP,001,6,10103,10112,4810,9,PERF
42283323190000,PI,IP,001,7,10415,10424,4810,9,PERF
42283323190000,PI,IP,001,8,10675,10684,4810,9,PERF
42283323190000,PI,IP,001,9,10933,10942,4810,9,PERF
42283323190000,PI,IP,001,10,11206,11215,4810,9,PERF
42283323190000,PI,IP,001,11,11415,11424,4810,9,PERF
42283323190000,PI,IP,001,12,11689,11698,4810,9,PERF
42283323190000,PI,IP,001,13,11959,11968,4810,9,PERF
42283323190000,PI,IP,001,14,12217,12227,4810,10,PERF
42283323190000,PI,IP,001,15,12535,12544,4810,9,PERF
42283323190000,PI,IP,001,16,12787,12796,4810,9,PERF
42283323200000,PI,IP,001,1,8715,8916,6577,201,PERF
42283323200000,PI,IP,001,2,9015,9216,6577,201,PERF
42283323200000,PI,IP,001,3,9315,9516,6577,201,PERF
42283323200000,PI,IP,001,4,9655,9816,6577,161,PERF
42283323200000,PI,IP,001,5,9915,10076,6577,161,PERF
42283323200000,PI,IP,001,6,10215,10416,6577,201,PERF
42283323200000,PI,IP,001,7,10515,10716,6577,201,PERF
42283323200000,PI,IP,001,8,10815,11015,6577,200,PERF
42283323200000,PI,IP,001,9,11115,11316,6577,201,PERF
42283323200000,PI,IP,001,10,11415,11616,6577,201,PERF
42283323200000,PI,IP,001,11,11715,11916,6577,201,PERF
42283323200000,PI,IP,001,12,12015,12216,6577,201,PERF
42283323200000,PI,IP,001,13,12315,12516,6577,201,PERF
42283323200000,PI,IP,001,14,12615,12816,6577,201,PERF
42283323200000,PI,IP,001,15,12915,13116,6577,201,PERF
42283323200000,PI,IP,001,16,13215,13416,6577,201,PERF
42283323200000,PI,IP,001,17,13515,13716,6577,201,PERF
42283323200000,PI,IP,001,18,13815,14016,6577,201,PERF
42283323200000,PI,IP,001,19,14115,14316,6577,201,PERF
42283323200000,PI,IP,001,20,14415,14616,6577,201,PERF
42283323230000,PI,IP,001,1,8665,8668,6838,3,PERF
42283323230000,PI,IP,001,2,8762,8765,6838,3,PERF
42283323230000,PI,IP,001,3,8860,8863,6838,3,PERF
42283323230000,PI,IP,001,4,8965,8968,6838,3,PERF
42283323230000,PI,IP,001,5,9066,9069,6838,3,PERF
42283323230000,PI,IP,001,6,9161,9164,6838,3,PERF
42283323230000,PI,IP,001,7,9266,9269,6838,3,PERF
42283323230000,PI,IP,001,8,9364,9367,6838,3,PERF
42283323230000,PI,IP,001,9,9462,9465,6838,3,PERF
42283323230000,PI,IP,001,10,9567,9570,6838,3,PERF
42283323230000,PI,IP,001,11,9665,9668,6838,3,PERF
42283323230000,PI,IP,001,12,9763,9766,6838,3,PERF
42283323230000,PI,IP,001,13,9874,9877,6838,3,PERF
42283323230000,PI,IP,001,14,9966,9969,6838,3,PERF
42283323230000,PI,IP,001,15,10064,10067,6838,3,PERF
42283323230000,PI,IP,001,16,10169,10172,6838,3,PERF
42283323230000,PI,IP,001,17,10267,10270,6838,3,PERF
42283323230000,PI,IP,001,18,10361,10364,6838,3,PERF
42283323230000,PI,IP,001,19,10470,10473,6838,3,PERF
42283323230000,PI,IP,001,20,10568,10571,6838,3,PERF
42283323230000,PI,IP,001,21,10666,10669,6838,3,PERF
42283323230000,PI,IP,001,22,10771,10774,6838,3,PERF
42283323230000,PI,IP,001,23,10869,10872,6838,3,PERF
42283323230000,PI,IP,001,24,10972,10975,6838,3,PERF
42283323230000,PI,IP,001,25,11072,11075,6838,3,PERF
42283323230000,PI,IP,001,26,11168,11171,6838,3,PERF
42283323230000,PI,IP,001,27,11268,11271,6838,3,PERF
42283323230000,PI,IP,001,28,11373,11376,6838,3,PERF
42283323230000,PI,IP,001,29,11471,11474,6838,3,PERF
42283323230000,PI,IP,001,30,11569,11572,6838,3,PERF
42283323230000,PI,IP,001,31,11674,11677,6838,3,PERF
42283323230000,PI,IP,001,32,11772,11775,6838,3,PERF
42283323230000,PI,IP,001,33,11867,11870,6838,3,PERF
42283323230000,PI,IP,001,34,11975,11978,6838,3,PERF
42283323230000,PI,IP,001,35,12073,12076,6838,3,PERF
42283323230000,PI,IP,001,36,12171,12174,6838,3,PERF
42283323230000,PI,IP,001,37,12276,12279,6838,3,PERF
42283323230000,PI,IP,001,38,12374,12377,6838,3,PERF
42283323230000,PI,IP,001,39,12472,12475,6838,3,PERF
42283323230000,PI,IP,001,40,12577,12580,6838,3,PERF
42283323230000,PI,IP,001,41,12625,12628,6838,3,PERF
42283323230000,PI,IP,001,42,12650,12653,6838,3,PERF
42283323230000,PI,IP,001,43,12675,12678,6838,3,PERF
42283323230000,PI,IP,001,44,12709,12712,6838,3,PERF
42283323230000,PI,IP,001,45,12773,12776,6838,3,PERF
42283323230000,PI,IP,001,46,12882,12885,6838,3,PERF
42283323230000,PI,IP,001,47,12976,12979,6838,3,PERF
42283323230000,PI,IP,001,48,13074,13077,6838,3,PERF
42283323230000,PI,IP,001,49,13179,13182,6838,3,PERF
42283323230000,PI,IP,001,50,13277,13280,6838,3,PERF
42283323230000,PI,IP,001,51,13375,13378,6838,3,PERF
42283323230000,PI,IP,001,52,13484,13487,6838,3,PERF
42283323230000,PI,IP,001,53,13578,13581,6838,3,PERF
42283323230000,PI,IP,001,54,13676,13679,6838,3,PERF
42283323230000,PI,IP,001,55,13781,13784,6838,3,PERF
42283323230000,PI,IP,001,56,13879,13882,6838,3,PERF
42283323230000,PI,IP,001,57,13977,13980,6838,3,PERF
42283323230000,PI,IP,001,58,14082,14085,6838,3,PERF
42283323230000,PI,IP,001,59,14180,14183,6838,3,PERF
42283323230000,PI,IP,001,60,14278,14281,6838,3,PERF
42283323230000,PI,IP,001,61,14383,14386,6838,3,PERF
42283323230000,PI,IP,001,62,14481,14484,6838,3,PERF
42283323230000,PI,IP,001,63,14579,14582,6838,3,PERF
42283323230000,PI,IP,001,64,14684,14688,6838,4,PERF
42283323230000,PI,IP,001,65,14783,14787,6838,4,PERF
42283323230000,PI,IP,001,66,14887,14891,6838,4,PERF
42283323230000,PI,IP,001,67,14905,14909,6838,4,PERF
42283323240000,PI,IP,001,1,8791,14983,6852,6192,PERF
42283323260000,PI,IP,001,1,7960,8193,5038,233,PERF
42283323260000,PI,IP,001,2,8269,8499,5038,230,PERF
42283323260000,PI,IP,001,3,8578,8811,5038,233,PERF
42283323260000,PI,IP,001,4,8887,9121,5038,234,PERF
42283323260000,PI,IP,001,5,9197,9430,5038,233,PERF
42283323260000,PI,IP,001,6,9506,9739,5038,233,PERF
42283323260000,PI,IP,001,7,9815,10048,5038,233,PERF
42283323260000,PI,IP,001,8,10124,10355,5038,231,PERF
42283323260000,PI,IP,001,9,10433,10666,5038,233,PERF
42283323260000,PI,IP,001,10,10742,10971,5038,229,PERF
42283323260000,PI,IP,001,11,11051,11285,5038,234,PERF
42283323260000,PI,IP,001,12,11361,11594,5038,233,PERF
42283323260000,PI,IP,001,13,11670,11903,5038,233,PERF
42283323260000,PI,IP,001,14,11979,12212,5038,233,PERF
42283323270000,PI,IP,001,1,10860,16033,5576,5173,PERF
42283323280000,PI,IP,001,1,8137,12201,5100,4064,PERF
42283323290000,PI,IP,001,1,8579,8680,3650,101,PERF
42283323290000,PI,IP,001,2,8769,8870,3650,101,PERF
42283323290000,PI,IP,001,3,8959,9060,3650,101,PERF
42283323290000,PI,IP,001,4,9149,9250,3650,101,PERF
42283323290000,PI,IP,001,5,9339,9440,3650,101,PERF
42283323290000,PI,IP,001,6,9529,9630,3650,101,PERF
42283323290000,PI,IP,001,7,9719,9820,3650,101,PERF
42283323290000,PI,IP,001,8,9909,10010,3650,101,PERF
42283323290000,PI,IP,001,9,10099,10200,3650,101,PERF
42283323290000,PI,IP,001,10,10289,10390,3650,101,PERF
42283323290000,PI,IP,001,11,10479,10580,3650,101,PERF
42283323290000,PI,IP,001,12,10669,10770,3650,101,PERF
42283323290000,PI,IP,001,13,10859,10960,3650,101,PERF
42283323290000,PI,IP,001,14,11049,11150,3650,101,PERF
42283323290000,PI,IP,001,15,11239,11340,3650,101,PERF
42283323290000,PI,IP,001,16,11429,11530,3650,101,PERF
42283323290000,PI,IP,001,17,11619,11720,3650,101,PERF
42283323290000,PI,IP,001,18,11809,11910,3650,101,PERF
42283323300000,PI,IP,001,1,9450,13733,5682,4283,PERF
42283323310000,PI,IP,001,1,8868,12723,5573,3855,PERF
42283323330000,PI,IP,001,1,9399,9851,4824,452,PERF
42283323330000,PI,IP,001,2,9899,10101,4824,202,PERF
42283323330000,PI,IP,001,3,10149,10351,4824,202,PERF
42283323330000,PI,IP,001,4,10399,10601,4824,202,PERF
42283323330000,PI,IP,001,5,10649,10851,4824,202,PERF
42283323330000,PI,IP,001,6,10899,11101,4824,202,PERF
42283323330000,PI,IP,001,7,11149,11351,4824,202,PERF
42283323330000,PI,IP,001,8,11399,11601,4824,202,PERF
42283323330000,PI,IP,001,9,11649,11851,4824,202,PERF
42283323330000,PI,IP,001,10,11899,12101,4824,202,PERF
42283323330000,PI,IP,001,11,12149,12351,4824,202,PERF
42283323330000,PI,IP,001,12,12399,12601,4824,202,PERF
42283323330000,PI,IP,001,13,12649,12851,4824,202,PERF
42283323330000,PI,IP,001,14,12899,13100,4824,201,PERF
42283323330000,PI,IP,001,15,13149,13318,4824,169,PERF
42283323330000,PI,IP,001,16,13339,13600,4824,261,PERF
42283323340000,PI,IP,001,1,8654,12120,3455,3466,OPENHOLE
42283323350000,PI,IP,001,1,9137,9347,5086,210,PERF
42283323350000,PI,IP,001,2,9414,9625,5086,211,PERF
42283323350000,PI,IP,001,3,9692,9902,5086,210,PERF
42283323350000,PI,IP,001,4,9969,10179,5086,210,PERF
42283323350000,PI,IP,001,5,10246,10456,5086,210,PERF
42283323350000,PI,IP,001,6,10523,10734,5086,211,PERF
42283323350000,PI,IP,001,7,10801,11011,5086,210,PERF
42283323350000,PI,IP,001,8,11078,11288,5086,210,PERF
42283323350000,PI,IP,001,9,11355,11565,5086,210,PERF
42283323350000,PI,IP,001,10,11632,11843,5086,211,PERF
42283323350000,PI,IP,001,11,11910,12120,5086,210,PERF
42283323350000,PI,IP,001,12,12187,12397,5086,210,PERF
42283323350000,PI,IP,001,13,12464,12674,5086,210,PERF
42283323350000,PI,IP,001,14,12741,12952,5086,211,PERF
42283323350000,PI,IP,001,15,13019,13229,5086,210,PERF
42283323360000,PI,IP,001,1,9349,14090,4970,4741,PERF
42283323370000,PI,IP,001,1,9200,14084,6184,4884,PERF
42283323380000,PI,IP,001,1,9013,15930,7138,6917,PERF
42283323400000,PI,IP,001,1,9700,15596,6630,5896,PERF
42283323420000,PI,IP,001,1,11300,17334,6710,6034,PERF
42283323440000,PI,IP,001,1,8128,12192,5026,4064,PERF
42283323450000,PI,IP,001,1,9643,9646,4986,3,PERF
42283323450000,PI,IP,001,2,9683,9686,4986,3,PERF
42283323450000,PI,IP,001,3,9724,9727,4986,3,PERF
42283323450000,PI,IP,001,4,9764,9767,4986,3,PERF
42283323450000,PI,IP,001,5,9804,9807,4986,3,PERF
42283323450000,PI,IP,001,6,9845,9848,4986,3,PERF
42283323450000,PI,IP,001,7,9924,9927,4986,3,PERF
42283323450000,PI,IP,001,8,9964,9967,4986,3,PERF
42283323450000,PI,IP,001,9,10004,10007,4986,3,PERF
42283323450000,PI,IP,001,10,10044,10047,4986,3,PERF
42283323450000,PI,IP,001,11,10085,10088,4986,3,PERF
42283323450000,PI,IP,001,12,10125,10128,4986,3,PERF
42283323450000,PI,IP,001,13,10204,10207,4986,3,PERF
42283323450000,PI,IP,001,14,10244,10247,4986,3,PERF
42283323450000,PI,IP,001,15,10285,10288,4986,3,PERF
42283323450000,PI,IP,001,16,10325,10328,4986,3,PERF
42283323450000,PI,IP,001,17,10365,10368,4986,3,PERF
42283323450000,PI,IP,001,18,10406,10409,4986,3,PERF
42283323450000,PI,IP,001,19,10485,10488,4986,3,PERF
42283323450000,PI,IP,001,20,10525,10528,4986,3,PERF
42283323450000,PI,IP,001,21,10565,10568,4986,3,PERF
42283323450000,PI,IP,001,22,10606,10609,4986,3,PERF
42283323450000,PI,IP,001,23,10646,10649,4986,3,PERF
42283323450000,PI,IP,001,24,10686,10689,4986,3,PERF
42283323450000,PI,IP,001,25,10765,10768,4986,3,PERF
42283323450000,PI,IP,001,26,10805,10808,4986,3,PERF
42283323450000,PI,IP,001,27,10846,10849,4986,3,PERF
42283323450000,PI,IP,001,28,10886,10889,4986,3,PERF
42283323450000,PI,IP,001,29,10926,10929,4986,3,PERF
42283323450000,PI,IP,001,30,10967,10970,4986,3,PERF
42283323450000,PI,IP,001,31,11046,11049,4986,3,PERF
42283323450000,PI,IP,001,32,11086,11089,4986,3,PERF
42283323450000,PI,IP,001,33,11126,11129,4986,3,PERF
42283323450000,PI,IP,001,34,11167,11170,4986,3,PERF
42283323450000,PI,IP,001,35,11207,11210,4986,3,PERF
42283323450000,PI,IP,001,36,11247,11250,4986,3,PERF
42283323450000,PI,IP,001,37,11326,11329,4986,3,PERF
42283323450000,PI,IP,001,38,11367,11370,4986,3,PERF
42283323450000,PI,IP,001,39,11407,11410,4986,3,PERF
42283323450000,PI,IP,001,40,11447,11450,4986,3,PERF
42283323450000,PI,IP,001,41,11487,11490,4986,3,PERF
42283323450000,PI,IP,001,42,11528,11531,4986,3,PERF
42283323450000,PI,IP,001,43,11607,11610,4986,3,PERF
42283323450000,PI,IP,001,44,11647,11650,4986,3,PERF
42283323450000,PI,IP,001,45,11687,11690,4986,3,PERF
42283323450000,PI,IP,001,46,11728,11731,4986,3,PERF
42283323450000,PI,IP,001,47,11768,11771,4986,3,PERF
42283323450000,PI,IP,001,48,11808,11811,4986,3,PERF
42283323450000,PI,IP,001,49,11887,11890,4986,3,PERF
42283323450000,PI,IP,001,50,11928,11931,4986,3,PERF
42283323450000,PI,IP,001,51,11968,11971,4986,3,PERF
42283323450000,PI,IP,001,52,12008,12011,4986,3,PERF
42283323450000,PI,IP,001,53,12048,12051,4986,3,PERF
42283323450000,PI,IP,001,54,12089,12092,4986,3,PERF
42283323450000,PI,IP,001,55,12168,12171,4986,3,PERF
42283323450000,PI,IP,001,56,12208,12211,4986,3,PERF
42283323450000,PI,IP,001,57,12248,12251,4986,3,PERF
42283323450000,PI,IP,001,58,12289,12292,4986,3,PERF
42283323450000,PI,IP,001,59,12329,12332,4986,3,PERF
42283323450000,PI,IP,001,60,12369,12372,4986,3,PERF
42283323450000,PI,IP,001,61,12448,12451,4986,3,PERF
42283323450000,PI,IP,001,62,12489,12492,4986,3,PERF
42283323450000,PI,IP,001,63,12529,12532,4986,3,PERF
42283323450000,PI,IP,001,64,12569,12572,4986,3,PERF
42283323450000,PI,IP,001,65,12610,12613,4986,3,PERF
42283323450000,PI,IP,001,66,12650,12653,4986,3,PERF
42283323450000,PI,IP,001,67,12729,12732,4986,3,PERF
42283323450000,PI,IP,001,68,12769,12772,4986,3,PERF
42283323450000,PI,IP,001,69,12809,12812,4986,3,PERF
42283323450000,PI,IP,001,70,12850,12853,4986,3,PERF
42283323450000,PI,IP,001,71,12890,12893,4986,3,PERF
42283323450000,PI,IP,001,72,12930,12933,4986,3,PERF
42283323450000,PI,IP,001,73,13009,13012,4986,3,PERF
42283323450000,PI,IP,001,74,13050,13053,4986,3,PERF
42283323450000,PI,IP,001,75,13090,13093,4986,3,PERF
42283323450000,PI,IP,001,76,13130,13133,4986,3,PERF
42283323450000,PI,IP,001,77,13171,13174,4986,3,PERF
42283323450000,PI,IP,001,78,13211,13214,4986,3,PERF
42283323450000,PI,IP,001,79,13290,13293,4986,3,PERF
42283323450000,PI,IP,001,80,13330,13333,4986,3,PERF
42283323450000,PI,IP,001,81,13371,13374,4986,3,PERF
42283323450000,PI,IP,001,82,13411,13414,4986,3,PERF
42283323450000,PI,IP,001,83,13451,13454,4986,3,PERF
42283323450000,PI,IP,001,84,13491,13494,4986,3,PERF
42283323450000,PI,IP,001,85,13570,13573,4986,3,PERF
42283323450000,PI,IP,001,86,13611,13614,4986,3,PERF
42283323450000,PI,IP,001,87,13651,13654,4986,3,PERF
42283323450000,PI,IP,001,88,13691,13694,4986,3,PERF
42283323450000,PI,IP,001,89,13732,13735,4986,3,PERF
42283323450000,PI,IP,001,90,13772,13775,4986,3,PERF
42283323460000,PI,IP,001,1,10359,14378,4882,4019,PERF
42283323480100,PI,IP,001,1,10493,15392,5568,4899,PERF
42283323490000,PI,IP,001,1,8082,8085,7093,3,PERF
42283323490000,PI,IP,001,2,8126,8129,7093,3,PERF
42283323490000,PI,IP,001,3,8170,8173,7093,3,PERF
42283323490000,PI,IP,001,4,8214,8217,7093,3,PERF
42283323490000,PI,IP,001,5,8258,8261,7093,3,PERF
42283323490000,PI,IP,001,6,8302,8305,7093,3,PERF
42283323490000,PI,IP,001,7,8383,8386,7093,3,PERF
42283323490000,PI,IP,001,8,8427,8430,7093,3,PERF
42283323490000,PI,IP,001,9,8471,8474,7093,3,PERF
42283323490000,PI,IP,001,10,8515,8518,7093,3,PERF
42283323490000,PI,IP,001,11,8559,8562,7093,3,PERF
42283323490000,PI,IP,001,12,8603,8606,7093,3,PERF
42283323490000,PI,IP,001,13,8684,8687,7093,3,PERF
42283323490000,PI,IP,001,14,8728,8731,7093,3,PERF
42283323490000,PI,IP,001,15,8772,8775,7093,3,PERF
42283323490000,PI,IP,001,16,8816,8819,7093,3,PERF
42283323490000,PI,IP,001,17,8860,8863,7093,3,PERF
42283323490000,PI,IP,001,18,8904,8907,7093,3,PERF
42283323490000,PI,IP,001,19,8985,8988,7093,3,PERF
42283323490000,PI,IP,001,20,9029,9032,7093,3,PERF
42283323490000,PI,IP,001,21,9073,9076,7093,3,PERF
42283323490000,PI,IP,001,22,9117,9120,7093,3,PERF
42283323490000,PI,IP,001,23,9161,9164,7093,3,PERF
42283323490000,PI,IP,001,24,9205,9208,7093,3,PERF
42283323490000,PI,IP,001,25,9286,9289,7093,3,PERF
42283323490000,PI,IP,001,26,9330,9333,7093,3,PERF
42283323490000,PI,IP,001,27,9374,9377,7093,3,PERF
42283323490000,PI,IP,001,28,9418,9421,7093,3,PERF
42283323490000,PI,IP,001,29,9462,9465,7093,3,PERF
42283323490000,PI,IP,001,30,9506,9509,7093,3,PERF
42283323490000,PI,IP,001,31,9587,9590,7093,3,PERF
42283323490000,PI,IP,001,32,9631,9634,7093,3,PERF
42283323490000,PI,IP,001,33,9675,9678,7093,3,PERF
42283323490000,PI,IP,001,34,9719,9722,7093,3,PERF
42283323490000,PI,IP,001,35,9763,9766,7093,3,PERF
42283323490000,PI,IP,001,36,9807,9810,7093,3,PERF
42283323490000,PI,IP,001,37,9888,9891,7093,3,PERF
42283323490000,PI,IP,001,38,9932,9935,7093,3,PERF
42283323490000,PI,IP,001,39,9976,9979,7093,3,PERF
42283323490000,PI,IP,001,40,10020,10023,7093,3,PERF
42283323490000,PI,IP,001,41,10064,10067,7093,3,PERF
42283323490000,PI,IP,001,42,10108,10111,7093,3,PERF
42283323490000,PI,IP,001,43,10189,10192,7093,3,PERF
42283323490000,PI,IP,001,44,10233,10236,7093,3,PERF
42283323490000,PI,IP,001,45,10277,10280,7093,3,PERF
42283323490000,PI,IP,001,46,10321,10324,7093,3,PERF
42283323490000,PI,IP,001,47,10365,10368,7093,3,PERF
42283323490000,PI,IP,001,48,10409,10412,7093,3,PERF
42283323490000,PI,IP,001,49,10490,10493,7093,3,PERF
42283323490000,PI,IP,001,50,10534,10537,7093,3,PERF
42283323490000,PI,IP,001,51,10578,10581,7093,3,PERF
42283323490000,PI,IP,001,52,10622,10625,7093,3,PERF
42283323490000,PI,IP,001,53,10666,10669,7093,3,PERF
42283323490000,PI,IP,001,54,10710,10713,7093,3,PERF
42283323490000,PI,IP,001,55,10791,10794,7093,3,PERF
42283323490000,PI,IP,001,56,10835,10838,7093,3,PERF
42283323490000,PI,IP,001,57,10879,10882,7093,3,PERF
42283323490000,PI,IP,001,58,10923,10926,7093,3,PERF
42283323490000,PI,IP,001,59,10967,10970,7093,3,PERF
42283323490000,PI,IP,001,60,11011,11014,7093,3,PERF
42283323490000,PI,IP,001,61,11092,11095,7093,3,PERF
42283323490000,PI,IP,001,62,11136,11139,7093,3,PERF
42283323490000,PI,IP,001,63,11180,11183,7093,3,PERF
42283323490000,PI,IP,001,64,11224,11227,7093,3,PERF
42283323490000,PI,IP,001,65,11268,11271,7093,3,PERF
42283323490000,PI,IP,001,66,11312,11315,7093,3,PERF
42283323490000,PI,IP,001,67,11393,11396,7093,3,PERF
42283323490000,PI,IP,001,68,11437,11440,7093,3,PERF
42283323490000,PI,IP,001,69,11481,11484,7093,3,PERF
42283323490000,PI,IP,001,70,11525,11528,7093,3,PERF
42283323490000,PI,IP,001,71,11569,11572,7093,3,PERF
42283323490000,PI,IP,001,72,11613,11616,7093,3,PERF
42283323490000,PI,IP,001,73,11694,11697,7093,3,PERF
42283323490000,PI,IP,001,74,11738,11741,7093,3,PERF
42283323490000,PI,IP,001,75,11782,11785,7093,3,PERF
42283323490000,PI,IP,001,76,11826,11829,7093,3,PERF
42283323490000,PI,IP,001,77,11870,11873,7093,3,PERF
42283323490000,PI,IP,001,78,11914,11917,7093,3,PERF
42283323490000,PI,IP,001,79,11995,11998,7093,3,PERF
42283323490000,PI,IP,001,80,12039,12042,7093,3,PERF
42283323490000,PI,IP,001,81,12083,12086,7093,3,PERF
42283323490000,PI,IP,001,82,12127,12130,7093,3,PERF
42283323490000,PI,IP,001,83,12171,12174,7093,3,PERF
42283323490000,PI,IP,001,84,12215,12218,7093,3,PERF
42283323490000,PI,IP,001,85,12296,12299,7093,3,PERF
42283323490000,PI,IP,001,86,12340,12343,7093,3,PERF
42283323490000,PI,IP,001,87,12384,12387,7093,3,PERF
42283323490000,PI,IP,001,88,12428,12431,7093,3,PERF
42283323490000,PI,IP,001,89,12472,12475,7093,3,PERF
42283323490000,PI,IP,001,90,12516,12519,7093,3,PERF
42283323490000,PI,IP,001,91,12597,12600,7093,3,PERF
42283323490000,PI,IP,001,92,12641,12644,7093,3,PERF
42283323490000,PI,IP,001,93,12685,12688,7093,3,PERF
42283323490000,PI,IP,001,94,12729,12732,7093,3,PERF
42283323490000,PI,IP,001,95,12773,12776,7093,3,PERF
42283323490000,PI,IP,001,96,12817,12820,7093,3,PERF
42283323490000,PI,IP,001,97,12898,12901,7093,3,PERF
42283323490000,PI,IP,001,98,12942,12945,7093,3,PERF
42283323490000,PI,IP,001,99,12986,12989,7093,3,PERF
42283323490000,PI,IP,001,100,13030,13033,7093,3,PERF
42283323490000,PI,IP,001,101,13074,13077,7093,3,PERF
42283323490000,PI,IP,001,102,13118,13121,7093,3,PERF
42283323490000,PI,IP,001,103,13199,13202,7093,3,PERF
42283323490000,PI,IP,001,104,13243,13246,7093,3,PERF
42283323490000,PI,IP,001,105,13287,13290,7093,3,PERF
42283323490000,PI,IP,001,106,13331,13334,7093,3,PERF
42283323490000,PI,IP,001,107,13375,13378,7093,3,PERF
42283323490000,PI,IP,001,108,13419,13422,7093,3,PERF
42283323490000,PI,IP,001,109,13500,13503,7093,3,PERF
42283323490000,PI,IP,001,110,13544,13547,7093,3,PERF
42283323490000,PI,IP,001,111,13588,13591,7093,3,PERF
42283323490000,PI,IP,001,112,13632,13635,7093,3,PERF
42283323490000,PI,IP,001,113,13676,13679,7093,3,PERF
42283323490000,PI,IP,001,114,13720,13723,7093,3,PERF
42283323490000,PI,IP,001,115,13801,13804,7093,3,PERF
42283323490000,PI,IP,001,116,13845,13848,7093,3,PERF
42283323490000,PI,IP,001,117,13889,13892,7093,3,PERF
42283323490000,PI,IP,001,118,13933,13936,7093,3,PERF
42283323490000,PI,IP,001,119,13977,13980,7093,3,PERF
42283323490000,PI,IP,001,120,14021,14024,7093,3,PERF
42283323490000,PI,IP,001,121,14102,14105,7093,3,PERF
42283323490000,PI,IP,001,122,14146,14149,7093,3,PERF
42283323490000,PI,IP,001,123,14190,14193,7093,3,PERF
42283323490000,PI,IP,001,124,14234,14237,7093,3,PERF
42283323490000,PI,IP,001,125,14278,14281,7093,3,PERF
42283323490000,PI,IP,001,126,14322,14325,7093,3,PERF
42283323510000,PI,IP,001,1,9482,14086,5208,4604,PERF
42283323520000,PI,IP,001,1,7700,7880,4774,180,PERF
42283323520000,PI,IP,001,2,7937,8117,4774,180,PERF
42283323520000,PI,IP,001,3,8174,8354,4774,180,PERF
42283323520000,PI,IP,001,4,8412,8591,4774,179,PERF
42283323520000,PI,IP,001,5,8649,8829,4774,180,PERF
42283323520000,PI,IP,001,6,8886,9066,4774,180,PERF
42283323520000,PI,IP,001,7,9123,9303,4774,180,PERF
42283323520000,PI,IP,001,8,9360,9540,4774,180,PERF
42283323520000,PI,IP,001,9,9597,9777,4774,180,PERF
42283323520000,PI,IP,001,10,9835,10013,4774,178,PERF
42283323520000,PI,IP,001,11,10072,10252,4774,180,PERF
42283323520000,PI,IP,001,12,10309,10489,4774,180,PERF
42283323520000,PI,IP,001,13,10546,10726,4774,180,PERF
42283323520000,PI,IP,001,14,10783,10963,4774,180,PERF
42283323520000,PI,IP,001,15,11020,11198,4774,178,PERF
42283323520000,PI,IP,001,16,11258,11437,4774,179,PERF
42283323520000,PI,IP,001,17,11495,11675,4774,180,PERF
42283323520000,PI,IP,001,18,11732,11912,4774,180,PERF
42283323530000,PI,IP,001,1,9425,14220,5052,4795,PERF
42283323540000,PI,IP,001,1,9133,14082,5491,4949,PERF
42283323560000,PI,IP,001,1,9635,14238,5362,4603,PERF
42283323570000,PI,IP,001,1,10275,14920,4887,4645,PERF
42283323580000,PI,IP,001,1,10396,14796,4891,4400,PERF
42283323590000,PI,IP,001,1,10252,14952,4914,4700,PERF
42283323600000,PI,IP,001,1,10380,14946,4906,4566,PERF
42283323610000,PI,IP,001,1,9753,13857,5029,4104,PERF
42283323620000,PI,IP,001,1,9770,13454,4697,3684,PERF
42283323630000,PI,IP,001,1,10310,14621,5590,4311,PERF
42283323640000,PI,IP,001,1,9575,14383,5604,4808,PERF
42283323650000,PI,IP,001,1,9233,14426,5804,5193,PERF
42283323660000,PI,IP,001,1,9128,9360,5012,232,PERF
42283323660000,PI,IP,001,2,9408,9660,5012,252,PERF
42283323660000,PI,IP,001,3,9708,9960,5012,252,PERF
42283323660000,PI,IP,001,4,10008,10260,5012,252,PERF
42283323660000,PI,IP,001,5,10308,10560,5012,252,PERF
42283323660000,PI,IP,001,6,10608,10860,5012,252,PERF
42283323660000,PI,IP,001,7,10908,11160,5012,252,PERF
42283323660000,PI,IP,001,8,11208,11460,5012,252,PERF
42283323660000,PI,IP,001,9,11508,11760,5012,252,PERF
42283323660000,PI,IP,001,10,11808,12060,5012,252,PERF
42283323660000,PI,IP,001,11,12108,12360,5012,252,PERF
42283323660000,PI,IP,001,12,12408,12660,5012,252,PERF
42283323660000,PI,IP,001,13,12708,12960,5012,252,PERF
42283323660000,PI,IP,001,14,13008,13260,5012,252,PERF
42283323660000,PI,IP,001,15,13308,13839,5012,531,PERF
42283323670000,PI,IP,001,1,11186,16143,5614,4957,PERF
42283323680000,PI,IP,001,1,10900,14560,4831,3660,PERF
42283323690000,PI,IP,001,1,8257,8458,4873,201,PERF
42283323690000,PI,IP,001,2,8537,8738,4873,201,PERF
42283323690000,PI,IP,001,3,8817,9018,4873,201,PERF
42283323690000,PI,IP,001,4,9097,9298,4873,201,PERF
42283323690000,PI,IP,001,5,9377,9578,4873,201,PERF
42283323690000,PI,IP,001,6,9657,9858,4873,201,PERF
42283323690000,PI,IP,001,7,9937,10138,4873,201,PERF
42283323690000,PI,IP,001,8,10217,10418,4873,201,PERF
42283323690000,PI,IP,001,9,10497,10698,4873,201,PERF
42283323690000,PI,IP,001,10,10777,10978,4873,201,PERF
42283323690000,PI,IP,001,11,11057,11258,4873,201,PERF
42283323690000,PI,IP,001,12,11337,11538,4873,201,PERF
42283323690000,PI,IP,001,13,11738,11939,4873,201,PERF
42283323690000,PI,IP,001,14,12018,12219,4873,201,PERF
42283323690000,PI,IP,001,15,12298,12499,4873,201,PERF
42283323700000,PI,IP,001,1,11261,15406,4797,4145,PERF
42283323710000,PI,IP,002,1,9451,15767,7450,6316,PERF
42283323710000,PI,PT,001,1,9451,15767,7450,6316,PERF
42283323720000,PI,IP,001,1,11350,16704,5724,5354,PERF
42283323730000,PI,IP,001,1,8934,8937,5057,3,PERF
42283323730000,PI,IP,001,2,8974,8977,5057,3,PERF
42283323730000,PI,IP,001,3,9013,9016,5057,3,PERF
42283323730000,PI,IP,001,4,9053,9056,5057,3,PERF
42283323730000,PI,IP,001,5,9092,9095,5057,3,PERF
42283323730000,PI,IP,001,6,9134,9137,5057,3,PERF
42283323730000,PI,IP,001,7,9205,9208,5057,3,PERF
42283323730000,PI,IP,001,8,9247,9250,5057,3,PERF
42283323730000,PI,IP,001,9,9290,9293,5057,3,PERF
42283323730000,PI,IP,001,10,9330,9333,5057,3,PERF
42283323730000,PI,IP,001,11,9370,9373,5057,3,PERF
42283323730000,PI,IP,001,12,9409,9412,5057,3,PERF
42283323730000,PI,IP,001,13,9488,9491,5057,3,PERF
42283323730000,PI,IP,001,14,9528,9531,5057,3,PERF
42283323730000,PI,IP,001,15,9567,9570,5057,3,PERF
42283323730000,PI,IP,001,16,9607,9610,5057,3,PERF
42283323730000,PI,IP,001,17,9647,9650,5057,3,PERF
42283323730000,PI,IP,001,18,9686,9689,5057,3,PERF
42283323730000,PI,IP,001,19,9765,9768,5057,3,PERF
42283323730000,PI,IP,001,20,9805,9808,5057,3,PERF
42283323730000,PI,IP,001,21,9844,9847,5057,3,PERF
42283323730000,PI,IP,001,22,9884,9887,5057,3,PERF
42283323730000,PI,IP,001,23,9924,9927,5057,3,PERF
42283323730000,PI,IP,001,24,9966,9969,5057,3,PERF
42283323730000,PI,IP,001,25,10036,10039,5057,3,PERF
42283323730000,PI,IP,001,26,10067,10070,5057,3,PERF
42283323730000,PI,IP,001,27,10110,10113,5057,3,PERF
42283323730000,PI,IP,001,28,10150,10153,5057,3,PERF
42283323730000,PI,IP,001,29,10190,10193,5057,3,PERF
42283323730000,PI,IP,001,30,10237,10240,5057,3,PERF
42283323730000,PI,IP,001,31,10319,10322,5057,3,PERF
42283323730000,PI,IP,001,32,10359,10362,5057,3,PERF
42283323730000,PI,IP,001,33,10399,10402,5057,3,PERF
42283323730000,PI,IP,001,34,10438,10441,5057,3,PERF
42283323730000,PI,IP,001,35,10478,10481,5057,3,PERF
42283323730000,PI,IP,001,36,10517,10520,5057,3,PERF
42283323730000,PI,IP,001,37,10596,10599,5057,3,PERF
42283323730000,PI,IP,001,38,10636,10639,5057,3,PERF
42283323730000,PI,IP,001,39,10676,10679,5057,3,PERF
42283323730000,PI,IP,001,40,10707,10710,5057,3,PERF
42283323730000,PI,IP,001,41,10737,10740,5057,3,PERF
42283323730000,PI,IP,001,42,10780,10783,5057,3,PERF
42283323730000,PI,IP,001,43,10873,10876,5057,3,PERF
42283323730000,PI,IP,001,44,10913,10916,5057,3,PERF
42283323730000,PI,IP,001,45,10953,10956,5057,3,PERF
42283323730000,PI,IP,001,46,10992,10995,5057,3,PERF
42283323730000,PI,IP,001,47,11032,11035,5057,3,PERF
42283323730000,PI,IP,001,48,11071,11075,5057,4,PERF
42283323730000,PI,IP,001,49,11151,11154,5057,3,PERF
42283323730000,PI,IP,001,50,11190,11193,5057,3,PERF
42283323730000,PI,IP,001,51,11230,11233,5057,3,PERF
42283323730000,PI,IP,001,52,11269,11272,5057,3,PERF
42283323730000,PI,IP,001,53,11309,11312,5057,3,PERF
42283323730000,PI,IP,001,54,11349,11352,5057,3,PERF
42283323730000,PI,IP,001,55,11413,11416,5057,3,PERF
42283323730000,PI,IP,001,56,11447,11450,5057,3,PERF
42283323730000,PI,IP,001,57,11497,11500,5057,3,PERF
42283323730000,PI,IP,001,58,11537,11540,5057,3,PERF
42283323730000,PI,IP,001,59,11577,11580,5057,3,PERF
42283323730000,PI,IP,001,60,11626,11629,5057,3,PERF
42283323730000,PI,IP,001,61,11705,11708,5057,3,PERF
42283323730000,PI,IP,001,62,11744,11747,5057,3,PERF
42283323730000,PI,IP,001,63,11784,11787,5057,3,PERF
42283323730000,PI,IP,001,64,11823,11826,5057,3,PERF
42283323730000,PI,IP,001,65,11863,11866,5057,3,PERF
42283323730000,PI,IP,001,66,11903,11906,5057,3,PERF
42283323730000,PI,IP,001,67,12977,12980,5057,3,PERF
42283323730000,PI,IP,001,68,12007,12010,5057,3,PERF
42283323730000,PI,IP,001,69,12047,12050,5057,3,PERF
42283323730000,PI,IP,001,70,12090,12093,5057,3,PERF
42283323730000,PI,IP,001,71,12130,12133,5057,3,PERF
42283323730000,PI,IP,001,72,12171,12174,5057,3,PERF
42283323730000,PI,IP,001,73,12256,12259,5057,3,PERF
42283323730000,PI,IP,001,74,12298,12301,5057,3,PERF
42283323730000,PI,IP,001,75,12338,12341,5057,3,PERF
42283323730000,PI,IP,001,76,12378,12381,5057,3,PERF
42283323730000,PI,IP,001,77,12417,12420,5057,3,PERF
42283323730000,PI,IP,001,78,12457,12460,5057,3,PERF
42283323730000,PI,IP,001,79,12517,12520,5057,3,PERF
42283323730000,PI,IP,001,80,12560,12563,5057,3,PERF
42283323730000,PI,IP,001,81,12600,12603,5057,3,PERF
42283323730000,PI,IP,001,82,12637,12640,5057,3,PERF
42283323730000,PI,IP,001,83,12680,12683,5057,3,PERF
42283323730000,PI,IP,001,84,12725,12728,5057,3,PERF
42283323730000,PI,IP,001,85,12813,12816,5057,3,PERF
42283323730000,PI,IP,001,86,12852,12855,5057,3,PERF
42283323730000,PI,IP,001,87,12892,12895,5057,3,PERF
42283323730000,PI,IP,001,88,12932,12935,5057,3,PERF
42283323730000,PI,IP,001,89,12971,12974,5057,3,PERF
42283323730000,PI,IP,001,90,13011,13014,5057,3,PERF
42283323730000,PI,IP,001,91,13090,13093,5057,3,PERF
42283323730000,PI,IP,001,92,13130,13133,5057,3,PERF
42283323730000,PI,IP,001,93,13169,13172,5057,3,PERF
42283323730000,PI,IP,001,94,13209,13212,5057,3,PERF
42283323730000,PI,IP,001,95,13248,13251,5057,3,PERF
42283323730000,PI,IP,001,96,13288,13291,5057,3,PERF
42283323740000,PI,IP,001,1,10178,14645,4982,4467,PERF
42283323750000,PI,IP,001,1,10163,14679,4973,4516,PERF
42283323760000,PI,IP,001,1,11150,15826,5401,4676,PERF
42283323770000,PI,IP,001,1,9129,14372,6301,5243,PERF
42283323790000,PI,IP,001,1,8476,11757,4909,3281,PERF
42283323800000,PI,IP,001,1,12900,14293,,1393,PERF
42283323810000,PI,IP,001,1,10227,10230,5043,3,PERF
42283323810000,PI,IP,001,2,10268,10271,5043,3,PERF
42283323810000,PI,IP,001,3,10309,10312,5043,3,PERF
42283323810000,PI,IP,001,4,10350,10353,5043,3,PERF
42283323810000,PI,IP,001,5,10392,10395,5043,3,PERF
42283323810000,PI,IP,001,6,10433,10436,5043,3,PERF
42283323810000,PI,IP,001,7,10512,10515,5043,3,PERF
42283323810000,PI,IP,001,8,10553,10556,5043,3,PERF
42283323810000,PI,IP,001,9,10594,10597,5043,3,PERF
42283323810000,PI,IP,001,10,10635,10638,5043,3,PERF
42283323810000,PI,IP,001,11,10676,10679,5043,3,PERF
42283323810000,PI,IP,001,12,10717,10720,5043,3,PERF
42283323810000,PI,IP,001,13,10796,10799,5043,3,PERF
42283323810000,PI,IP,001,14,10837,10840,5043,3,PERF
42283323810000,PI,IP,001,15,10879,10882,5043,3,PERF
42283323810000,PI,IP,001,16,10920,10923,5043,3,PERF
42283323810000,PI,IP,001,17,10961,10964,5043,3,PERF
42283323810000,PI,IP,001,18,11002,11005,5043,3,PERF
42283323810000,PI,IP,001,19,11081,11084,5043,3,PERF
42283323810000,PI,IP,001,20,11122,11125,5043,3,PERF
42283323810000,PI,IP,001,21,11163,11166,5043,3,PERF
42283323810000,PI,IP,001,22,11204,11207,5043,3,PERF
42283323810000,PI,IP,001,23,11246,11249,5043,3,PERF
42283323810000,PI,IP,001,24,11287,11290,5043,3,PERF
42283323810000,PI,IP,001,25,11363,11366,5043,3,PERF
42283323810000,PI,IP,001,26,11405,11408,5043,3,PERF
42283323810000,PI,IP,001,27,11446,11449,5043,3,PERF
42283323810000,PI,IP,001,28,11489,11492,5043,3,PERF
42283323810000,PI,IP,001,29,11527,11530,5043,3,PERF
42283323810000,PI,IP,001,30,11571,11574,5043,3,PERF
42283323810000,PI,IP,001,31,11650,11653,5043,3,PERF
42283323810000,PI,IP,001,32,11691,11694,5043,3,PERF
42283323810000,PI,IP,001,33,11733,11736,5043,3,PERF
42283323810000,PI,IP,001,34,11774,11777,5043,3,PERF
42283323810000,PI,IP,001,35,11815,11818,5043,3,PERF
42283323810000,PI,IP,001,36,11856,11859,5043,3,PERF
42283323810000,PI,IP,001,37,11935,11938,5043,3,PERF
42283323810000,PI,IP,001,38,11976,11979,5043,3,PERF
42283323810000,PI,IP,001,39,12017,12020,5043,3,PERF
42283323810000,PI,IP,001,40,12058,12061,5043,3,PERF
42283323810000,PI,IP,001,41,12100,12103,5043,3,PERF
42283323810000,PI,IP,001,42,12141,12144,5043,3,PERF
42283323810000,PI,IP,001,43,12220,12223,5043,3,PERF
42283323810000,PI,IP,001,44,12261,12264,5043,3,PERF
42283323810000,PI,IP,001,45,12302,12305,5043,3,PERF
42283323810000,PI,IP,001,46,12343,12346,5043,3,PERF
42283323810000,PI,IP,001,47,12384,12387,5043,3,PERF
42283323810000,PI,IP,001,48,12425,12428,5043,3,PERF
42283323810000,PI,IP,001,49,12504,12507,5043,3,PERF
42283323810000,PI,IP,001,50,12545,12548,5043,3,PERF
42283323810000,PI,IP,001,51,12587,12590,5043,3,PERF
42283323810000,PI,IP,001,52,12628,12631,5043,3,PERF
42283323810000,PI,IP,001,53,12669,12672,5043,3,PERF
42283323810000,PI,IP,001,54,12710,12713,5043,3,PERF
42283323810000,PI,IP,001,55,12789,12792,5043,3,PERF
42283323810000,PI,IP,001,56,12832,12835,5043,3,PERF
42283323810000,PI,IP,001,57,12874,12877,5043,3,PERF
42283323810000,PI,IP,001,58,12915,12918,5043,3,PERF
42283323810000,PI,IP,001,59,12956,12959,5043,3,PERF
42283323810000,PI,IP,001,60,12998,13001,5043,3,PERF
42283323810000,PI,IP,001,61,13070,13073,5043,3,PERF
42283323810000,PI,IP,001,62,13111,13114,5043,3,PERF
42283323810000,PI,IP,001,63,13151,13154,5043,3,PERF
42283323810000,PI,IP,001,64,13194,13197,5043,3,PERF
42283323810000,PI,IP,001,65,13235,13238,5043,3,PERF
42283323810000,PI,IP,001,66,13275,13278,5043,3,PERF
42283323810000,PI,IP,001,67,13358,13361,5043,3,PERF
42283323810000,PI,IP,001,68,13399,13402,5043,3,PERF
42283323810000,PI,IP,001,69,13441,13444,5043,3,PERF
42283323810000,PI,IP,001,70,13482,13485,5043,3,PERF
42283323810000,PI,IP,001,71,13523,13526,5043,3,PERF
42283323810000,PI,IP,001,72,13564,13567,5043,3,PERF
42283323810000,PI,IP,001,73,13643,13646,5043,3,PERF
42283323810000,PI,IP,001,74,13684,13687,5043,3,PERF
42283323810000,PI,IP,001,75,13725,13728,5043,3,PERF
42283323810000,PI,IP,001,76,13766,13769,5043,3,PERF
42283323810000,PI,IP,001,77,13808,13811,5043,3,PERF
42283323810000,PI,IP,001,78,13849,13852,5043,3,PERF
42283323810000,PI,IP,001,79,13928,13931,5043,3,PERF
42283323810000,PI,IP,001,80,13969,13972,5043,3,PERF
42283323810000,PI,IP,001,81,14010,14013,5043,3,PERF
42283323810000,PI,IP,001,82,14051,14054,5043,3,PERF
42283323810000,PI,IP,001,83,14092,14095,5043,3,PERF
42283323810000,PI,IP,001,84,14133,14136,5043,3,PERF
42283323810000,PI,IP,001,85,14212,14215,5043,3,PERF
42283323810000,PI,IP,001,86,14253,14256,5043,3,PERF
42283323810000,PI,IP,001,87,14295,14298,5043,3,PERF
42283323810000,PI,IP,001,88,14336,14339,5043,3,PERF
42283323810000,PI,IP,001,89,14377,14380,5043,3,PERF
42283323810000,PI,IP,001,90,14418,14421,5043,3,PERF
42283323820000,PI,IP,001,1,8670,13506,6131,4836,PERF
42283323830000,PI,IP,001,1,8521,13261,5874,4740,PERF
42283323860000,PI,IP,001,1,12631,16842,,4211,PERF
42283323870000,PI,IP,001,1,11100,13798,3419,2698,PERF
42283323880000,PI,IP,001,1,11463,15234,3973,3771,PERF
42283323890000,PI,IP,001,1,11261,16202,5625,4941,PERF
42283323900000,PI,IP,001,1,9321,9546,4902,225,PERF
42283323900000,PI,IP,001,2,9622,9847,4902,225,PERF
42283323900000,PI,IP,001,3,9923,10148,4902,225,PERF
42283323900000,PI,IP,001,4,10224,10449,4902,225,PERF
42283323900000,PI,IP,001,5,10525,10750,4902,225,PERF
42283323900000,PI,IP,001,6,10826,11051,4902,225,PERF
42283323900000,PI,IP,001,7,11127,11353,4902,226,PERF
42283323900000,PI,IP,001,8,11429,11654,4902,225,PERF
42283323900000,PI,IP,001,9,11730,11957,4902,227,PERF
42283323900000,PI,IP,001,10,11971,12208,4902,237,PERF
42283323900000,PI,IP,001,11,12284,12521,4902,237,PERF
42283323900000,PI,IP,001,12,12633,12855,4902,222,PERF
42283323900000,PI,IP,001,13,12934,13070,4902,136,PERF
42283323900000,PI,IP,001,14,13223,13460,4902,237,PERF
42283323910000,PI,IP,001,1,10100,10103,5044,3,PERF
42283323910000,PI,IP,001,2,10142,10145,5044,3,PERF
42283323910000,PI,IP,001,3,10181,10184,5044,3,PERF
42283323910000,PI,IP,001,4,10221,10224,5044,3,PERF
42283323910000,PI,IP,001,5,10260,10263,5044,3,PERF
42283323910000,PI,IP,001,6,10299,10302,5044,3,PERF
42283323910000,PI,IP,001,7,10386,10389,5044,3,PERF
42283323910000,PI,IP,001,8,10425,10428,5044,3,PERF
42283323910000,PI,IP,001,9,10462,10465,5044,3,PERF
42283323910000,PI,IP,001,10,10503,10506,5044,3,PERF
42283323910000,PI,IP,001,11,10543,10546,5044,3,PERF
42283323910000,PI,IP,001,12,10582,10585,5044,3,PERF
42283323910000,PI,IP,001,13,10669,10672,5044,3,PERF
42283323910000,PI,IP,001,14,10708,10711,5044,3,PERF
42283323910000,PI,IP,001,15,10747,10750,5044,3,PERF
42283323910000,PI,IP,001,16,10786,10789,5044,3,PERF
42283323910000,PI,IP,001,17,10828,10831,5044,3,PERF
42283323910000,PI,IP,001,18,10859,10862,5044,3,PERF
42283323910000,PI,IP,001,19,10953,10956,5044,3,PERF
42283323910000,PI,IP,001,20,10993,10996,5044,3,PERF
42283323910000,PI,IP,001,21,11024,11027,5044,3,PERF
42283323910000,PI,IP,001,22,11067,11070,5044,3,PERF
42283323910000,PI,IP,001,23,11109,11112,5044,3,PERF
42283323910000,PI,IP,001,24,11148,11151,5044,3,PERF
42283323910000,PI,IP,001,25,11235,11238,5044,3,PERF
42283323910000,PI,IP,001,26,11274,11277,5044,3,PERF
42283323910000,PI,IP,001,27,11313,11316,5044,3,PERF
42283323910000,PI,IP,001,28,11352,11355,5044,3,PERF
42283323910000,PI,IP,001,29,11391,11394,5044,3,PERF
42283323910000,PI,IP,001,30,11431,11434,5044,3,PERF
42283323910000,PI,IP,001,31,11518,11521,5044,3,PERF
42283323910000,PI,IP,001,32,11557,11560,5044,3,PERF
42283323910000,PI,IP,001,33,11596,11599,5044,3,PERF
42283323910000,PI,IP,001,34,11635,11638,5044,3,PERF
42283323910000,PI,IP,001,35,11674,11677,5044,3,PERF
42283323910000,PI,IP,001,36,11714,11717,5044,3,PERF
42283323910000,PI,IP,001,37,11800,11803,5044,3,PERF
42283323910000,PI,IP,001,38,11840,11843,5044,3,PERF
42283323910000,PI,IP,001,39,11879,11882,5044,3,PERF
42283323910000,PI,IP,001,40,11918,11921,5044,3,PERF
42283323910000,PI,IP,001,41,11957,11960,5044,3,PERF
42283323910000,PI,IP,001,42,11997,12000,5044,3,PERF
42283323910000,PI,IP,001,43,12084,12087,5044,3,PERF
42283323910000,PI,IP,001,44,12123,12126,5044,3,PERF
42283323910000,PI,IP,001,45,12155,12158,5044,3,PERF
42283323910000,PI,IP,001,46,12197,12200,5044,3,PERF
42283323910000,PI,IP,001,47,12236,12239,5044,3,PERF
42283323910000,PI,IP,001,48,12275,12278,5044,3,PERF
42283323910000,PI,IP,001,49,12362,12365,5044,3,PERF
42283323910000,PI,IP,001,50,12402,12405,5044,3,PERF
42283323910000,PI,IP,001,51,12441,12444,5044,3,PERF
42283323910000,PI,IP,001,52,12480,12483,5044,3,PERF
42283323910000,PI,IP,001,53,12519,12522,5044,3,PERF
42283323910000,PI,IP,001,54,12558,12561,5044,3,PERF
42283323910000,PI,IP,001,55,12649,12652,5044,3,PERF
42283323910000,PI,IP,001,56,12689,12692,5044,3,PERF
42283323910000,PI,IP,001,57,12728,12731,5044,3,PERF
42283323910000,PI,IP,001,58,12767,12770,5044,3,PERF
42283323910000,PI,IP,001,59,12806,12809,5044,3,PERF
42283323910000,PI,IP,001,60,12845,12848,5044,3,PERF
42283323910000,PI,IP,001,61,12932,12935,5044,3,PERF
42283323910000,PI,IP,001,62,12972,12975,5044,3,PERF
42283323910000,PI,IP,001,63,13011,13014,5044,3,PERF
42283323910000,PI,IP,001,64,13050,13053,5044,3,PERF
42283323910000,PI,IP,001,65,13089,13092,5044,3,PERF
42283323910000,PI,IP,001,66,13128,13131,5044,3,PERF
42283323910000,PI,IP,001,67,13215,13218,5044,3,PERF
42283323910000,PI,IP,001,68,13254,13257,5044,3,PERF
42283323910000,PI,IP,001,69,13294,13297,5044,3,PERF
42283323910000,PI,IP,001,70,13334,13337,5044,3,PERF
42283323910000,PI,IP,001,71,13367,13370,5044,3,PERF
42283323910000,PI,IP,001,72,13408,13411,5044,3,PERF
42283323910000,PI,IP,001,73,13494,13497,5044,3,PERF
42283323910000,PI,IP,001,74,13533,13536,5044,3,PERF
42283323910000,PI,IP,001,75,13573,13576,5044,3,PERF
42283323910000,PI,IP,001,76,13612,13615,5044,3,PERF
42283323910000,PI,IP,001,77,13651,13654,5044,3,PERF
42283323910000,PI,IP,001,78,13690,13693,5044,3,PERF
42283323910000,PI,IP,001,79,13781,13784,5044,3,PERF
42283323910000,PI,IP,001,80,13820,13823,5044,3,PERF
42283323910000,PI,IP,001,81,13860,13863,5044,3,PERF
42283323910000,PI,IP,001,82,13899,13902,5044,3,PERF
42283323910000,PI,IP,001,83,13938,13941,5044,3,PERF
42283323910000,PI,IP,001,84,13989,13992,5044,3,PERF
42283323910000,PI,IP,001,85,14064,14067,5044,3,PERF
42283323910000,PI,IP,001,86,14103,14106,5044,3,PERF
42283323910000,PI,IP,001,87,14142,14145,5044,3,PERF
42283323910000,PI,IP,001,88,14182,14185,5044,3,PERF
42283323910000,PI,IP,001,89,14221,14224,5044,3,PERF
42283323910000,PI,IP,001,90,14260,14263,5044,3,PERF
42283323920000,PI,IP,001,1,8015,8281,5588,266,PERF
42283323920000,PI,IP,001,2,8380,8601,5588,221,PERF
42283323920000,PI,IP,001,3,8700,8961,5588,261,PERF
42283323920000,PI,IP,001,4,9060,9321,5588,261,PERF
42283323920000,PI,IP,001,5,9420,9676,5588,256,PERF
42283323920000,PI,IP,001,6,9775,10016,5588,241,PERF
42283323920000,PI,IP,001,7,10115,10381,5588,266,PERF
42283323920000,PI,IP,001,8,10480,10731,5588,251,PERF
42283323920000,PI,IP,001,9,10830,11091,5588,261,PERF
42283323920000,PI,IP,001,10,11190,11431,5588,241,PERF
42283323920000,PI,IP,001,11,11530,11791,5588,261,PERF
42283323920000,PI,IP,001,12,11890,12146,5588,256,PERF
42283323920000,PI,IP,001,13,12245,12506,5588,261,PERF
42283323920000,PI,IP,001,14,12600,12846,5588,246,PERF
42283323930000,PI,IP,001,1,7828,8028,5679,200,PERF
42283323930000,PI,IP,001,2,8100,8306,5679,206,PERF
42283323930000,PI,IP,001,3,8382,8582,5679,200,PERF
42283323930000,PI,IP,001,4,8658,8856,5679,198,PERF
42283323930000,PI,IP,001,5,8930,9174,5679,244,PERF
42283323930000,PI,IP,001,6,9212,9410,5679,198,PERF
42283323930000,PI,IP,001,7,9489,9689,5679,200,PERF
42283323930000,PI,IP,001,8,9750,9966,5679,216,PERF
42283323930000,PI,IP,001,9,10046,10246,5679,200,PERF
42283323930000,PI,IP,001,10,10319,10521,5679,202,PERF
42283323930000,PI,IP,001,11,10596,10786,5679,190,PERF
42283323930000,PI,IP,001,12,10870,11073,5679,203,PERF
42283323930000,PI,IP,001,13,11149,11350,5679,201,PERF
42283323930000,PI,IP,001,14,11418,11627,5679,209,PERF
42283323930000,PI,IP,001,15,11704,11904,5679,200,PERF
42283323930000,PI,IP,001,16,11980,12180,5679,200,PERF
42283323930000,PI,IP,001,17,12257,12458,5679,201,PERF
42283323930000,PI,IP,001,18,12534,12734,5679,200,PERF
42283323950100,PI,IP,001,1,8243,16727,8761,8484,PERF
42283323960000,PI,IP,001,1,9256,9464,4761,208,PERF
42283323960000,PI,IP,001,2,9540,9747,4761,207,PERF
42283323960000,PI,IP,001,3,9825,10031,4761,206,PERF
42283323960000,PI,IP,001,4,10107,10314,4761,207,PERF
42283323960000,PI,IP,001,5,10390,10598,4761,208,PERF
42283323960000,PI,IP,001,6,10674,10881,4761,207,PERF
42283323960000,PI,IP,001,7,10957,11163,4761,206,PERF
42283323960000,PI,IP,001,8,11241,11448,4761,207,PERF
42283323960000,PI,IP,001,9,11524,11732,4761,208,PERF
42283323960000,PI,IP,001,10,11808,12018,4761,210,PERF
42283323960000,PI,IP,001,11,12091,12296,4761,205,PERF
42283323960000,PI,IP,001,12,12375,12582,4761,207,PERF
42283323960000,PI,IP,001,13,12658,12866,4761,208,PERF
42283323960000,PI,IP,001,14,12942,13149,4761,207,PERF
42283323970000,PI,IP,001,1,9626,17640,,8014,PERF
42283323980000,PI,IP,001,1,10105,10308,5043,203,PERF
42283323980000,PI,IP,001,2,10394,10594,5043,200,PERF
42283323980000,PI,IP,001,3,10678,10879,5043,201,PERF
42283323980000,PI,IP,001,4,10963,11163,5043,200,PERF
42283323980000,PI,IP,001,5,11247,11448,5043,201,PERF
42283323980000,PI,IP,001,6,11532,11733,5043,201,PERF
42283323980000,PI,IP,001,7,11817,12017,5043,200,PERF
42283323980000,PI,IP,001,8,12101,12302,5043,201,PERF
42283323980000,PI,IP,001,9,12386,12586,5043,200,PERF
42283323980000,PI,IP,001,10,12670,12871,5043,201,PERF
42283323980000,PI,IP,001,11,12955,13156,5043,201,PERF
42283323980000,PI,IP,001,12,13240,13440,5043,200,PERF
42283323980000,PI,IP,001,13,13524,13725,5043,201,PERF
42283323980000,PI,IP,001,14,13809,14009,5043,200,PERF
42283323980000,PI,IP,001,15,14093,14294,5043,201,PERF
42283323990000,PI,IP,001,1,8871,9072,6095,201,PERF
42283323990000,PI,IP,001,2,9151,9352,6095,201,PERF
42283323990000,PI,IP,001,3,9431,9632,6095,201,PERF
42283323990000,PI,IP,001,4,9711,9912,6095,201,PERF
42283323990000,PI,IP,001,5,9991,10192,6095,201,PERF
42283323990000,PI,IP,001,6,10271,10472,6095,201,PERF
42283323990000,PI,IP,001,7,10551,10752,6095,201,PERF
42283323990000,PI,IP,001,8,10831,11032,6095,201,PERF
42283323990000,PI,IP,001,9,11111,11312,6095,201,PERF
42283323990000,PI,IP,001,10,11391,11592,6095,201,PERF
42283323990000,PI,IP,001,11,11671,11872,6095,201,PERF
42283323990000,PI,IP,001,12,11951,12152,6095,201,PERF
42283323990000,PI,IP,001,13,12231,12432,6095,201,PERF
42283323990000,PI,IP,001,14,12511,12712,6095,201,PERF
42283323990000,PI,IP,001,15,12791,12992,6095,201,PERF
42283323990000,PI,IP,001,16,13071,13272,6095,201,PERF
42283323990000,PI,IP,001,17,13351,13552,6095,201,PERF
42283323990000,PI,IP,001,18,13631,13832,6095,201,PERF
42283323990000,PI,IP,001,19,13911,14112,6095,201,PERF
42283324020000,PI,IP,001,1,10915,17728,7462,6813,PERF
42283324030000,PI,IP,001,1,7828,8041,,213,PERF
42283324030000,PI,IP,001,2,8117,8327,,210,PERF
42283324030000,PI,IP,001,3,8406,8618,,212,PERF
42283324030000,PI,IP,001,4,8694,8907,,213,PERF
42283324030000,PI,IP,001,5,8983,9196,,213,PERF
42283324030000,PI,IP,001,6,9272,9485,,213,PERF
42283324030000,PI,IP,001,7,9561,9774,,213,PERF
42283324030000,PI,IP,001,8,9850,10063,,213,PERF
42283324030000,PI,IP,001,9,10139,10342,,203,PERF
42283324030000,PI,IP,001,10,10427,10637,,210,PERF
42283324030000,PI,IP,001,11,10716,10929,,213,PERF
42283324030000,PI,IP,001,12,11005,11218,,213,PERF
42283324030000,PI,IP,001,13,11291,11511,,220,PERF
42283324030000,PI,IP,001,14,11583,11795,,212,PERF
42283324030000,PI,IP,001,15,11871,12084,,213,PERF
42283324030000,PI,IP,001,16,12160,12373,,213,PERF
42283324040000,PI,IP,001,1,10215,15976,6590,5761,PERF
42283324050000,PI,IP,001,1,11028,17181,6968,6153,PERF
42283324060000,PI,IP,001,1,10257,15708,6731,5451,PERF
42283324070100,PI,IP,001,1,10137,10340,5042,203,PERF
42283324070100,PI,IP,001,2,10416,10619,5042,203,PERF
42283324070100,PI,IP,001,3,10695,10899,5042,204,PERF
42283324070100,PI,IP,001,4,10975,11178,5042,203,PERF
42283324070100,PI,IP,001,5,11254,11457,5042,203,PERF
42283324070100,PI,IP,001,6,11533,11736,5042,203,PERF
42283324070100,PI,IP,001,7,11812,12015,5042,203,PERF
42283324070100,PI,IP,001,8,12091,12295,5042,204,PERF
42283324070100,PI,IP,001,9,12371,12574,5042,203,PERF
42283324070100,PI,IP,001,10,12650,12853,5042,203,PERF
42283324070100,PI,IP,001,11,12929,13132,5042,203,PERF
42283324070100,PI,IP,001,12,13208,13411,5042,203,PERF
42283324070100,PI,IP,001,13,13487,13691,5042,204,PERF
42283324070100,PI,IP,001,14,13767,13970,5042,203,PERF
42283324070100,PI,IP,001,15,14046,14249,5042,203,PERF
42283324080000,PI,IP,001,1,8652,8853,6476,201,PERF
42283324080000,PI,IP,001,2,8932,9133,6476,201,PERF
42283324080000,PI,IP,001,3,9212,9413,6476,201,PERF
42283324080000,PI,IP,001,4,9492,9693,6476,201,PERF
42283324080000,PI,IP,001,5,9772,9973,6476,201,PERF
42283324080000,PI,IP,001,6,10052,10253,6476,201,PERF
42283324080000,PI,IP,001,7,10332,10533,6476,201,PERF
42283324080000,PI,IP,001,8,10612,10813,6476,201,PERF
42283324080000,PI,IP,001,9,10892,11093,6476,201,PERF
42283324080000,PI,IP,001,10,11172,11373,6476,201,PERF
42283324080000,PI,IP,001,11,11452,11653,6476,201,PERF
42283324080000,PI,IP,001,12,11732,11933,6476,201,PERF
42283324080000,PI,IP,001,13,12012,12213,6476,201,PERF
42283324080000,PI,IP,001,14,12292,12493,6476,201,PERF
42283324080000,PI,IP,001,15,12572,12773,6476,201,PERF
42283324080000,PI,IP,001,16,12852,13053,6476,201,PERF
42283324080000,PI,IP,001,17,13132,13333,6476,201,PERF
42283324080000,PI,IP,001,18,13412,13613,6476,201,PERF
42283324080000,PI,IP,001,19,13692,13893,6476,201,PERF
42283324080000,PI,IP,001,20,13972,14172,6476,200,PERF
42283324080000,PI,IP,001,21,14252,14453,6476,201,PERF
42283324100000,PI,IP,001,1,8881,14979,6259,6098,PERF
42283324120000,PI,IP,001,1,11382,17933,7283,6551,PERF
42283324130000,PI,IP,001,1,8030,8341,5493,311,PERF
42283324130000,PI,IP,001,2,8450,8771,5493,321,PERF
42283324130000,PI,IP,001,3,8880,9151,5493,271,PERF
42283324130000,PI,IP,001,4,9250,9511,5493,261,PERF
42283324130000,PI,IP,001,5,9610,9831,5493,221,PERF
42283324130000,PI,IP,001,6,9930,10196,5493,266,PERF
42283324130000,PI,IP,001,7,10295,10536,5493,241,PERF
42283324130000,PI,IP,001,8,10625,10876,5493,251,PERF
42283324130000,PI,IP,001,9,10975,11211,5493,236,PERF
42283324130000,PI,IP,001,10,11305,11546,5493,241,PERF
42283324130000,PI,IP,001,11,11635,11881,5493,246,PERF
42283324130000,PI,IP,001,12,11965,12216,5493,251,PERF
42283324130000,PI,IP,001,13,12285,12551,5493,266,PERF
42283324130000,PI,IP,001,14,12645,12886,5493,241,PERF
42283324130000,PI,IP,001,15,12975,13226,5493,251,PERF
42283324140000,PI,IP,001,1,9934,10139,5078,205,PERF
42283324140000,PI,IP,001,2,10223,10429,5078,206,PERF
42283324140000,PI,IP,001,3,10513,10718,5078,205,PERF
42283324140000,PI,IP,001,4,10802,11007,5078,205,PERF
42283324140000,PI,IP,001,5,11091,11296,5078,205,PERF
42283324140000,PI,IP,001,6,11380,11586,5078,206,PERF
42283324140000,PI,IP,001,7,11670,11875,5078,205,PERF
42283324140000,PI,IP,001,8,11959,12164,5078,205,PERF
42283324140000,PI,IP,001,9,12248,12453,5078,205,PERF
42283324140000,PI,IP,001,10,12573,12743,5078,170,PERF
42283324140000,PI,IP,001,11,12827,13032,5078,205,PERF
42283324140000,PI,IP,001,12,13116,13321,5078,205,PERF
42283324140000,PI,IP,001,13,13405,13610,5078,205,PERF
42283324140000,PI,IP,001,14,13694,13900,5078,206,PERF
42283324140000,PI,IP,001,15,13984,14189,5078,205,PERF
42283324150000,PI,IP,001,1,9959,14527,4854,4568,PERF
42283324160000,PI,IP,001,1,10377,14817,,4440,PERF
42283324170000,PI,IP,001,1,10347,14639,5208,4292,PERF
42283324180000,PI,IP,001,1,11070,16011,5448,4941,PERF
42283324190000,PI,IP,001,1,8700,8901,6233,201,PERF
42283324190000,PI,IP,001,2,8980,9181,6233,201,PERF
42283324190000,PI,IP,001,3,9260,9461,6233,201,PERF
42283324190000,PI,IP,001,4,9540,9741,6233,201,PERF
42283324190000,PI,IP,001,5,9820,10021,6233,201,PERF
42283324190000,PI,IP,001,6,10100,10301,6233,201,PERF
42283324190000,PI,IP,001,7,10380,10581,6233,201,PERF
42283324190000,PI,IP,001,8,10660,10861,6233,201,PERF
42283324190000,PI,IP,001,9,10940,11141,6233,201,PERF
42283324190000,PI,IP,001,10,11220,11421,6233,201,PERF
42283324190000,PI,IP,001,11,11500,11701,6233,201,PERF
42283324190000,PI,IP,001,12,11780,11981,6233,201,PERF
42283324190000,PI,IP,001,13,12060,12261,6233,201,PERF
42283324190000,PI,IP,001,14,12340,12540,6233,200,PERF
42283324190000,PI,IP,001,15,12620,12821,6233,201,PERF
42283324190000,PI,IP,001,16,12900,13100,6233,200,PERF
42283324190000,PI,IP,001,17,13180,13381,6233,201,PERF
42283324190000,PI,IP,001,18,13460,13661,6233,201,PERF
42283324190000,PI,IP,001,19,13740,13941,6233,201,PERF
42283324190000,PI,IP,001,20,14020,14221,6233,201,PERF
42283324200000,PI,IP,001,1,9309,14053,4905,4744,PERF
42283324210000,PI,IP,001,1,9161,12705,4387,3544,PERF
42283324220000,PI,IP,001,1,11441,16614,,5173,PERF
42283324230000,PI,IP,001,1,8150,8481,6011,331,PERF
42283324230000,PI,IP,001,2,8585,8896,6011,311,PERF
42283324230000,PI,IP,001,3,8995,9256,6011,261,PERF
42283324230000,PI,IP,001,4,9355,9616,6011,261,PERF
42283324230000,PI,IP,001,5,9710,9971,6011,261,PERF
42283324230000,PI,IP,001,6,10060,10306,6011,246,PERF
42283324230000,PI,IP,001,7,10405,10666,6011,261,PERF
42283324230000,PI,IP,001,8,10765,11026,6011,261,PERF
42283324230000,PI,IP,001,9,11110,11351,6011,241,PERF
42283324230000,PI,IP,001,10,11450,11711,6011,261,PERF
42283324230000,PI,IP,001,11,11810,12071,6011,261,PERF
42283324230000,PI,IP,001,12,12165,12416,6011,251,PERF
42283324230000,PI,IP,001,13,12510,12751,6011,241,PERF
42283324230000,PI,IP,001,14,12245,12506,6011,261,REPERF
42283324230000,PI,IP,001,15,13180,13441,6011,261,PERF
42283324240000,PI,IP,001,1,11227,16828,6367,5601,PERF
42283324250000,PI,IP,001,1,7960,8153,5067,193,PERF
42283324250000,PI,IP,001,2,8229,8422,5067,193,PERF
42283324250000,PI,IP,001,3,8498,8691,5067,193,PERF
42283324250000,PI,IP,001,4,8767,8960,5067,193,PERF
42283324250000,PI,IP,001,5,9036,9229,5067,193,PERF
42283324250000,PI,IP,001,6,9305,9498,5067,193,PERF
42283324250000,PI,IP,001,7,9574,9767,5067,193,PERF
42283324250000,PI,IP,001,8,9843,10036,5067,193,PERF
42283324250000,PI,IP,001,9,10112,10305,5067,193,PERF
42283324250000,PI,IP,001,10,10381,10574,5067,193,PERF
42283324250000,PI,IP,001,11,10650,10843,5067,193,PERF
42283324250000,PI,IP,001,12,10919,11112,5067,193,PERF
42283324250000,PI,IP,001,13,11188,11381,5067,193,PERF
42283324250000,PI,IP,001,14,11457,11650,5067,193,PERF
42283324250000,PI,IP,001,15,11726,11919,5067,193,PERF
42283324250000,PI,IP,001,16,11995,12188,5067,193,PERF
42283324260100,PI,IP,001,1,10157,14387,6443,4230,PERF
42283324270000,PI,IP,001,1,10100,16106,6653,6006,PERF
42283324280000,PI,IP,001,1,9617,15478,6608,5861,PERF
42283324290000,PI,IP,001,1,11137,16078,5984,4941,PERF
42283324300000,PI,IP,001,1,10175,16185,6774,6010,PERF
42283324310000,PI,IP,001,1,8851,8861,5968,10,PERF
42283324310000,PI,IP,001,2,9148,9158,5968,10,PERF
42283324310000,PI,IP,001,3,9439,9449,5968,10,PERF
42283324310000,PI,IP,001,4,9733,9743,5968,10,PERF
42283324310000,PI,IP,001,5,10027,10037,5968,10,PERF
42283324310000,PI,IP,001,6,10321,10331,5968,10,PERF
42283324310000,PI,IP,001,7,10615,10625,5968,10,PERF
42283324310000,PI,IP,001,8,10909,10919,5968,10,PERF
42283324310000,PI,IP,001,9,11203,11213,5968,10,PERF
42283324310000,PI,IP,001,10,11497,11507,5968,10,PERF
42283324310000,PI,IP,001,11,11791,11801,5968,10,PERF
42283324310000,PI,IP,001,12,12085,12095,5968,10,PERF
42283324310000,PI,IP,001,13,12379,12389,5968,10,PERF
42283324310000,PI,IP,001,14,12673,12683,5968,10,PERF
42283324310000,PI,IP,001,15,12953,12963,5968,10,PERF
42283324310000,PI,IP,001,16,13261,13271,5968,10,PERF
42283324310000,PI,IP,001,17,13517,13527,5968,10,PERF
42283324310000,PI,IP,001,18,13849,13859,5968,10,PERF
42283324320000,PI,IP,001,1,10062,10274,6470,212,PERF
42283324320000,PI,IP,001,2,10350,10560,6470,210,PERF
42283324320000,PI,IP,001,3,10639,10851,6470,212,PERF
42283324320000,PI,IP,001,4,10927,11139,6470,212,PERF
42283324320000,PI,IP,001,5,11215,11428,6470,213,PERF
42283324320000,PI,IP,001,6,11504,11716,6470,212,PERF
42283324320000,PI,IP,001,7,11792,12072,6470,280,PERF
42283324320000,PI,IP,001,8,12143,12426,6470,283,PERF
42283324320000,PI,IP,001,9,12502,12781,6470,279,PERF
42283324320000,PI,IP,001,10,12857,13136,6470,279,PERF
42283324320000,PI,IP,001,11,13212,13491,6470,279,PERF
42283324320000,PI,IP,001,12,13567,13775,6470,208,PERF
42283324320000,PI,IP,001,13,13851,14058,6470,207,PERF
42283324320000,PI,IP,001,14,14134,14341,6470,207,PERF
42283324320000,PI,IP,001,15,14417,14625,6470,208,PERF
42283324320000,PI,IP,001,16,14701,14908,6470,207,PERF
42283324320000,PI,IP,001,17,14984,15192,6470,208,PERF
42283324320000,PI,IP,001,18,15268,15475,6470,207,PERF
42283324330000,PI,IP,001,1,10011,10226,6474,215,PERF
42283324330000,PI,IP,001,2,10302,10518,6474,216,PERF
42283324330000,PI,IP,001,3,10594,10809,6474,215,PERF
42283324330000,PI,IP,001,4,10885,11101,6474,216,PERF
42283324330000,PI,IP,001,5,11177,11392,6474,215,PERF
42283324330000,PI,IP,001,6,11468,11684,6474,216,PERF
42283324330000,PI,IP,001,7,11760,11975,6474,215,PERF
42283324330000,PI,IP,001,8,12051,12267,6474,216,PERF
42283324330000,PI,IP,001,9,12343,12558,6474,215,PERF
42283324330000,PI,IP,001,10,12634,12850,6474,216,PERF
42283324330000,PI,IP,001,11,12931,13141,6474,210,PERF
42283324330000,PI,IP,001,12,13217,13432,6474,215,PERF
42283324330000,PI,IP,001,13,13510,13724,6474,214,PERF
42283324330000,PI,IP,001,14,13800,14015,6474,215,PERF
42283324330000,PI,IP,001,15,14094,14307,6474,213,PERF
42283324330000,PI,IP,001,16,14383,14598,6474,215,PERF
42283324330000,PI,IP,001,17,14674,14890,6474,216,PERF
42283324330000,PI,IP,001,18,14966,15181,6474,215,PERF
42283324330000,PI,IP,001,19,15257,15473,6474,216,PERF
42283324330000,PI,IP,001,20,15549,15764,6474,215,PERF
42283324340000,PI,IP,001,1,10080,10284,6620,204,PERF
42283324340000,PI,IP,001,2,10360,10564,6620,204,PERF
42283324340000,PI,IP,001,3,10640,10844,6620,204,PERF
42283324340000,PI,IP,001,4,10920,11125,6620,205,PERF
42283324340000,PI,IP,001,5,11201,11405,6620,204,PERF
42283324340000,PI,IP,001,6,11481,11685,6620,204,PERF
42283324340000,PI,IP,001,7,11761,11965,6620,204,PERF
42283324340000,PI,IP,001,8,12041,12208,6620,167,PERF
42283324340000,PI,IP,001,9,12350,12518,6620,168,PERF
42283324340000,PI,IP,001,10,12660,12827,6620,167,PERF
42283324340000,PI,IP,001,11,12970,13137,6620,167,PERF
42283324340000,PI,IP,001,12,13277,13513,6620,236,PERF
42283324340000,PI,IP,001,13,13589,13828,6620,239,PERF
42283324340000,PI,IP,001,14,13906,14133,6620,227,PERF
42283324340000,PI,IP,001,15,14209,14443,6620,234,PERF
42283324340000,PI,IP,001,16,14525,14753,6620,228,PERF
42283324340000,PI,IP,001,17,14829,15063,6620,234,PERF
42283324340000,PI,IP,001,18,15139,15343,6620,204,PERF
42283324340000,PI,IP,001,19,15419,15623,6620,204,PERF
42283324360000,PI,IP,001,1,9955,15778,6700,5823,PERF
42283324370000,PI,IP,001,1,9970,15540,6503,5570,PERF
42283324380000,PI,IP,001,1,8960,14561,6075,5601,PERF
42283324390000,PI,IP,001,1,8767,8968,6483,201,PERF
42283324390000,PI,IP,001,2,9037,9238,6483,201,PERF
42283324390000,PI,IP,001,3,9307,9508,6483,201,PERF
42283324390000,PI,IP,001,4,9577,9778,6483,201,PERF
42283324390000,PI,IP,001,5,9847,10048,6483,201,PERF
42283324390000,PI,IP,001,6,10117,10318,6483,201,PERF
42283324390000,PI,IP,001,7,10387,10588,6483,201,PERF
42283324390000,PI,IP,001,8,10657,10858,6483,201,PERF
42283324390000,PI,IP,001,9,10927,11128,6483,201,PERF
42283324390000,PI,IP,001,10,11197,11398,6483,201,PERF
42283324390000,PI,IP,001,11,11467,11668,6483,201,PERF
42283324390000,PI,IP,001,12,11967,12143,6483,176,PERF
42283324390000,PI,IP,001,13,12202,12383,6483,181,PERF
42283324390000,PI,IP,001,14,12442,12623,6483,181,PERF
42283324390000,PI,IP,001,15,12682,12883,6483,201,PERF
42283324390000,PI,IP,001,16,12942,13143,6483,201,PERF
42283324390000,PI,IP,001,17,13202,13403,6483,201,PERF
42283324390000,PI,IP,001,18,13462,13663,6483,201,PERF
42283324390000,PI,IP,001,19,13722,13923,6483,201,PERF
42283324400000,PI,IP,001,1,9564,13560,4717,3996,PERF
42283324420000,PI,IP,001,1,8789,8791,5767,2,PERF
42283324420000,PI,IP,001,2,9084,9086,5767,2,PERF
42283324420000,PI,IP,001,3,9379,9381,5767,2,PERF
42283324420000,PI,IP,001,4,9674,9676,5767,2,PERF
42283324420000,PI,IP,001,5,9969,9971,5767,2,PERF
42283324420000,PI,IP,001,6,10264,10266,5767,2,PERF
42283324420000,PI,IP,001,7,10559,10561,5767,2,PERF
42283324420000,PI,IP,001,8,10854,10856,5767,2,PERF
42283324420000,PI,IP,001,9,11149,11151,5767,2,PERF
42283324420000,PI,IP,001,10,11444,11446,5767,2,PERF
42283324420000,PI,IP,001,11,11739,11741,5767,2,PERF
42283324420000,PI,IP,001,12,12034,12036,5767,2,PERF
42283324420000,PI,IP,001,13,12329,12331,5767,2,PERF
42283324420000,PI,IP,001,14,12624,12626,5767,2,PERF
42283324420000,PI,IP,001,15,12919,12921,5767,2,PERF
42283324420000,PI,IP,001,16,13214,13216,5767,2,PERF
42283324420000,PI,IP,001,17,13509,13511,5767,2,PERF
42283324420000,PI,IP,001,18,13804,13814,5767,10,PERF
42283324430000,PI,IP,001,1,11355,16391,5737,5036,PERF
42283324440000,PI,IP,001,1,11431,16149,5328,4718,PERF
42283324450000,PI,IP,001,1,8896,9097,6504,201,PERF
42283324450000,PI,IP,001,2,9176,9377,6504,201,PERF
42283324450000,PI,IP,001,3,9456,9657,6504,201,PERF
42283324450000,PI,IP,001,4,9736,9937,6504,201,PERF
42283324450000,PI,IP,001,5,10016,10217,6504,201,PERF
42283324450000,PI,IP,001,6,10296,10497,6504,201,PERF
42283324450000,PI,IP,001,7,10576,10777,6504,201,PERF
42283324450000,PI,IP,001,8,10856,11057,6504,201,PERF
42283324450000,PI,IP,001,9,11136,11337,6504,201,PERF
42283324450000,PI,IP,001,10,11416,11617,6504,201,PERF
42283324450000,PI,IP,001,11,11696,11897,6504,201,PERF
42283324450000,PI,IP,001,12,11976,12177,6504,201,PERF
42283324450000,PI,IP,001,13,12256,12457,6504,201,PERF
42283324450000,PI,IP,001,14,12536,12737,6504,201,PERF
42283324450000,PI,IP,001,15,12816,13017,6504,201,PERF
42283324450000,PI,IP,001,16,13096,13297,6504,201,PERF
42283324450000,PI,IP,001,17,13376,13577,6504,201,PERF
42283324450000,PI,IP,001,18,13656,13857,6504,201,PERF
42283324450000,PI,IP,001,19,13937,14137,6504,200,PERF
42283324450000,PI,IP,001,20,14211,14412,6504,201,PERF
42283324460000,PI,IP,001,1,8373,8537,4741,164,PERF
42283324460000,PI,IP,001,2,8591,8757,4741,166,PERF
42283324460000,PI,IP,001,3,8810,8976,4741,166,PERF
42283324460000,PI,IP,001,4,9029,9195,4741,166,PERF
42283324460000,PI,IP,001,5,9247,9413,4741,166,PERF
42283324460000,PI,IP,001,6,9466,9632,4741,166,PERF
42283324460000,PI,IP,001,7,9685,9851,4741,166,PERF
42283324460000,PI,IP,001,8,9903,10069,4741,166,PERF
42283324460000,PI,IP,001,9,10122,10288,4741,166,PERF
42283324460000,PI,IP,001,10,10341,10507,4741,166,PERF
42283324460000,PI,IP,001,11,10559,10725,4741,166,PERF
42283324460000,PI,IP,001,12,10778,10944,4741,166,PERF
42283324460000,PI,IP,001,13,10997,11163,4741,166,PERF
42283324460000,PI,IP,001,14,11215,11381,4741,166,PERF
42283324460000,PI,IP,001,15,11434,11600,4741,166,PERF
42283324460000,PI,IP,001,16,11653,11819,4741,166,PERF
42283324470000,PI,PT,001,1,8787,9008,,221,PERF
42283324470000,PI,PT,001,2,9082,9303,,221,PERF
42283324470000,PI,PT,001,3,9377,9598,,221,PERF
42283324470000,PI,PT,001,4,9672,9894,,222,PERF
42283324470000,PI,PT,001,5,9968,10189,,221,PERF
42283324470000,PI,PT,001,6,10263,10484,,221,PERF
42283324470000,PI,PT,001,7,10558,10779,,221,PERF
42283324470000,PI,PT,001,8,10853,11074,,221,PERF
42283324470000,PI,PT,001,9,11148,11369,,221,PERF
42283324470000,PI,PT,001,10,11443,11665,,222,PERF
42283324470000,PI,PT,001,11,11739,11960,,221,PERF
42283324470000,PI,PT,001,12,12034,12255,,221,PERF
42283324470000,PI,PT,001,13,12329,12550,,221,PERF
42283324470000,PI,PT,001,14,12624,12845,,221,PERF
42283324470000,PI,PT,001,15,12919,13140,,221,PERF
42283324470000,PI,PT,001,16,13214,13436,,222,PERF
42283324470000,PI,PT,001,17,13510,13731,,221,PERF
42283324490000,PI,PT,001,1,9126,9353,,227,PERF
42283324490000,PI,PT,001,2,9429,9655,,226,PERF
42283324490000,PI,PT,001,3,9731,9958,,227,PERF
42283324490000,PI,PT,001,4,10034,10261,,227,PERF
42283324490000,PI,PT,001,5,10337,10563,,226,PERF
42283324490000,PI,PT,001,6,10639,10866,,227,PERF
42283324490000,PI,PT,001,7,10942,11169,,227,PERF
42283324490000,PI,PT,001,8,11245,11471,,226,PERF
42283324490000,PI,PT,001,9,11547,11774,,227,PERF
42283324490000,PI,PT,001,10,11850,12076,,226,PERF
42283324490000,PI,PT,001,11,12152,12379,,227,PERF
42283324490000,PI,PT,001,12,12455,12682,,227,PERF
42283324490000,PI,PT,001,13,12758,12984,,226,PERF
42283324490000,PI,PT,001,14,13060,13287,,227,PERF
42283324490000,PI,PT,001,15,13363,13590,,227,PERF
42283324490000,PI,PT,001,16,13666,13892,,226,PERF
42283324490000,PI,PT,001,17,13968,14195,,227,PERF
42283324540000,PI,IP,001,1,9374,14863,5911,5489,PERF
42283324540000,PI,PT,001,1,9374,14863,5911,5489,PERF
42283324590000,PI,IP,001,1,9195,9396,10430,201,PERF
42283324590000,PI,IP,001,2,9485,9686,10430,201,PERF
42283324590000,PI,IP,001,3,9775,9976,10430,201,PERF
42283324590000,PI,IP,001,4,10065,10266,10430,201,PERF
42283324590000,PI,IP,001,5,10355,10556,10430,201,PERF
42283324590000,PI,IP,001,6,10645,10846,10430,201,PERF
42283324590000,PI,IP,001,7,10935,11136,10430,201,PERF
42283324590000,PI,IP,001,8,11225,11426,10430,201,PERF
42283324590000,PI,IP,001,9,11515,11716,10430,201,PERF
42283324590000,PI,IP,001,10,11805,12006,10430,201,PERF
42283324590000,PI,IP,001,11,12095,12296,10430,201,PERF
42283324590000,PI,IP,001,12,12385,12586,10430,201,PERF
42283324590000,PI,IP,001,13,12675,12876,10430,201,PERF
42283324590000,PI,IP,001,14,12965,13166,10430,201,PERF
42283324590000,PI,IP,001,15,13255,13456,10430,201,PERF
42283324590000,PI,IP,001,16,13545,13746,10430,201,PERF
42283324590000,PI,IP,001,17,13835,14036,10430,201,PERF
42283324590000,PI,IP,001,18,14125,14326,10430,201,PERF
42283324590000,PI,IP,001,19,14415,14616,10430,201,PERF
42283324590000,PI,IP,001,20,14705,14906,10430,201,PERF
42283324590000,PI,IP,001,21,14995,15196,10430,201,PERF
42283324590000,PI,IP,001,22,15285,15486,10430,201,PERF
42283324590000,PI,IP,001,23,15575,15776,10430,201,PERF
42283324590000,PI,IP,001,24,15865,16066,10430,201,PERF
42283324590000,PI,IP,001,25,16155,16356,10430,201,PERF
42283324590000,PI,IP,001,26,16445,16646,10430,201,PERF
42283324590000,PI,IP,001,27,16735,16936,10430,201,PERF
42283324590000,PI,IP,001,28,17025,17226,10430,201,PERF
42283324590000,PI,IP,001,29,17315,17516,10430,201,PERF
42283324590000,PI,IP,001,30,17605,17806,10430,201,PERF
42283324590000,PI,IP,001,31,17895,18096,10430,201,PERF
42283324590000,PI,IP,001,32,18185,18386,10430,201,PERF
42283324600000,PI,IP,001,1,8910,14870,6674,5960,PERF
42283324610000,PI,IP,001,1,8992,15432,6586,6440,PERF
42283324650000,PI,IP,001,1,10196,15365,5761,5169,PERF
42283324660100,PI,IP,001,1,8025,12127,4818,4102,PERF
42283324670000,PI,IP,001,1,8180,12297,4856,4117,PERF
42283324680000,PI,IP,001,1,9843,14781,5746,4938,PERF
42283324690000,PI,IP,001,1,8667,8868,6509,201,PERF
42283324690000,PI,IP,001,2,8947,9148,6509,201,PERF
42283324690000,PI,IP,001,3,9227,9428,6509,201,PERF
42283324690000,PI,IP,001,4,9507,9708,6509,201,PERF
42283324690000,PI,IP,001,5,9787,9988,6509,201,PERF
42283324690000,PI,IP,001,6,10067,10268,6509,201,PERF
42283324690000,PI,IP,001,7,10347,10548,6509,201,PERF
42283324690000,PI,IP,001,8,10627,10828,6509,201,PERF
42283324690000,PI,IP,001,9,10907,11108,6509,201,PERF
42283324690000,PI,IP,001,10,11187,11388,6509,201,PERF
42283324690000,PI,IP,001,11,11467,11668,6509,201,PERF
42283324690000,PI,IP,001,12,11747,11948,6509,201,PERF
42283324690000,PI,IP,001,13,12027,12228,6509,201,PERF
42283324690000,PI,IP,001,14,12527,12728,6509,201,PERF
42283324690000,PI,IP,001,15,12807,13008,6509,201,PERF
42283324690000,PI,IP,001,16,13087,13288,6509,201,PERF
42283324690000,PI,IP,001,17,13367,13568,6509,201,PERF
42283324690000,PI,IP,001,18,13630,13831,6509,201,PERF
42283324690000,PI,IP,001,19,13890,14091,6509,201,PERF
42283324690000,PI,IP,001,20,14150,14351,6509,201,PERF
42283324690000,PI,IP,001,21,14410,14611,6509,201,PERF
42283324700000,PI,IP,001,1,8732,8933,6546,201,PERF
42283324700000,PI,IP,001,2,9012,9213,6546,201,PERF
42283324700000,PI,IP,001,3,9292,9493,6546,201,PERF
42283324700000,PI,IP,001,4,9572,9773,6546,201,PERF
42283324700000,PI,IP,001,5,9852,10053,6546,201,PERF
42283324700000,PI,IP,001,6,10132,10333,6546,201,PERF
42283324700000,PI,IP,001,7,10412,10613,6546,201,PERF
42283324700000,PI,IP,001,8,10692,10893,6546,201,PERF
42283324700000,PI,IP,001,9,10972,11173,6546,201,PERF
42283324700000,PI,IP,001,10,11252,11453,6546,201,PERF
42283324700000,PI,IP,001,11,11532,11733,6546,201,PERF
42283324700000,PI,IP,001,12,11812,12013,6546,201,PERF
42283324700000,PI,IP,001,13,12092,12293,6546,201,PERF
42283324700000,PI,IP,001,14,12372,12573,6546,201,PERF
42283324700000,PI,IP,001,15,12872,13073,6546,201,PERF
42283324700000,PI,IP,001,16,13132,13333,6546,201,PERF
42283324700000,PI,IP,001,17,13392,13593,6546,201,PERF
42283324700000,PI,IP,001,18,13652,13843,6546,191,PERF
42283324700000,PI,IP,001,19,13932,14133,6546,201,PERF
42283324700000,PI,IP,001,20,14212,14413,6546,201,PERF
42283324700000,PI,IP,001,21,14492,14693,6546,201,PERF
42283324710000,PI,IP,001,1,9901,14304,5254,4403,PERF
42283324720000,PI,IP,001,1,9960,15473,5982,5513,PERF
42283324860000,PI,IP,001,1,9585,14486,5530,4901,PERF
42283324970000,PI,IP,001,1,9850,12301,3441,2451,PERF
42283325000000,PI,IP,001,1,10139,16348,7083,6209,PERF
42283325010000,PI,IP,001,1,10358,10602,7283,244,PERF
42283325010000,PI,IP,001,2,10678,10922,7283,244,PERF
42283325010000,PI,IP,001,3,10998,11242,7283,244,PERF
42283325010000,PI,IP,001,4,11318,11562,7283,244,PERF
42283325010000,PI,IP,001,5,11638,11882,7283,244,PERF
42283325010000,PI,IP,001,6,11958,12202,7283,244,PERF
42283325010000,PI,IP,001,7,12278,12522,7283,244,PERF
42283325010000,PI,IP,001,8,12598,12842,7283,244,PERF
42283325010000,PI,IP,001,9,12918,13162,7283,244,PERF
42283325010000,PI,IP,001,10,13238,13482,7283,244,PERF
42283325010000,PI,IP,001,11,13558,13802,7283,244,PERF
42283325010000,PI,IP,001,12,13878,14122,7283,244,PERF
42283325010000,PI,IP,001,13,14198,14442,7283,244,PERF
42283325010000,PI,IP,001,14,14518,14762,7283,244,PERF
42283325010000,PI,IP,001,15,14838,15082,7283,244,PERF
42283325010000,PI,IP,001,16,15158,15402,7283,244,PERF
42283325010000,PI,IP,001,17,15478,15722,7283,244,PERF
42283325010000,PI,IP,001,18,15798,16042,7283,244,PERF
42283325010000,PI,IP,001,19,16118,16362,7283,244,PERF
42283325010000,PI,IP,001,20,16438,16682,7283,244,PERF
42283325050000,PI,IP,001,1,10160,15120,5928,4960,PERF
42283325060000,PI,IP,001,1,10060,15102,5933,5042,PERF
42283325070000,PI,IP,001,1,9930,15053,5898,5123,PERF
42283325530000,PI,IP,001,1,9877,17633,8234,7756,PERF
42283325540000,PI,IP,001,1,10023,16023,6699,6000,PERF
42283325550000,PI,IP,001,1,9524,14584,,5060,PERF
42283325560000,PI,IP,001,1,9604,9955,,351,PERF
42283325560000,PI,IP,001,2,10024,10375,,351,PERF
42283325560000,PI,IP,001,3,10444,10795,,351,PERF
42283325560000,PI,IP,001,4,10864,11215,,351,PERF
42283325560000,PI,IP,001,5,11284,11635,,351,PERF
42283325560000,PI,IP,001,6,11704,12055,,351,PERF
42283325560000,PI,IP,001,7,12124,12475,,351,PERF
42283325560000,PI,IP,001,8,12544,12895,,351,PERF
42283325560000,PI,IP,001,9,12964,13315,,351,PERF
42283325560000,PI,IP,001,10,13384,13735,,351,PERF
42283325560000,PI,IP,001,11,13804,14155,,351,PERF
42283325560000,PI,IP,001,12,14214,14355,,141,PERF
42283325650000,PI,IP,001,1,10173,10370,4824,197,PERF
42283325650000,PI,IP,001,2,10446,10643,4824,197,PERF
42283325650000,PI,IP,001,3,10719,10915,4824,196,PERF
42283325650000,PI,IP,001,4,10992,11189,4824,197,PERF
42283325650000,PI,IP,001,5,11265,11462,4824,197,PERF
42283325650000,PI,IP,001,6,11538,11735,4824,197,PERF
42283325650000,PI,IP,001,7,11811,12008,4824,197,PERF
42283325650000,PI,IP,001,8,12084,12281,4824,197,PERF
42283325650000,PI,IP,001,9,12357,12554,4824,197,PERF
42283325650000,PI,IP,001,10,12630,12827,4824,197,PERF
42283325650000,PI,IP,001,11,12903,13100,4824,197,PERF
42283325650000,PI,IP,001,12,13176,13373,4824,197,PERF
42283325650000,PI,IP,001,13,13449,13646,4824,197,PERF
42283325650000,PI,IP,001,14,13722,13919,4824,197,PERF
42283325650000,PI,IP,001,15,13995,14192,4824,197,PERF
42283325660000,PI,IP,001,1,9092,9293,5920,201,PERF
42283325660000,PI,IP,001,2,9342,9543,5920,201,PERF
42283325660000,PI,IP,001,3,9592,9793,5920,201,PERF
42283325660000,PI,IP,001,4,9842,10043,5920,201,PERF
42283325660000,PI,IP,001,5,10092,10293,5920,201,PERF
42283325660000,PI,IP,001,6,10342,10543,5920,201,PERF
42283325660000,PI,IP,001,7,10592,10793,5920,201,PERF
42283325660000,PI,IP,001,8,10842,11043,5920,201,PERF
42283325660000,PI,IP,001,9,11092,11293,5920,201,PERF
42283325660000,PI,IP,001,10,11342,11543,5920,201,PERF
42283325660000,PI,IP,001,11,11592,11793,5920,201,PERF
42283325660000,PI,IP,001,12,11842,12043,5920,201,PERF
42283325660000,PI,IP,001,13,12092,12292,5920,200,PERF
42283325660000,PI,IP,001,14,12342,12543,5920,201,PERF
42283325660000,PI,IP,001,15,12592,12793,5920,201,PERF
42283325660000,PI,IP,001,16,12842,13043,5920,201,PERF
42283325660000,PI,IP,001,17,13092,13293,5920,201,PERF
42283325660000,PI,IP,001,18,13342,13543,5920,201,PERF
42283325660000,PI,IP,001,19,13592,13793,5920,201,PERF
42283325680000,PI,IP,001,1,9305,15143,6328,5838,COMB
42283325690000,PI,IP,001,1,9197,15497,7064,6300,PERF
42283325700000,PI,IP,001,1,10239,14296,4756,4057,PERF
42283325710000,PI,IP,001,1,10205,10393,4008,188,PERF
42283325710000,PI,IP,001,2,10469,10657,4008,188,PERF
42283325710000,PI,IP,001,3,10733,10921,4008,188,PERF
42283325710000,PI,IP,001,4,10997,11185,4008,188,PERF
42283325710000,PI,IP,001,5,11261,11449,4008,188,PERF
42283325710000,PI,IP,001,6,11525,11713,4008,188,PERF
42283325710000,PI,IP,001,7,11789,11977,4008,188,PERF
42283325710000,PI,IP,001,8,12053,12241,4008,188,PERF
42283325710000,PI,IP,001,9,12317,12505,4008,188,PERF
42283325710000,PI,IP,001,10,12581,12769,4008,188,PERF
42283325710000,PI,IP,001,11,12845,13030,4008,185,PERF
42283325710000,PI,IP,001,12,13136,13327,4008,191,PERF
42283325720000,PI,IP,001,1,10314,10514,3834,200,PERF
42283325720000,PI,IP,001,2,10593,10792,3834,199,PERF
42283325720000,PI,IP,001,3,10871,11074,3834,203,PERF
42283325720000,PI,IP,001,4,11150,11353,3834,203,PERF
42283325720000,PI,IP,001,5,11429,11632,3834,203,PERF
42283325720000,PI,IP,001,6,11708,11910,3834,202,PERF
42283325720000,PI,IP,001,7,11986,12189,3834,203,PERF
42283325720000,PI,IP,001,8,12265,12468,3834,203,PERF
42283325720000,PI,IP,001,9,12540,12746,3834,206,PERF
42283325720000,PI,IP,001,10,12822,13025,3834,203,PERF
42283325720000,PI,IP,001,11,13101,13304,3834,203,PERF
42283325730000,PI,IP,001,1,8430,13552,5928,5122,PERF
42283325740000,PI,IP,001,1,8405,13527,5621,5122,PERF
42283325750000,PI,IP,001,1,9051,14210,5707,5159,PERF
42283325760000,PI,IP,001,1,9519,14345,5765,4826,PERF
42283325830000,PI,IP,001,1,9185,14149,5914,4964,PERF
42283325840000,PI,IP,001,1,9400,14151,5829,4751,PERF
42283325860000,PI,IP,001,1,11568,16101,5323,4533,PERF
42283325870000,PI,IP,001,1,8959,14810,6013,5851,PERF
42283325880000,PI,IP,001,1,9147,13847,5724,4700,PERF
42283325890000,PI,IP,001,1,8877,9089,4783,212,PERF
42283325890000,PI,IP,001,2,9163,9375,4783,212,PERF
42283325890000,PI,IP,001,3,9449,9662,4783,213,PERF
42283325890000,PI,IP,001,4,9736,9948,4783,212,PERF
42283325890000,PI,IP,001,5,10022,10234,4783,212,PERF
42283325890000,PI,IP,001,6,10308,10520,4783,212,PERF
42283325890000,PI,IP,001,7,10594,10806,4783,212,PERF
42283325890000,PI,IP,001,8,10870,11083,4783,213,PERF
42283325890000,PI,IP,001,9,11150,11363,4783,213,PERF
42283325890000,PI,IP,001,10,11440,11653,4783,213,PERF
42283325890000,PI,IP,001,11,11739,11951,4783,212,PERF
42283325890000,PI,IP,001,12,12025,12237,4783,212,PERF
42283325890000,PI,IP,001,13,12311,12532,4783,221,PERF
42283325890000,PI,IP,001,14,12597,12810,4783,213,PERF
42283325900000,PI,IP,001,1,8824,9029,4566,205,PERF
42283325900000,PI,IP,001,2,9103,9307,4566,204,PERF
42283325900000,PI,IP,001,3,9381,9586,4566,205,PERF
42283325900000,PI,IP,001,4,9660,9864,4566,204,PERF
42283325900000,PI,IP,001,5,9938,10143,4566,205,PERF
42283325900000,PI,IP,001,6,10217,10421,4566,204,PERF
42283325900000,PI,IP,001,7,10495,10700,4566,205,PERF
42283325900000,PI,IP,001,8,10774,10978,4566,204,PERF
42283325900000,PI,IP,001,9,11053,11257,4566,204,PERF
42283325900000,PI,IP,001,10,11331,11535,4566,204,PERF
42283325900000,PI,IP,001,11,11609,11814,4566,205,PERF
42283325900000,PI,IP,001,12,11888,12092,4566,204,PERF
42283325900000,PI,IP,001,13,12166,12371,4566,205,PERF
42283325900000,PI,IP,001,14,12445,12649,4566,204,PERF
42283325910000,PI,IP,001,1,11582,15310,5018,3728,PERF
42283325920000,PI,IP,001,1,9475,9673,4928,198,PERF
42283325920000,PI,IP,001,2,9749,9948,4928,199,PERF
42283325920000,PI,IP,001,3,10024,10222,4928,198,PERF
42283325920000,PI,IP,001,4,10298,10496,4928,198,PERF
42283325920000,PI,IP,001,5,10572,10770,4928,198,PERF
42283325920000,PI,IP,001,6,10846,11045,4928,199,PERF
42283325920000,PI,IP,001,7,11212,11319,4928,107,PERF
42283325920000,PI,IP,001,8,11395,11593,4928,198,PERF
42283325920000,PI,IP,001,9,11669,11867,4928,198,PERF
42283325920000,PI,IP,001,10,11943,12142,4928,199,PERF
42283325920000,PI,IP,001,11,12218,12416,4928,198,PERF
42283325920000,PI,IP,001,12,12492,12690,4928,198,PERF
42283325920000,PI,IP,001,13,12766,12961,4928,195,PERF
42283325920000,PI,IP,001,14,13040,13239,4928,199,PERF
42283325920000,PI,IP,001,15,13315,13513,4928,198,PERF
42283325920000,PI,IP,001,16,13589,13787,4928,198,PERF
42283325930000,PI,IP,001,1,9100,13450,5088,4350,PERF
42283325940000,PI,IP,001,1,9050,9246,5076,196,PERF
42283325940000,PI,IP,001,2,9314,9519,5076,205,PERF
42283325940000,PI,IP,001,3,9595,9791,5076,196,PERF
42283325940000,PI,IP,001,4,9867,10063,5076,196,PERF
42283325940000,PI,IP,001,5,10139,10336,5076,197,PERF
42283325940000,PI,IP,001,6,10412,10608,5076,196,PERF
42283325940000,PI,IP,001,7,10684,10880,5076,196,PERF
42283325940000,PI,IP,001,8,10956,11153,5076,197,PERF
42283325940000,PI,IP,001,9,11229,11425,5076,196,PERF
42283325940000,PI,IP,001,10,11501,11697,5076,196,PERF
42283325940000,PI,IP,001,11,11773,11970,5076,197,PERF
42283325940000,PI,IP,001,12,12046,12242,5076,196,PERF
42283325940000,PI,IP,001,13,12318,12514,5076,196,PERF
42283325940000,PI,IP,001,14,12590,12787,5076,197,PERF
42283325940000,PI,IP,001,15,12863,13059,5076,196,PERF
42283325940000,PI,IP,001,16,13135,13331,5076,196,PERF
42283325950000,PI,IP,001,1,9132,13327,5067,4195,PERF
42283325960000,PI,IP,001,1,9853,16525,6864,6672,PERF
42283325970000,PI,IP,001,1,11478,18262,7435,6784,PERF
42283325990100,PI,IP,001,1,8225,12004,5062,3779,PERF
42283326010000,PI,IP,001,1,9423,9656,7972,233,PERF
42283326010000,PI,IP,001,2,9732,9966,7972,234,PERF
42283326010000,PI,IP,001,3,10042,10275,7972,233,PERF
42283326010000,PI,IP,001,4,10351,10584,7972,233,PERF
42283326010000,PI,IP,001,5,10660,10894,7972,234,PERF
42283326010000,PI,IP,001,6,10970,11203,7972,233,PERF
42283326010000,PI,IP,001,7,11279,11512,7972,233,PERF
42283326010000,PI,IP,001,8,11588,11821,7972,233,PERF
42283326010000,PI,IP,001,9,11897,12131,7972,234,PERF
42283326010000,PI,IP,001,10,12207,12440,7972,233,PERF
42283326010000,PI,IP,001,11,12516,12749,7972,233,PERF
42283326010000,PI,IP,001,12,12825,13059,7972,234,PERF
42283326010000,PI,IP,001,13,13135,13368,7972,233,PERF
42283326010000,PI,IP,001,14,13444,13677,7972,233,PERF
42283326010000,PI,IP,001,15,13753,13987,7972,234,PERF
42283326010000,PI,IP,001,16,14063,14296,7972,233,PERF
42283326010000,PI,IP,001,17,14372,14605,7972,233,PERF
42283326010000,PI,IP,001,18,14681,14915,7972,234,PERF
42283326010000,PI,IP,001,19,14991,15224,7972,233,PERF
42283326010000,PI,IP,001,20,15300,15490,7972,190,PERF
42283326010000,PI,IP,001,21,15609,15843,7972,234,PERF
42283326010000,PI,IP,001,22,15919,16151,7972,232,PERF
42283326010000,PI,IP,001,23,16228,16481,7972,253,PERF
42283326030000,PI,IP,001,1,10452,15075,4967,4623,PERF
42283326050000,PI,IP,001,1,11335,17221,6589,5886,PERF
42283326060000,PI,IP,001,1,11036,15754,5179,4718,PERF
42283326070000,PI,IP,001,1,9101,9342,5773,241,PERF
42283326070000,PI,IP,001,2,9418,9660,5773,242,PERF
42283326070000,PI,IP,001,3,9736,9977,5773,241,PERF
42283326070000,PI,IP,001,4,10053,10295,5773,242,PERF
42283326070000,PI,IP,001,5,10371,10612,5773,241,PERF
42283326070000,PI,IP,001,6,10688,10929,5773,241,PERF
42283326070000,PI,IP,001,7,11003,11247,5773,244,PERF
42283326070000,PI,IP,001,8,11323,11564,5773,241,PERF
42283326070000,PI,IP,001,9,11640,11881,5773,241,PERF
42283326070000,PI,IP,001,10,11957,12199,5773,242,PERF
42283326070000,PI,IP,001,11,12275,12516,5773,241,PERF
42283326070000,PI,IP,001,12,12592,12834,5773,242,PERF
42283326070000,PI,IP,001,13,12910,13151,5773,241,PERF
42283326070000,PI,IP,001,14,13227,13468,5773,241,PERF
42283326070000,PI,IP,001,15,13544,13786,5773,242,PERF
42283326070000,PI,IP,001,16,13862,14103,5773,241,PERF
42283326080000,PI,IP,001,1,11372,15531,6166,4159,PERF
42283326090000,PI,IP,001,1,8918,9119,6232,201,PERF
42283326090000,PI,IP,001,2,9188,9389,6232,201,PERF
42283326090000,PI,IP,001,3,9458,9659,6232,201,PERF
42283326090000,PI,IP,001,4,9728,9929,6232,201,PERF
42283326090000,PI,IP,001,5,9998,10199,6232,201,PERF
42283326090000,PI,IP,001,6,10268,10469,6232,201,PERF
42283326090000,PI,IP,001,7,10538,10739,6232,201,PERF
42283326090000,PI,IP,001,8,10808,11009,6232,201,PERF
42283326090000,PI,IP,001,9,11078,11279,6232,201,PERF
42283326090000,PI,IP,001,10,11348,11549,6232,201,PERF
42283326090000,PI,IP,001,11,11618,11819,6232,201,PERF
42283326090000,PI,IP,001,12,11888,12089,6232,201,PERF
42283326090000,PI,IP,001,13,12158,12359,6232,201,PERF
42283326090000,PI,IP,001,14,12428,12629,6232,201,PERF
42283326090000,PI,IP,001,15,12698,12899,6232,201,PERF
42283326090000,PI,IP,001,16,12968,13169,6232,201,PERF
42283326090000,PI,IP,001,17,13238,13439,6232,201,PERF
42283326090000,PI,IP,001,18,13508,13709,6232,201,PERF
42283326090000,PI,IP,001,19,13778,13979,6232,201,PERF
42283326100000,PI,IP,001,1,9557,14306,4978,4749,PERF
42283326120000,PI,IP,001,1,9271,13540,4978,4269,PERF
42283326130000,PI,IP,001,1,9231,9427,7566,196,PERF
42283326130000,PI,IP,001,2,9503,9696,7566,193,PERF
42283326130000,PI,IP,001,3,9772,9988,7566,216,PERF
42283326130000,PI,IP,001,4,10042,10237,7566,195,PERF
42283326130000,PI,IP,001,5,10313,10507,7566,194,PERF
42283326130000,PI,IP,001,6,10583,10778,7566,195,PERF
42283326130000,PI,IP,001,7,10854,11048,7566,194,PERF
42283326130000,PI,IP,001,8,11124,11319,7566,195,PERF
42283326130000,PI,IP,001,9,11395,11589,7566,194,PERF
42283326130000,PI,IP,001,10,11662,11860,7566,198,PERF
42283326130000,PI,IP,001,11,11936,12130,7566,194,PERF
42283326130000,PI,IP,001,12,12206,12401,7566,195,PERF
42283326130000,PI,IP,001,13,12477,12671,7566,194,PERF
42283326130000,PI,IP,001,14,12747,12942,7566,195,PERF
42283326130000,PI,IP,001,15,13018,13212,7566,194,PERF
42283326130000,PI,IP,001,16,13288,13543,7566,255,PERF
42283326130000,PI,IP,001,17,13559,13752,7566,193,PERF
42283326130000,PI,IP,001,18,13829,14020,7566,191,PERF
42283326130000,PI,IP,001,19,14100,14294,7566,194,PERF
42283326130000,PI,IP,001,20,14370,14585,7566,215,PERF
42283326130000,PI,IP,001,21,14646,14835,7566,189,PERF
42283326130000,PI,IP,001,22,14911,15108,7566,197,PERF
42283326130000,PI,IP,001,23,15182,15376,7566,194,PERF
42283326130000,PI,IP,001,24,15452,15847,7566,395,PERF
42283326130000,PI,IP,001,25,15723,15917,7566,194,PERF
42283326140000,PI,IP,001,1,7808,12341,5098,4533,PERF
42283326150000,PI,IP,001,1,9644,14475,5211,4831,PERF
42283326170000,PI,IP,001,1,9430,15260,6598,5830,PERF
42283326180000,PI,IP,001,1,8786,8987,8692,201,PERF
42283326180000,PI,IP,001,2,9076,9277,8692,201,PERF
42283326180000,PI,IP,001,3,9366,9567,8692,201,PERF
42283326180000,PI,IP,001,4,9656,9857,8692,201,PERF
42283326180000,PI,IP,001,5,9946,10147,8692,201,PERF
42283326180000,PI,IP,001,6,10236,10437,8692,201,PERF
42283326180000,PI,IP,001,7,10526,10727,8692,201,PERF
42283326180000,PI,IP,001,8,10816,11017,8692,201,PERF
42283326180000,PI,IP,001,9,11106,11307,8692,201,PERF
42283326180000,PI,IP,001,10,11396,11597,8692,201,PERF
42283326180000,PI,IP,001,11,11686,11887,8692,201,PERF
42283326180000,PI,IP,001,12,11976,12177,8692,201,PERF
42283326180000,PI,IP,001,13,12266,12467,8692,201,PERF
42283326180000,PI,IP,001,14,12556,12757,8692,201,PERF
42283326180000,PI,IP,001,15,12846,13047,8692,201,PERF
42283326180000,PI,IP,001,16,13136,13337,8692,201,PERF
42283326180000,PI,IP,001,17,13426,13627,8692,201,PERF
42283326180000,PI,IP,001,18,13716,13917,8692,201,PERF
42283326180000,PI,IP,001,19,14006,14207,8692,201,PERF
42283326180000,PI,IP,001,20,14296,14497,8692,201,PERF
42283326180000,PI,IP,001,21,14586,14787,8692,201,PERF
42283326180000,PI,IP,001,22,14876,15077,8692,201,PERF
42283326180000,PI,IP,001,23,15166,15367,8692,201,PERF
42283326180000,PI,IP,001,24,15456,15657,8692,201,PERF
42283326180000,PI,IP,001,25,15746,15947,8692,201,PERF
42283326180000,PI,IP,001,26,16036,16237,8692,201,PERF
42283326180000,PI,IP,001,27,16326,16527,8692,201,PERF
42283326180000,PI,IP,001,28,16616,16817,8692,201,PERF
42283326180000,PI,IP,001,29,16906,17107,8692,201,PERF
42283326190000,PI,IP,001,1,8883,9084,9231,201,PERF
42283326190000,PI,IP,001,2,9153,9354,9231,201,PERF
42283326190000,PI,IP,001,3,9423,9624,9231,201,PERF
42283326190000,PI,IP,001,4,9693,9894,9231,201,PERF
42283326190000,PI,IP,001,5,9963,10164,9231,201,PERF
42283326190000,PI,IP,001,6,10233,10434,9231,201,PERF
42283326190000,PI,IP,001,7,10503,10704,9231,201,PERF
42283326190000,PI,IP,001,8,10773,10974,9231,201,PERF
42283326190000,PI,IP,001,9,11043,11244,9231,201,PERF
42283326190000,PI,IP,001,10,11323,11524,9231,201,PERF
42283326190000,PI,IP,001,11,11603,11804,9231,201,PERF
42283326190000,PI,IP,001,12,11883,12084,9231,201,PERF
42283326190000,PI,IP,001,13,12163,12364,9231,201,PERF
42283326190000,PI,IP,001,14,12443,12644,9231,201,PERF
42283326190000,PI,IP,001,15,12723,12924,9231,201,PERF
42283326190000,PI,IP,001,16,13003,13204,9231,201,PERF
42283326190000,PI,IP,001,17,13283,13484,9231,201,PERF
42283326190000,PI,IP,001,18,13563,13764,9231,201,PERF
42283326190000,PI,IP,001,19,13843,14044,9231,201,PERF
42283326190000,PI,IP,001,20,14123,14324,9231,201,PERF
42283326190000,PI,IP,001,21,14403,14604,9231,201,PERF
42283326190000,PI,IP,001,22,14683,14884,9231,201,PERF
42283326190000,PI,IP,001,23,14963,15164,9231,201,PERF
42283326190000,PI,IP,001,24,15243,15444,9231,201,PERF
42283326190000,PI,IP,001,25,15523,15724,9231,201,PERF
42283326190000,PI,IP,001,26,15803,16004,9231,201,PERF
42283326190000,PI,IP,001,27,16083,16284,9231,201,PERF
42283326190000,PI,IP,001,28,16363,16564,9231,201,PERF
42283326190000,PI,IP,001,29,16643,16844,9231,201,PERF
42283326190000,PI,IP,001,30,16923,17124,9231,201,PERF
42283326190000,PI,IP,001,31,17203,17404,9231,201,PERF
42283326190000,PI,IP,001,32,17483,17684,9231,201,PERF
42283326190000,PI,IP,001,33,17763,17964,9231,201,PERF
42283326200000,PI,IP,001,1,8923,9124,8953,201,PERF
42283326200000,PI,IP,001,2,9203,9404,8953,201,PERF
42283326200000,PI,IP,001,3,9483,9684,8953,201,PERF
42283326200000,PI,IP,001,4,9763,9964,8953,201,PERF
42283326200000,PI,IP,001,5,10043,10244,8953,201,PERF
42283326200000,PI,IP,001,6,10323,10524,8953,201,PERF
42283326200000,PI,IP,001,7,10603,10804,8953,201,PERF
42283326200000,PI,IP,001,8,10883,11084,8953,201,PERF
42283326200000,PI,IP,001,9,11163,11364,8953,201,PERF
42283326200000,PI,IP,001,10,11443,11644,8953,201,PERF
42283326200000,PI,IP,001,11,11723,11924,8953,201,PERF
42283326200000,PI,IP,001,12,12003,12204,8953,201,PERF
42283326200000,PI,IP,001,13,12283,12484,8953,201,PERF
42283326200000,PI,IP,001,14,12563,12764,8953,201,PERF
42283326200000,PI,IP,001,15,12843,13044,8953,201,PERF
42283326200000,PI,IP,001,16,13123,13324,8953,201,PERF
42283326200000,PI,IP,001,17,13403,13604,8953,201,PERF
42283326200000,PI,IP,001,18,13683,13884,8953,201,PERF
42283326200000,PI,IP,001,19,13963,14164,8953,201,PERF
42283326200000,PI,IP,001,20,14243,14444,8953,201,PERF
42283326200000,PI,IP,001,21,14523,14724,8953,201,PERF
42283326200000,PI,IP,001,22,14803,15004,8953,201,PERF
42283326200000,PI,IP,001,23,15083,15284,8953,201,PERF
42283326200000,PI,IP,001,24,15363,15564,8953,201,PERF
42283326200000,PI,IP,001,25,15643,15844,8953,201,PERF
42283326200000,PI,IP,001,26,15923,16124,8953,201,PERF
42283326200000,PI,IP,001,27,16203,16404,8953,201,PERF
42283326200000,PI,IP,001,28,16483,16684,8953,201,PERF
42283326200000,PI,IP,001,29,16763,16964,8953,201,PERF
42283326200000,PI,IP,001,30,17043,17244,8953,201,PERF
42283326200000,PI,IP,001,31,17323,17524,8953,201,PERF
42283326210000,PI,IP,001,1,11279,16330,,5051,PERF
42283326240000,PI,IP,001,1,10185,14544,5059,4359,PERF
42283326280000,PI,IP,001,1,10266,10464,4663,198,PERF
42283326280000,PI,IP,001,2,10540,10739,4663,199,PERF
42283326280000,PI,IP,001,3,10815,11013,4663,198,PERF
42283326280000,PI,IP,001,4,11089,11288,4663,199,PERF
42283326280000,PI,IP,001,5,11364,11562,4663,198,PERF
42283326280000,PI,IP,001,6,11638,11836,4663,198,PERF
42283326280000,PI,IP,001,7,11912,12111,4663,199,PERF
42283326280000,PI,IP,001,8,12187,12385,4663,198,PERF
42283326280000,PI,IP,001,9,12461,12659,4663,198,PERF
42283326280000,PI,IP,001,10,12735,12934,4663,199,PERF
42283326280000,PI,IP,001,11,13010,13208,4663,198,PERF
42283326280000,PI,IP,001,12,13284,13483,4663,199,PERF
42283326280000,PI,IP,001,13,13559,13757,4663,198,PERF
42283326280000,PI,IP,001,14,13833,14031,4663,198,PERF
42283326280000,PI,IP,001,15,14107,14306,4663,199,PERF
42283326290000,PI,IP,001,1,7703,12280,4973,4577,PERF
42283326300000,PI,IP,001,1,9477,15595,7257,6118,PERF
42283326320000,PI,IP,001,1,8375,13502,6243,5127,PERF
42283326330000,PI,IP,001,1,10150,17081,6922,6931,PERF
42283326340000,PI,IP,001,1,9506,9709,9703,203,PERF
42283326340000,PI,IP,001,2,9788,9989,9703,201,PERF
42283326340000,PI,IP,001,3,10068,10269,9703,201,PERF
42283326340000,PI,IP,001,4,10348,10549,9703,201,PERF
42283326340000,PI,IP,001,5,10625,10829,9703,204,PERF
42283326340000,PI,IP,001,6,10908,11109,9703,201,PERF
42283326340000,PI,IP,001,7,11188,11389,9703,201,PERF
42283326340000,PI,IP,001,8,11468,11669,9703,201,PERF
42283326340000,PI,IP,001,9,11748,11949,9703,201,PERF
42283326340000,PI,IP,001,10,12028,12229,9703,201,PERF
42283326340000,PI,IP,001,11,12309,12509,9703,200,PERF
42283326340000,PI,IP,001,12,12588,12789,9703,201,PERF
42283326340000,PI,IP,001,13,12868,13069,9703,201,PERF
42283326340000,PI,IP,001,14,13148,13349,9703,201,PERF
42283326340000,PI,IP,001,15,13428,13629,9703,201,PERF
42283326340000,PI,IP,001,16,13708,13909,9703,201,PERF
42283326340000,PI,IP,001,17,13988,14189,9703,201,PERF
42283326340000,PI,IP,001,18,14268,14469,9703,201,PERF
42283326340000,PI,IP,001,19,14548,14749,9703,201,PERF
42283326340000,PI,IP,001,20,14828,15029,9703,201,PERF
42283326340000,PI,IP,001,21,15108,15309,9703,201,PERF
42283326340000,PI,IP,001,22,15388,15589,9703,201,PERF
42283326340000,PI,IP,001,23,15668,15869,9703,201,PERF
42283326340000,PI,IP,001,24,15948,16149,9703,201,PERF
42283326340000,PI,IP,001,25,16228,16429,9703,201,PERF
42283326340000,PI,IP,001,26,16508,16709,9703,201,PERF
42283326340000,PI,IP,001,27,16788,16989,9703,201,PERF
42283326340000,PI,IP,001,28,17068,17269,9703,201,PERF
42283326340000,PI,IP,001,29,17348,17549,9703,201,PERF
42283326340000,PI,IP,001,30,17628,17829,9703,201,PERF
42283326340000,PI,IP,001,31,17908,18109,9703,201,PERF
42283326340000,PI,IP,001,32,18188,18389,9703,201,PERF
42283326350000,PI,IP,001,1,9974,15631,6363,5657,PERF
42283326370000,PI,IP,001,1,9632,15165,,5533,PERF
42283326380000,PI,IP,001,1,9270,13826,,4556,PERF
42283326390000,PI,IP,001,1,11199,15095,4935,3896,PERF
42283326400000,PI,IP,001,1,11344,15246,5018,3902,PERF
42283326410000,PI,IP,001,1,9150,15786,7200,6636,PERF
42283326420000,PI,IP,001,1,8996,9006,5721,10,PERF
42283326420000,PI,IP,001,2,9309,9319,5721,10,PERF
42283326420000,PI,IP,001,3,9622,9632,5721,10,PERF
42283326420000,PI,IP,001,4,9935,9945,5721,10,PERF
42283326420000,PI,IP,001,5,10248,10258,5721,10,PERF
42283326420000,PI,IP,001,6,10561,10571,5721,10,PERF
42283326420000,PI,IP,001,7,10874,10884,5721,10,PERF
42283326420000,PI,IP,001,8,11187,11197,5721,10,PERF
42283326420000,PI,IP,001,9,11500,11510,5721,10,PERF
42283326420000,PI,IP,001,10,12000,12010,5721,10,PERF
42283326420000,PI,IP,001,11,12335,12345,5721,10,PERF
42283326420000,PI,IP,001,12,12670,12680,5721,10,PERF
42283326420000,PI,IP,001,13,13005,13007,5721,2,PERF
42283326420000,PI,IP,001,14,13270,13272,5721,2,PERF
42283326420000,PI,IP,001,15,13530,13532,5721,2,PERF
42283326420000,PI,IP,001,16,13797,13799,5721,2,PERF
42283326430000,PI,IP,001,1,10947,17050,6967,6103,PERF
42283326450000,PI,IP,001,1,7836,15300,7853,7464,PERF
42283326460000,PI,IP,001,1,8336,8533,,197,PERF
42283326460000,PI,IP,001,2,8609,8806,,197,PERF
42283326460000,PI,IP,001,3,8882,9079,,197,PERF
42283326460000,PI,IP,001,4,9155,9352,,197,PERF
42283326460000,PI,IP,001,5,9428,9626,,198,PERF
42283326460000,PI,IP,001,6,9702,9899,,197,PERF
42283326460000,PI,IP,001,7,9975,10172,,197,PERF
42283326460000,PI,IP,001,8,10248,10445,,197,PERF
42283326460000,PI,IP,001,9,10521,10718,,197,PERF
42283326460000,PI,IP,001,10,10794,10991,,197,PERF
42283326460000,PI,IP,001,11,11067,11264,,197,PERF
42283326460000,PI,IP,001,12,11340,11538,,198,PERF
42283326460000,PI,IP,001,13,11614,11811,,197,PERF
42283326460000,PI,IP,001,14,11887,12084,,197,PERF
42283326460000,PI,IP,001,15,12160,12357,,197,PERF
42283326460000,PI,IP,001,16,12433,12630,,197,PERF
42283326470000,PI,IP,001,1,9503,12752,3515,3249,PERF
42283326480000,PI,IP,001,1,10646,10958,6135,312,PERF
42283326480000,PI,IP,001,2,11210,11482,6135,272,PERF
42283326480000,PI,IP,001,3,11570,11810,6135,240,PERF
42283326480000,PI,IP,001,4,11880,12104,6135,224,PERF
42283326480000,PI,IP,001,5,12204,12410,6135,206,PERF
42283326480000,PI,IP,001,6,12538,12700,6135,162,PERF
42283326480000,PI,IP,001,7,12772,12972,6135,200,PERF
42283326480000,PI,IP,001,8,13032,13262,6135,230,PERF
42283326480000,PI,IP,001,9,13348,13562,6135,214,PERF
42283326480000,PI,IP,001,10,13646,13870,6135,224,PERF
42283326480000,PI,IP,001,11,13950,14190,6135,240,PERF
42283326480000,PI,IP,001,12,14266,14482,6135,216,PERF
42283326480000,PI,IP,001,13,14538,14738,6135,200,PERF
42283326480000,PI,IP,001,14,14812,15036,6135,224,PERF
42283326480000,PI,IP,001,15,15110,15344,6135,234,PERF
42283326480000,PI,IP,001,16,15426,15636,6135,210,PERF
42283326490000,PI,IP,001,1,8013,15220,7636,7207,PERF
42283326500000,PI,IP,001,1,7954,15185,7612,7231,PERF
42283326510000,PI,IP,001,1,9342,14171,5370,4829,PERF
42283326520000,PI,IP,001,1,11075,15229,4690,4154,PERF
42283326540000,PI,IP,002,1,8884,14314,5936,5430,PERF
42283326540000,PI,PT,001,1,8884,8914,5936,30,PERF
42283326540000,PI,PT,001,2,9184,9214,5936,30,PERF
42283326540000,PI,PT,001,3,9484,9514,5936,30,PERF
42283326540000,PI,PT,001,4,9784,9814,5936,30,PERF
42283326540000,PI,PT,001,5,10084,10114,5936,30,PERF
42283326540000,PI,PT,001,6,10384,10414,5936,30,PERF
42283326540000,PI,PT,001,7,10684,10714,5936,30,PERF
42283326540000,PI,PT,001,8,10984,11014,5936,30,PERF
42283326540000,PI,PT,001,9,11284,11314,5936,30,PERF
42283326540000,PI,PT,001,10,11584,11614,5936,30,PERF
42283326540000,PI,PT,001,11,11884,11914,5936,30,PERF
42283326540000,PI,PT,001,12,12184,12214,5936,30,PERF
42283326540000,PI,PT,001,13,12484,12514,5936,30,PERF
42283326540000,PI,PT,001,14,12784,12814,5936,30,PERF
42283326540000,PI,PT,001,15,13084,13114,5936,30,PERF
42283326540000,PI,PT,001,16,13384,13414,5936,30,PERF
42283326540000,PI,PT,001,17,13684,13714,5936,30,PERF
42283326540000,PI,PT,001,18,13984,14014,5936,30,PERF
42283326540000,PI,PT,001,19,14284,14314,5936,30,PERF
42283326550000,PI,IP,001,1,8197,8408,4989,211,PERF
42283326550000,PI,IP,001,2,8484,8695,4989,211,PERF
42283326550000,PI,IP,001,3,8771,8982,4989,211,PERF
42283326550000,PI,IP,001,4,9058,9269,4989,211,PERF
42283326550000,PI,IP,001,5,9245,9556,4989,311,PERF
42283326550000,PI,IP,001,6,9632,9842,4989,210,PERF
42283326550000,PI,IP,001,7,9918,10129,4989,211,PERF
42283326550000,PI,IP,001,8,10205,10416,4989,211,PERF
42283326550000,PI,IP,001,9,10487,10703,4989,216,PERF
42283326550000,PI,IP,001,10,10779,10990,4989,211,PERF
42283326550000,PI,IP,001,11,11066,11277,4989,211,PERF
42283326550000,PI,IP,001,12,11353,11584,4989,231,PERF
42283326550000,PI,IP,001,13,11682,11851,4989,169,PERF
42283326550000,PI,IP,001,14,11927,12138,4989,211,PERF
42283326550000,PI,IP,001,15,12214,12425,4989,211,PERF
42283326560000,PI,IP,001,1,9865,14248,5165,4383,PERF
42283326570000,PI,IP,001,1,11041,15441,4822,4400,PERF
42283326580000,PI,IP,001,1,10685,14165,4688,3480,PERF
42283326590000,PI,IP,001,1,9248,13032,4510,3784,PERF
42283326600000,PI,IP,001,1,10270,15230,5216,4960,PERF
42283326610000,PI,IP,001,1,10170,15024,5536,4854,PERF
42283326620000,PI,IP,001,1,10340,16339,,5999,PERF
42283326630000,PI,IP,001,1,10130,14857,5295,4727,PERF
42283326640000,PI,IP,001,1,9885,14201,5171,4316,PERF
42283326680000,PI,IP,001,1,8988,8998,5301,10,PERF
42283326680000,PI,IP,001,2,9238,9248,5301,10,PERF
42283326680000,PI,IP,001,3,9538,9548,5301,10,PERF
42283326680000,PI,IP,001,4,9838,9848,5301,10,PERF
42283326680000,PI,IP,001,5,10138,10148,5301,10,PERF
42283326680000,PI,IP,001,6,10438,10448,5301,10,PERF
42283326680000,PI,IP,001,7,10738,10748,5301,10,PERF
42283326680000,PI,IP,001,8,11038,11048,5301,10,PERF
42283326680000,PI,IP,001,9,11338,11348,5301,10,PERF
42283326680000,PI,IP,001,10,11638,11648,5301,10,PERF
42283326680000,PI,IP,001,11,11938,11948,5301,10,PERF
42283326680000,PI,IP,001,12,12238,12248,5301,10,PERF
42283326680000,PI,IP,001,13,12710,12720,5301,10,PERF
42283326680000,PI,IP,001,14,13006,13016,5301,10,PERF
42283326680000,PI,IP,001,15,13252,13262,5301,10,PERF
42283326680000,PI,IP,001,16,13513,13523,5301,10,PERF
42283326690000,PI,IP,001,1,9600,14430,5351,4830,PERF
42283326700000,PI,IP,001,1,9660,14183,5009,4523,PERF
42283326730000,PI,IP,001,1,8430,13551,5358,5121,PERF
42283326740000,PI,IP,001,1,8430,13552,5721,5122,PERF
42283326820000,PI,IP,001,1,9655,9861,5426,206,PERF
42283326820000,PI,IP,001,2,9937,10142,5426,205,PERF
42283326820000,PI,IP,001,3,10218,10424,5426,206,PERF
42283326820000,PI,IP,001,4,10500,10705,5426,205,PERF
42283326820000,PI,IP,001,5,10781,10987,5426,206,PERF
42283326820000,PI,IP,001,6,11063,11269,5426,206,PERF
42283326820000,PI,IP,001,7,11345,11550,5426,205,PERF
42283326820000,PI,IP,001,8,11626,11832,5426,206,PERF
42283326820000,PI,IP,001,9,11904,12113,5426,209,PERF
42283326820000,PI,IP,001,10,12187,12395,5426,208,PERF
42283326820000,PI,IP,001,11,12471,12677,5426,206,PERF
42283326820000,PI,IP,001,12,12753,12985,5426,232,PERF
42283326820000,PI,IP,001,13,13034,13240,5426,206,PERF
42283326820000,PI,IP,001,14,13316,13521,5426,205,PERF
42283326820000,PI,IP,001,15,13597,13803,5426,206,PERF
42283326820000,PI,IP,001,16,13879,14084,5426,205,PERF
42283326820000,PI,IP,001,17,14160,14366,5426,206,PERF
42283326830000,PI,IP,001,1,8847,9048,6204,201,PERF
42283326830000,PI,IP,001,2,9117,9318,6204,201,PERF
42283326830000,PI,IP,001,3,9387,9588,6204,201,PERF
42283326830000,PI,IP,001,4,9657,9858,6204,201,PERF
42283326830000,PI,IP,001,5,9927,10128,6204,201,PERF
42283326830000,PI,IP,001,6,10197,10398,6204,201,PERF
42283326830000,PI,IP,001,7,10467,10668,6204,201,PERF
42283326830000,PI,IP,001,8,10737,10938,6204,201,PERF
42283326830000,PI,IP,001,9,11007,11208,6204,201,PERF
42283326830000,PI,IP,001,10,11277,11478,6204,201,PERF
42283326830000,PI,IP,001,11,11547,11748,6204,201,PERF
42283326830000,PI,IP,001,12,11817,12018,6204,201,PERF
42283326830000,PI,IP,001,13,12087,12288,6204,201,PERF
42283326830000,PI,IP,001,14,12357,12558,6204,201,PERF
42283326830000,PI,IP,001,15,12627,12828,6204,201,PERF
42283326830000,PI,IP,001,16,12897,13098,6204,201,PERF
42283326830000,PI,IP,001,17,13167,13368,6204,201,PERF
42283326830000,PI,IP,001,18,13437,13638,6204,201,PERF
42283326830000,PI,IP,001,19,13704,13905,6204,201,PERF
42283326840000,PI,IP,001,1,12642,17449,5435,4807,PERF
42283326850000,PI,IP,001,1,10035,10235,5255,200,PERF
42283326850000,PI,IP,001,2,10312,10511,5255,199,PERF
42283326850000,PI,IP,001,3,10588,10789,5255,201,PERF
42283326850000,PI,IP,001,4,10865,11066,5255,201,PERF
42283326850000,PI,IP,001,5,11142,11342,5255,200,PERF
42283326850000,PI,IP,001,6,11418,11619,5255,201,PERF
42283326850000,PI,IP,001,7,11695,11895,5255,200,PERF
42283326850000,PI,IP,001,8,11972,12171,5255,199,PERF
42283326850000,PI,IP,001,9,12248,12449,5255,201,PERF
42283326850000,PI,IP,001,10,12525,12726,5255,201,PERF
42283326850000,PI,IP,001,11,12802,13002,5255,200,PERF
42283326850000,PI,IP,001,12,13078,13279,5255,201,PERF
42283326850000,PI,IP,001,13,13355,13455,5255,100,PERF
42283326850000,PI,IP,001,14,13631,13832,5255,201,PERF
42283326850000,PI,IP,001,15,13908,14109,5255,201,PERF
42283326850000,PI,IP,001,16,14185,14385,5255,200,PERF
42283326860000,PI,IP,001,1,10381,14889,4924,4508,PERF
42283326870000,PI,IP,001,1,14314,17866,5323,3552,PERF
42283326880000,PI,IP,001,1,10863,14665,4406,3802,PERF
42283326890000,PI,IP,001,1,8699,14530,,5831,PERF
42283326910000,PI,IP,001,1,8824,9025,6854,201,PERF
42283326910000,PI,IP,001,2,9094,9295,6854,201,PERF
42283326910000,PI,IP,001,3,9364,9565,6854,201,PERF
42283326910000,PI,IP,001,4,9634,9835,6854,201,PERF
42283326910000,PI,IP,001,5,9904,10105,6854,201,PERF
42283326910000,PI,IP,001,6,10174,10375,6854,201,PERF
42283326910000,PI,IP,001,7,10444,10645,6854,201,PERF
42283326910000,PI,IP,001,8,10714,10915,6854,201,PERF
42283326910000,PI,IP,001,9,10984,11185,6854,201,PERF
42283326910000,PI,IP,001,10,11254,11455,6854,201,PERF
42283326910000,PI,IP,001,11,11524,11725,6854,201,PERF
42283326910000,PI,IP,001,12,11794,11995,6854,201,PERF
42283326910000,PI,IP,001,13,12064,12265,6854,201,PERF
42283326910000,PI,IP,001,14,12334,12535,6854,201,PERF
42283326910000,PI,IP,001,15,12604,12805,6854,201,PERF
42283326910000,PI,IP,001,16,12874,13075,6854,201,PERF
42283326910000,PI,IP,001,17,13144,13345,6854,201,PERF
42283326910000,PI,IP,001,18,13414,13615,6854,201,PERF
42283326910000,PI,IP,001,19,13684,13885,6854,201,PERF
42283326910000,PI,IP,001,20,13954,14155,6854,201,PERF
42283326910000,PI,IP,001,21,14224,14425,6854,201,PERF
42283326910000,PI,IP,001,22,14494,14695,6854,201,PERF
42283326910000,PI,IP,001,23,14764,14965,6854,201,PERF
42283326910000,PI,IP,001,24,15034,15235,6854,201,PERF
42283326920000,PI,IP,001,1,9106,9313,7710,207,PERF
42283326920000,PI,IP,001,2,9389,9597,7710,208,PERF
42283326920000,PI,IP,001,3,9673,9880,7710,207,PERF
42283326920000,PI,IP,001,4,9956,10163,7710,207,PERF
42283326920000,PI,IP,001,5,10239,10447,7710,208,PERF
42283326920000,PI,IP,001,6,10523,10730,7710,207,PERF
42283326920000,PI,IP,001,7,10803,11014,7710,211,PERF
42283326920000,PI,IP,001,8,11090,11297,7710,207,PERF
42283326920000,PI,IP,001,9,11373,11580,7710,207,PERF
42283326920000,PI,IP,001,10,11656,11864,7710,208,PERF
42283326920000,PI,IP,001,11,11940,12147,7710,207,PERF
42283326920000,PI,IP,001,12,12223,12430,7710,207,PERF
42283326920000,PI,IP,001,13,12506,12714,7710,208,PERF
42283326920000,PI,IP,001,14,12790,12997,7710,207,PERF
42283326920000,PI,IP,001,15,13073,13281,7710,208,PERF
42283326920000,PI,IP,001,16,13357,13564,7710,207,PERF
42283326920000,PI,IP,001,17,13640,13847,7710,207,PERF
42283326920000,PI,IP,001,18,13923,14131,7710,208,PERF
42283326920000,PI,IP,001,19,14207,14414,7710,207,PERF
42283326920000,PI,IP,001,20,14490,14697,7710,207,PERF
42283326920000,PI,IP,001,21,14773,14981,7710,208,PERF
42283326920000,PI,IP,001,22,15057,15264,7710,207,PERF
42283326920000,PI,IP,001,23,15340,15548,7710,208,PERF
42283326920000,PI,IP,001,24,15624,15831,7710,207,PERF
42283326930000,PI,IP,001,1,7909,15313,7748,7404,PERF
42283326940000,PI,IP,001,1,7800,12433,4907,4633,PERF
42283326950000,PI,IP,001,1,10207,16194,6589,5987,PERF
42283326980000,PI,IP,001,1,8983,8993,6260,10,PERF
42283326980000,PI,IP,001,2,9241,9251,6260,10,PERF
42283326980000,PI,IP,001,3,9499,9509,6260,10,PERF
42283326980000,PI,IP,001,4,9735,9745,6260,10,PERF
42283326980000,PI,IP,001,5,9989,9999,6260,10,PERF
42283326980000,PI,IP,001,6,10240,10250,6260,10,PERF
42283326980000,PI,IP,001,7,10471,10481,6260,10,PERF
42283326980000,PI,IP,001,8,10732,10742,6260,10,PERF
42283326980000,PI,IP,001,9,10997,11007,6260,10,PERF
42283326980000,PI,IP,001,10,11237,11247,6260,10,PERF
42283326980000,PI,IP,001,11,11495,11505,6260,10,PERF
42283326980000,PI,IP,001,12,11755,11765,6260,10,PERF
42283326980000,PI,IP,001,13,12002,12012,6260,10,PERF
42283326980000,PI,IP,001,14,12250,12260,6260,10,PERF
42283326980000,PI,IP,001,15,12501,12511,6260,10,PERF
42283326980000,PI,IP,001,16,13367,13377,6260,10,PERF
42283326980000,PI,IP,001,17,13647,13649,6260,2,PERF
42283326980000,PI,IP,001,18,13910,13912,6260,2,PERF
42283326980000,PI,IP,001,19,14185,14187,6260,2,PERF
42283326980000,PI,IP,001,20,14488,14490,6260,2,PERF
42283326990000,PI,IP,001,1,11062,17744,6836,6682,PERF
42283327010000,PI,IP,001,1,8215,12628,,4413,PERF
42283327050000,PI,IP,001,1,8236,14114,6756,5878,PERF
42283327060000,PI,IP,001,1,8245,14114,6365,5869,PERF
42283327070000,PI,IP,001,1,11097,16249,5814,5152,PERF
42283327080000,PI,IP,001,1,10566,14511,4893,3945,PERF
42283327090000,PI,IP,001,1,8261,13508,6000,5247,PERF
42283327100000,PI,IP,001,1,8202,12578,5111,4376,PERF
42283327110000,PI,IP,001,1,8737,15928,8563,7191,PERF
42283327120000,PI,IP,001,1,11391,17384,6622,5993,PERF
42283327130000,PI,IP,001,1,11167,15974,5640,4807,PERF
42283327140000,PI,IP,001,1,7577,12377,5016,4800,PERF
42283327150000,PI,IP,001,1,7675,12357,4983,4682,PERF
42283327160000,PI,IP,001,1,8719,12534,4769,3815,PERF
42283327170000,PI,IP,001,1,7835,12390,5050,4555,PERF
42283327180000,PI,IP,001,1,7692,12215,5039,4523,PERF
42283327200000,PI,IP,001,1,8950,14940,6184,5990,PERF
42283327210000,PI,IP,001,1,8700,8853,5928,153,PERF
42283327210000,PI,IP,001,2,8978,9181,5928,203,PERF
42283327210000,PI,IP,001,3,9257,9460,5928,203,PERF
42283327210000,PI,IP,001,4,9538,9738,5928,200,PERF
42283327210000,PI,IP,001,5,9814,10017,5928,203,PERF
42283327210000,PI,IP,001,6,10093,10296,5928,203,PERF
42283327210000,PI,IP,001,7,10372,10574,5928,202,PERF
42283327210000,PI,IP,001,8,10650,10853,5928,203,PERF
42283327210000,PI,IP,001,9,10929,11131,5928,202,PERF
42283327210000,PI,IP,001,10,11207,11410,5928,203,PERF
42283327210000,PI,IP,001,11,11486,11689,5928,203,PERF
42283327210000,PI,IP,001,12,11765,11967,5928,202,PERF
42283327210000,PI,IP,001,13,12043,12246,5928,203,PERF
42283327210000,PI,IP,001,14,12322,12525,5928,203,PERF
42283327210000,PI,IP,001,15,12601,12803,5928,202,PERF
42283327210000,PI,IP,001,16,12879,13082,5928,203,PERF
42283327210000,PI,IP,001,17,13158,13360,5928,202,PERF
42283327210000,PI,IP,001,18,13436,13639,5928,203,PERF
42283327250000,PI,IP,001,1,8078,15160,7659,7082,PERF
42283327260000,PI,IP,001,1,11216,16544,5840,5328,PERF
42283327270000,PI,IP,001,1,11400,16697,6314,5297,PERF
42283327320000,PI,IP,001,1,8233,12591,4780,4358,PERF
42283327340100,PI,IP,001,1,7806,12470,4828,4664,PERF
42283327350000,PI,IP,001,1,11538,16288,5213,4750,PERF
42283327360000,PI,IP,001,1,8583,14316,6349,5733,PERF
42283327370000,PI,IP,001,1,8383,14300,6207,5917,PERF
42283327380000,PI,IP,001,1,8230,11946,4794,3716,PERF
42283327390000,PI,IP,001,1,8980,13032,4758,4052,PERF
42283327400000,PI,IP,001,1,9080,13579,4900,4499,PERF
42283327410000,PI,IP,001,1,9005,13607,4836,4602,PERF
42283327440000,PI,PT,001,1,11164,16313,,5149,PERF
42283327470000,PI,PT,001,1,10935,15666,,4731,PERF
42283327510000,PI,IP,001,1,10404,15068,4981,4664,PERF
42283327520000,PI,IP,001,1,7888,15209,7602,7321,PERF
42283327530000,PI,IP,001,1,9243,16401,,7158,PERF
42283327540000,PI,IP,001,1,9218,15305,7027,6087,PERF
42283327550000,PI,IP,001,1,7764,13700,6276,5936,PERF
42283327560000,PI,IP,001,1,7903,15161,7589,7258,PERF
42283327570000,PI,IP,001,1,10169,14753,4765,4584,PERF
42283327580000,PI,IP,001,1,9366,16405,7739,7039,PERF
42283327600000,PI,IP,001,1,7866,11815,,3949,PERF
42283327620000,PI,IP,001,1,9811,14644,5212,4833,PERF
42283327630000,PI,IP,001,1,10790,16025,5722,5235,PERF
42283327690000,PI,IP,001,1,9020,13518,4510,4498,PERF
42283327700000,PI,IP,001,1,8890,12699,4357,3809,PERF
42283327710000,PI,IP,001,1,9010,13242,4425,4232,PERF
42283327730000,PI,IP,001,1,8174,12572,4736,4398,PERF
42283327740000,PI,IP,001,1,9485,14623,5682,5138,PERF
42283327760000,PI,IP,001,1,9918,15505,6282,5587,PERF
42283327770000,PI,IP,001,1,8976,13159,4649,4183,PERF
42283327780000,PI,IP,001,1,11850,14301,3485,2451,PERF
42283327790000,PI,IP,001,1,10970,15195,5020,4225,PERF
42283327800000,PI,IP,001,1,9915,15705,6372,5790,PERF
42283327810000,PI,IP,001,1,9035,13882,5202,4847,PERF
42283327820000,PI,IP,001,1,9108,13876,5217,4768,PERF
42283327830000,PI,IP,001,1,10084,16335,6921,6251,PERF
42283327840000,PI,IP,001,1,10290,16095,6693,5805,PERF
42283327850000,PI,IP,002,1,10112,15360,6110,5248,PERF
42283327850000,PI,PT,001,1,15476,15715,6110,239,PERF
42283327860000,PI,IP,001,1,9522,13998,5229,4476,PERF
42283327870000,PI,IP,001,1,9646,13541,4872,3895,PERF
42283327890000,PI,IP,001,1,10260,14259,5042,3999,PERF
42283327900000,PI,IP,001,1,9296,17278,8943,7982,PERF
42283327910000,PI,IP,002,1,10034,15575,6054,5541,PERF
42283327910000,PI,PT,001,1,15676,15777,6054,101,PERF
42283327920000,PI,IP,001,1,10193,15120,5480,4927,PERF
42283327930000,PI,IP,001,1,10174,15331,5947,5157,PERF
42283327940000,PI,IP,001,1,10078,15572,5993,5494,PERF
42283327950000,PI,IP,001,1,7776,14927,7582,7151,PERF
42283327970000,PI,IP,001,1,8130,12901,5011,4771,PERF
42283327980000,PI,IP,001,1,8558,13145,5121,4587,PERF
42283327990000,PI,IP,001,1,8807,13043,4766,4236,PERF
42283328000000,PI,IP,001,1,10457,16660,7033,6203,PERF
42283328020000,PI,IP,001,1,10789,15583,5612,4794,PERF
42283328030000,PI,IP,001,1,7976,13671,6196,5695,PERF
42283328050000,PI,IP,001,1,7990,14008,6461,6018,PERF
42283328090000,PI,IP,001,1,10243,15292,,5049,PERF
42283328100000,PI,IP,001,1,10189,14875,4908,4686,PERF
42283328110000,PI,IP,001,1,10243,15270,,5027,PERF
42283328140000,PI,IP,001,1,10960,16792,6568,5832,PERF
42283328150000,PI,IP,001,1,8845,9200,6003,355,PERF
42283328150000,PI,IP,001,2,9261,9616,6003,355,PERF
42283328150000,PI,IP,001,3,9677,10032,6003,355,PERF
42283328150000,PI,IP,001,4,10093,10448,6003,355,PERF
42283328150000,PI,IP,001,5,10509,10864,6003,355,PERF
42283328150000,PI,IP,001,6,10925,11280,6003,355,PERF
42283328150000,PI,IP,001,7,11341,11696,6003,355,PERF
42283328150000,PI,IP,001,8,11757,12112,6003,355,PERF
42283328150000,PI,IP,001,9,12173,12528,6003,355,PERF
42283328150000,PI,IP,001,10,12589,12944,6003,355,PERF
42283328150000,PI,IP,001,11,13005,13360,6003,355,PERF
42283328150000,PI,IP,001,12,13421,13776,6003,355,PERF
42283328150000,PI,IP,001,13,13837,14192,6003,355,PERF
42283328150000,PI,IP,001,14,14253,14608,6003,355,PERF
42283328160000,PI,IP,001,1,8925,9280,6002,355,PERF
42283328160000,PI,IP,001,2,9339,9694,6002,355,PERF
42283328160000,PI,IP,001,3,9753,10108,6002,355,PERF
42283328160000,PI,IP,001,4,10167,10522,6002,355,PERF
42283328160000,PI,IP,001,5,10581,10936,6002,355,PERF
42283328160000,PI,IP,001,6,10995,11350,6002,355,PERF
42283328160000,PI,IP,001,7,11409,11764,6002,355,PERF
42283328160000,PI,IP,001,8,11823,12178,6002,355,PERF
42283328160000,PI,IP,001,9,12237,12592,6002,355,PERF
42283328160000,PI,IP,001,10,12710,13006,6002,296,PERF
42283328160000,PI,IP,001,11,13065,13420,6002,355,PERF
42283328160000,PI,IP,001,12,13479,13834,6002,355,PERF
42283328160000,PI,IP,001,13,13893,14248,6002,355,PERF
42283328160000,PI,IP,001,14,14307,14662,6002,355,PERF
42283328170000,PI,IP,001,1,8921,13316,4954,4395,PERF
42283328190000,PI,IP,001,1,10318,16110,6647,5792,PERF
42283328200000,PI,IP,001,1,8126,13113,,4987,PERF
42283328210000,PI,IP,001,1,9657,14175,5575,4518,PERF
42283328220000,PI,IP,001,1,10441,17781,7592,7340,PERF
42283328230000,PI,IP,001,1,8000,15363,7894,7363,PERF
42283328250000,PI,IP,001,1,10419,18060,,7641,PERF
42283328270000,PI,IP,003,1,9149,14532,5820,5383,PERF
42283328270000,PI,PT,001,1,13274,13277,5820,3,PERF
42283328270000,PI,PT,001,2,13549,13551,5820,2,PERF
42283328270000,PI,PT,001,3,13809,13820,5820,11,PERF
42283328270000,PI,PT,001,4,13828,13830,5820,2,PERF
42283328270000,PI,PT,001,5,14101,14103,5820,2,PERF
42283328270000,PI,PT,001,6,14350,14361,5820,11,PERF
42283328270000,PI,PT,001,7,14530,14532,5820,2,PERF
42283328270000,PI,PT,002,8,9149,9159,5820,10,PERF
42283328270000,PI,PT,002,9,9424,9434,5820,10,PERF
42283328270000,PI,PT,002,10,9699,9709,5820,10,PERF
42283328270000,PI,PT,002,11,9974,9984,5820,10,PERF
42283328270000,PI,PT,002,12,10249,10259,5820,10,PERF
42283328270000,PI,PT,002,13,10524,10534,5820,10,PERF
42283328270000,PI,PT,002,14,10799,10809,5820,10,PERF
42283328270000,PI,PT,002,15,11074,11084,5820,10,PERF
42283328270000,PI,PT,002,16,11349,11359,5820,10,PERF
42283328270000,PI,PT,002,17,11624,11634,5820,10,PERF
42283328270000,PI,PT,002,18,11896,11906,5820,10,PERF
42283328270000,PI,PT,002,19,12174,12184,5820,10,PERF
42283328270000,PI,PT,002,20,12449,12459,5820,10,PERF
42283328270000,PI,PT,002,21,12713,12723,5820,10,PERF
42283328270000,PI,PT,002,22,12999,13009,5820,10,PERF
42283328270000,PI,PT,002,23,13210,13220,5820,10,PERF
42283328270000,PI,PT,002,24,13460,13470,5820,10,PERF
42283328270000,PI,PT,002,25,13720,13730,5820,10,PERF
42283328280000,PI,IP,001,1,8620,8805,5743,185,PERF
42283328280000,PI,IP,001,2,8900,9085,5743,185,PERF
42283328280000,PI,IP,001,3,9186,9365,5743,179,PERF
42283328280000,PI,IP,001,4,9478,9645,5743,167,PERF
42283328280000,PI,IP,001,5,9743,9923,5743,180,PERF
42283328280000,PI,IP,001,6,10023,10205,5743,182,PERF
42283328280000,PI,IP,001,7,10303,10482,5743,179,PERF
42283328280000,PI,IP,001,8,10583,10765,5743,182,PERF
42283328280000,PI,IP,001,9,10863,11045,5743,182,PERF
42283328280000,PI,IP,001,10,11140,11325,5743,185,PERF
42283328280000,PI,IP,001,11,11422,11603,5743,181,PERF
42283328280000,PI,IP,001,12,11700,11885,5743,185,PERF
42283328280000,PI,IP,001,13,12080,12165,5743,85,PERF
42283328280000,PI,IP,001,14,12270,12445,5743,175,PERF
42283328280000,PI,IP,001,15,12543,12725,5743,182,PERF
42283328280000,PI,IP,001,16,12823,13003,5743,180,PERF
42283328280000,PI,IP,001,17,13103,13283,5743,180,PERF
42283328280000,PI,IP,001,18,13351,13433,5743,82,PERF
42283328290000,PI,IP,001,1,10320,14621,4762,4301,PERF
42283328300000,PI,IP,001,1,8771,8953,5758,182,PERF
42283328300000,PI,IP,001,2,9054,9233,5758,179,PERF
42283328300000,PI,IP,001,3,9331,9513,5758,182,PERF
42283328300000,PI,IP,001,4,9604,9793,5758,189,PERF
42283328300000,PI,IP,001,5,9891,10073,5758,182,PERF
42283328300000,PI,IP,001,6,10174,10353,5758,179,PERF
42283328300000,PI,IP,001,7,10451,10630,5758,179,PERF
42283328300000,PI,IP,001,8,10731,10913,5758,182,PERF
42283328300000,PI,IP,001,9,11011,11190,5758,179,PERF
42283328300000,PI,IP,001,10,11291,11473,5758,182,PERF
42283328300000,PI,IP,001,11,11571,11752,5758,181,PERF
42283328300000,PI,IP,001,12,11851,12033,5758,182,PERF
42283328300000,PI,IP,001,13,12131,12313,5758,182,PERF
42283328300000,PI,IP,001,14,12408,12590,5758,182,PERF
42283328300000,PI,IP,001,15,12691,12873,5758,182,PERF
42283328300000,PI,IP,001,16,12971,13159,5758,188,PERF
42283328300000,PI,IP,001,17,13251,13433,5758,182,PERF
42283328310000,PI,IP,001,1,10304,14949,4985,4645,PERF
42283328320000,PI,IP,001,1,10772,15310,5197,4538,PERF
42283328330000,PI,IP,001,1,11027,15196,4955,4169,PERF
42283328340000,PI,IP,001,1,10746,16261,6827,5515,PERF
42283328350000,PI,IP,001,1,7806,13097,5837,5291,PERF
42283328360000,PI,IP,001,1,12277,16815,5360,4538,PERF
42283328380000,PI,IP,001,1,10458,16436,6775,5978,PERF
42283328390000,PI,IP,001,1,11016,17255,7042,6239,PERF
42283328400000,PI,IP,001,1,9559,15651,6849,6092,PERF
42283328420000,PI,IP,001,1,8549,8731,5583,182,PERF
42283328420000,PI,IP,001,2,8830,9011,5583,181,PERF
42283328420000,PI,IP,001,3,9109,9291,5583,182,PERF
42283328420000,PI,IP,001,4,9389,9571,5583,182,PERF
42283328420000,PI,IP,001,5,9669,9851,5583,182,PERF
42283328420000,PI,IP,001,6,9944,10131,5583,187,PERF
42283328420000,PI,IP,001,7,10229,10411,5583,182,PERF
42283328420000,PI,IP,001,8,10504,10691,5583,187,PERF
42283328420000,PI,IP,001,9,10789,10971,5583,182,PERF
42283328420000,PI,IP,001,10,11069,11251,5583,182,PERF
42283328420000,PI,IP,001,11,11349,11531,5583,182,PERF
42283328420000,PI,IP,001,12,11629,11806,5583,177,PERF
42283328420000,PI,IP,001,13,11909,12087,5583,178,PERF
42283328420000,PI,IP,001,14,12189,12376,5583,187,PERF
42283328420000,PI,IP,001,15,12469,12650,5583,181,PERF
42283328420000,PI,IP,001,16,12749,12931,5583,182,PERF
42283328420000,PI,IP,001,17,13029,13211,5583,182,PERF
42283328430000,PI,IP,001,1,10834,15834,5305,5000,PERF
42283328440000,PI,IP,001,1,9159,15485,7078,6326,PERF
42283328450000,PI,IP,001,1,8899,13344,4969,4445,PERF
42283328460000,PI,IP,001,1,8360,8538,5825,178,PERF
42283328460000,PI,IP,001,2,8640,8818,5825,178,PERF
42283328460000,PI,IP,001,3,8921,9098,5825,177,PERF
42283328460000,PI,IP,001,4,9196,9377,5825,181,PERF
42283328460000,PI,IP,001,5,9476,9663,5825,187,PERF
42283328460000,PI,IP,001,6,9756,9941,5825,185,PERF
42283328460000,PI,IP,001,7,10036,10212,5825,176,PERF
42283328460000,PI,IP,001,8,10316,10493,5825,177,PERF
42283328460000,PI,IP,001,9,10596,10783,5825,187,PERF
42283328460000,PI,IP,001,10,10876,11062,5825,186,PERF
42283328460000,PI,IP,001,11,11156,11338,5825,182,PERF
42283328460000,PI,IP,001,12,11436,11618,5825,182,PERF
42283328460000,PI,IP,001,13,11716,11898,5825,182,PERF
42283328460000,PI,IP,001,14,11990,12178,5825,188,PERF
42283328460000,PI,IP,001,15,12276,12458,5825,182,PERF
42283328460000,PI,IP,001,16,12556,12737,5825,181,PERF
42283328460000,PI,IP,001,17,12836,13018,5825,182,PERF
42283328460000,PI,IP,001,18,13116,13298,5825,182,PERF
42283328470000,PI,IP,001,1,8537,8898,5471,361,PERF
42283328470000,PI,IP,001,2,8956,9317,5471,361,PERF
42283328470000,PI,IP,001,3,9375,9736,5471,361,PERF
42283328470000,PI,IP,001,4,9794,10155,5471,361,PERF
42283328470000,PI,IP,001,5,10213,10574,5471,361,PERF
42283328470000,PI,IP,001,6,10632,10993,5471,361,PERF
42283328470000,PI,IP,001,7,11051,11412,5471,361,PERF
42283328470000,PI,IP,001,8,11470,11831,5471,361,PERF
42283328470000,PI,IP,001,9,11889,12250,5471,361,PERF
42283328470000,PI,IP,001,10,12308,12669,5471,361,PERF
42283328470000,PI,IP,001,11,12727,13088,5471,361,PERF
42283328470000,PI,IP,001,12,13146,13442,5471,296,PERF
42283328480000,PI,IP,001,1,9085,9095,8606,10,PERF
42283328480000,PI,IP,001,2,9382,9392,8606,10,PERF
42283328480000,PI,IP,001,3,9678,9688,8606,10,PERF
42283328480000,PI,IP,001,4,9975,9985,8606,10,PERF
42283328480000,PI,IP,001,5,10271,10281,8606,10,PERF
42283328480000,PI,IP,001,6,10568,10578,8606,10,PERF
42283328480000,PI,IP,001,7,10864,10874,8606,10,PERF
42283328480000,PI,IP,001,8,11161,11171,8606,10,PERF
42283328480000,PI,IP,001,9,11457,11467,8606,10,PERF
42283328480000,PI,IP,001,10,11754,11764,8606,10,PERF
42283328480000,PI,IP,001,11,12050,12060,8606,10,PERF
42283328480000,PI,IP,001,12,12347,12357,8606,10,PERF
42283328480000,PI,IP,001,13,12643,12653,8606,10,PERF
42283328480000,PI,IP,001,14,12940,12950,8606,10,PERF
42283328480000,PI,IP,001,15,13237,13247,8606,10,PERF
42283328480000,PI,IP,001,16,13533,13543,8606,10,PERF
42283328480000,PI,IP,001,17,13830,13840,8606,10,PERF
42283328480000,PI,IP,001,18,14126,14136,8606,10,PERF
42283328480000,PI,IP,001,19,14423,14433,8606,10,PERF
42283328480000,PI,IP,001,20,14719,14729,8606,10,PERF
42283328480000,PI,IP,001,21,15016,15026,8606,10,PERF
42283328480000,PI,IP,001,22,15312,15322,8606,10,PERF
42283328480000,PI,IP,001,23,15609,15619,8606,10,PERF
42283328480000,PI,IP,001,24,15905,15915,8606,10,PERF
42283328480000,PI,IP,001,25,16202,16212,8606,10,PERF
42283328480000,PI,IP,001,26,16498,16508,8606,10,PERF
42283328480000,PI,IP,001,27,16825,16827,8606,2,PERF
42283328490000,PI,IP,001,1,10325,15702,6293,5377,PERF
42283328500000,PI,IP,001,1,11353,17423,6266,6070,PERF
42283328510000,PI,IP,001,1,9543,13510,4782,3967,PERF
42283328520000,PI,IP,001,1,8950,8960,8654,10,PERF
42283328520000,PI,IP,001,2,9250,9260,8654,10,PERF
42283328520000,PI,IP,001,3,9550,9560,8654,10,PERF
42283328520000,PI,IP,001,4,9954,9964,8654,10,PERF
42283328520000,PI,IP,001,5,10264,10274,8654,10,PERF
42283328520000,PI,IP,001,6,10575,10585,8654,10,PERF
42283328520000,PI,IP,001,7,10885,10895,8654,10,PERF
42283328520000,PI,IP,001,8,11196,11206,8654,10,PERF
42283328520000,PI,IP,001,9,11506,11516,8654,10,PERF
42283328520000,PI,IP,001,10,11817,11827,8654,10,PERF
42283328520000,PI,IP,001,11,12127,12137,8654,10,PERF
42283328520000,PI,IP,001,12,12438,12448,8654,10,PERF
42283328520000,PI,IP,001,13,12748,12758,8654,10,PERF
42283328520000,PI,IP,001,14,13059,13069,8654,10,PERF
42283328520000,PI,IP,001,15,13369,13379,8654,10,PERF
42283328520000,PI,IP,001,16,13680,13690,8654,10,PERF
42283328520000,PI,IP,001,17,13990,14000,8654,10,PERF
42283328520000,PI,IP,001,18,14301,14311,8654,10,PERF
42283328520000,PI,IP,001,19,14611,14621,8654,10,PERF
42283328520000,PI,IP,001,20,14922,14932,8654,10,PERF
42283328520000,PI,IP,001,21,15232,15242,8654,10,PERF
42283328520000,PI,IP,001,22,15543,15553,8654,10,PERF
42283328520000,PI,IP,001,23,15853,15863,8654,10,PERF
42283328520000,PI,IP,001,24,16164,16174,8654,10,PERF
42283328520000,PI,IP,001,25,16474,16484,8654,10,PERF
42283328520000,PI,IP,001,26,16785,16795,8654,10,PERF
42283328520000,PI,IP,001,27,17095,17098,8654,3,PERF
42283328530000,PI,IP,001,1,9550,16059,6929,6509,PERF
42283328540000,PI,IP,001,1,9321,13493,4794,4172,PERF
42283328550000,PI,IP,001,1,8676,14983,6824,6307,PERF
42283328560000,PI,IP,001,1,8785,15025,6880,6240,PERF
42283328570000,PI,IP,001,1,9365,13533,4818,4168,PERF
42283328580000,PI,IP,001,1,9451,14682,6026,5231,PERF
42283328590000,PI,IP,001,1,9075,9085,8535,10,PERF
42283328590000,PI,IP,001,2,9650,9660,8535,10,PERF
42283328590000,PI,IP,001,3,10075,10085,8535,10,PERF
42283328590000,PI,IP,001,4,10500,10510,8535,10,PERF
42283328590000,PI,IP,001,5,10783,10793,8535,10,PERF
42283328590000,PI,IP,001,6,11040,11050,8535,10,PERF
42283328590000,PI,IP,001,7,11348,11358,8535,10,PERF
42283328590000,PI,IP,001,8,11631,11641,8535,10,PERF
42283328590000,PI,IP,001,9,11914,11924,8535,10,PERF
42283328590000,PI,IP,001,10,12197,12207,8535,10,PERF
42283328590000,PI,IP,001,11,12480,12490,8535,10,PERF
42283328590000,PI,IP,001,12,12762,12772,8535,10,PERF
42283328590000,PI,IP,001,13,13045,13055,8535,10,PERF
42283328590000,PI,IP,001,14,13328,13338,8535,10,PERF
42283328590000,PI,IP,001,15,13611,13621,8535,10,PERF
42283328590000,PI,IP,001,16,13893,13903,8535,10,PERF
42283328590000,PI,IP,001,17,14176,14186,8535,10,PERF
42283328590000,PI,IP,001,18,14459,14469,8535,10,PERF
42283328590000,PI,IP,001,19,14742,14752,8535,10,PERF
42283328590000,PI,IP,001,20,15025,15035,8535,10,PERF
42283328590000,PI,IP,001,21,15307,15317,8535,10,PERF
42283328590000,PI,IP,001,22,15590,15600,8535,10,PERF
42283328590000,PI,IP,001,23,15873,15883,8535,10,PERF
42283328590000,PI,IP,001,24,16156,16166,8535,10,PERF
42283328590000,PI,IP,001,25,16438,16448,8535,10,PERF
42283328590000,PI,IP,001,26,16721,16731,8535,10,PERF
42283328590000,PI,IP,001,27,17004,17006,8535,2,PERF
42283328630000,PI,IP,001,1,7776,12345,4948,4569,PERF
42283328650000,PI,IP,001,1,7854,12460,4956,4606,PERF
42283328660000,PI,IP,001,1,7500,12570,4938,5070,PERF
42283328680000,PI,IP,001,1,7915,12490,4950,4575,PERF
42283328700000,PI,IP,001,1,9251,13915,5100,4664,PERF
42283328710000,PI,IP,001,1,10912,17387,6847,6475,PERF
42283328720000,PI,IP,001,1,10553,10785,6928,232,PERF
42283328720000,PI,IP,001,2,10873,11035,6928,162,PERF
42283328720000,PI,IP,001,3,11133,11295,6928,162,PERF
42283328720000,PI,IP,001,4,11483,11705,6928,222,PERF
42283328720000,PI,IP,001,5,11793,12015,6928,222,PERF
42283328720000,PI,IP,001,6,12103,12325,6928,222,PERF
42283328720000,PI,IP,001,7,12413,12635,6928,222,PERF
42283328720000,PI,IP,001,8,12723,12945,6928,222,PERF
42283328720000,PI,IP,001,9,13033,13255,6928,222,PERF
42283328720000,PI,IP,001,10,13343,13565,6928,222,PERF
42283328720000,PI,IP,001,11,13648,13867,6928,219,PERF
42283328720000,PI,IP,001,12,13963,14185,6928,222,PERF
42283328720000,PI,IP,001,13,14273,14495,6928,222,PERF
42283328720000,PI,IP,001,14,14583,16755,6928,2172,PERF
42283328730000,PI,IP,001,1,10960,17000,6875,6040,PERF
42283328740000,PI,IP,001,1,9278,13745,4932,4467,PERF
42283328750000,PI,IP,001,1,9502,14404,5384,4902,PERF
42283328760000,PI,IP,001,1,13209,16934,4605,3725,PERF
42283328770000,PI,IP,001,1,10020,14734,5657,4714,PERF
42283328780000,PI,IP,001,1,9847,15392,6030,5545,PERF
42283328790000,PI,IP,001,1,9320,14348,5605,5028,PERF
42283328800000,PI,IP,001,1,10300,14793,4769,4493,PERF
42283328810000,PI,IP,001,1,9531,15360,6610,5829,PERF
42283328820000,PI,IP,001,1,9629,14846,,5217,PERF
42283328830000,PI,IP,001,1,9629,17240,8598,7611,PERF
42283328840000,PI,IP,001,1,9863,14954,5608,5091,PERF
42283328850000,PI,IP,001,1,9791,10008,4847,217,PERF
42283328850000,PI,IP,001,2,10087,10307,4847,220,PERF
42283328850000,PI,IP,001,3,10383,10602,4847,219,PERF
42283328850000,PI,IP,001,4,10679,10900,4847,221,PERF
42283328850000,PI,IP,001,5,10975,11195,4847,220,PERF
42283328850000,PI,IP,001,6,11271,11495,4847,224,PERF
42283328850000,PI,IP,001,7,11567,11791,4847,224,PERF
42283328850000,PI,IP,001,8,11863,12087,4847,224,PERF
42283328850000,PI,IP,001,9,12159,12383,4847,224,PERF
42283328850000,PI,IP,001,10,12455,12679,4847,224,PERF
42283328850000,PI,IP,001,11,12751,12975,4847,224,PERF
42283328850000,PI,IP,001,12,13047,13271,4847,224,PERF
42283328850000,PI,IP,001,13,13343,13477,4847,134,PERF
42283328850000,PI,IP,001,14,13603,13792,4847,189,PERF
42283328850000,PI,IP,001,15,13864,14050,4847,186,PERF
42283328850000,PI,IP,001,16,14123,14257,4847,134,PERF
42283328850000,PI,IP,001,17,14383,14515,4847,132,PERF
42283328860000,PI,IP,001,1,10350,15067,5044,4717,PERF
42283328890000,PI,IP,001,1,9771,14383,5225,4612,PERF
42283328900000,PI,IP,001,1,8255,12847,5049,4592,PERF
42283328930000,PI,IP,001,1,9818,15276,5943,5458,PERF
42283328940000,PI,IP,001,1,10985,15020,4775,4035,PERF
42283328950000,PI,IP,001,1,8187,8369,,182,PERF
42283328950000,PI,IP,001,2,8447,8629,,182,PERF
42283328950000,PI,IP,001,3,8707,8889,,182,PERF
42283328950000,PI,IP,001,4,8970,9149,,179,PERF
42283328950000,PI,IP,001,5,9227,9409,,182,PERF
42283328950000,PI,IP,001,6,9487,9669,,182,PERF
42283328950000,PI,IP,001,7,9747,9929,,182,PERF
42283328950000,PI,IP,001,8,10007,10182,,175,PERF
42283328950000,PI,IP,001,9,10267,10442,,175,PERF
42283328950000,PI,IP,001,10,10527,10709,,182,PERF
42283328950000,PI,IP,001,11,10787,10969,,182,PERF
42283328950000,PI,IP,001,12,11047,11229,,182,PERF
42283328950000,PI,IP,001,13,11307,11489,,182,PERF
42283328950000,PI,IP,001,14,11567,11749,,182,PERF
42283328950000,PI,IP,001,15,11827,12002,,175,PERF
42283328950000,PI,IP,001,16,12082,12269,,187,PERF
42283328950000,PI,IP,001,17,12353,12535,,182,PERF
42283328950000,PI,IP,001,18,12607,12789,,182,PERF
42283328970000,PI,IP,001,1,9415,15499,6430,6084,PERF
42283328990000,PI,IP,001,1,9395,13831,4868,4436,PERF
42283329030000,PI,IP,001,1,11153,15693,5062,4540,PERF
42283329050000,PI,IP,001,1,8090,12842,4977,4752,PERF
42283329070000,PI,IP,001,1,8876,9221,6015,345,PERF
42283329070000,PI,IP,001,2,9265,9610,6015,345,PERF
42283329070000,PI,IP,001,3,9654,9999,6015,345,PERF
42283329070000,PI,IP,001,4,10043,10388,6015,345,PERF
42283329070000,PI,IP,001,5,10432,10777,6015,345,PERF
42283329070000,PI,IP,001,6,10821,11166,6015,345,PERF
42283329070000,PI,IP,001,7,11210,11555,6015,345,PERF
42283329070000,PI,IP,001,8,11599,11944,6015,345,PERF
42283329070000,PI,IP,001,9,11988,12323,6015,335,PERF
42283329070000,PI,IP,001,10,12377,12722,6015,345,PERF
42283329070000,PI,IP,001,11,12766,13111,6015,345,PERF
42283329070000,PI,IP,001,12,13155,13500,6015,345,PERF
42283329070000,PI,IP,001,13,13544,13889,6015,345,PERF
42283329070000,PI,IP,001,14,13933,14278,6015,345,PERF
42283329070000,PI,IP,001,15,14322,14667,6015,345,PERF
42283329080000,PI,IP,001,1,10887,15121,4625,4234,PERF
42283329090000,PI,IP,001,1,10300,15509,,5209,PERF
42283329100000,PI,IP,001,1,9715,14856,5931,5141,PERF
42283329110000,PI,IP,001,1,10340,15597,,5257,PERF
42283329180000,PI,IP,001,1,8938,9283,6016,345,PERF
42283329180000,PI,IP,001,2,9327,9672,6016,345,PERF
42283329180000,PI,IP,001,3,9716,10061,6016,345,PERF
42283329180000,PI,IP,001,4,10105,10450,6016,345,PERF
42283329180000,PI,IP,001,5,10494,10839,6016,345,PERF
42283329180000,PI,IP,001,6,10883,11228,6016,345,PERF
42283329180000,PI,IP,001,7,11272,11617,6016,345,PERF
42283329180000,PI,IP,001,8,11661,12006,6016,345,PERF
42283329180000,PI,IP,001,9,12050,12395,6016,345,PERF
42283329180000,PI,IP,001,10,12439,12784,6016,345,PERF
42283329180000,PI,IP,001,11,12828,13173,6016,345,PERF
42283329180000,PI,IP,001,12,13217,13562,6016,345,PERF
42283329180000,PI,IP,001,13,13606,13951,6016,345,PERF
42283329180000,PI,IP,001,14,13995,14340,6016,345,PERF
42283329180000,PI,IP,001,15,14384,14729,6016,345,PERF
42283329210000,PI,IP,001,1,9754,9940,5284,186,PERF
42283329210000,PI,IP,001,2,10020,10207,5284,187,PERF
42283329210000,PI,IP,001,3,10288,10473,5284,185,PERF
42283329210000,PI,IP,001,4,10553,10738,5284,185,PERF
42283329210000,PI,IP,001,5,10818,11007,5284,189,PERF
42283329210000,PI,IP,001,6,11080,11268,5284,188,PERF
42283329210000,PI,IP,001,7,11348,11533,5284,185,PERF
42283329210000,PI,IP,001,8,11613,11802,5284,189,PERF
42283329210000,PI,IP,001,9,11855,12063,5284,208,PERF
42283329210000,PI,IP,001,10,12143,12328,5284,185,PERF
42283329210000,PI,IP,001,11,12408,12593,5284,185,PERF
42283329210000,PI,IP,001,12,12673,12858,5284,185,PERF
42283329210000,PI,IP,001,13,12938,13123,5284,185,PERF
42283329210000,PI,IP,001,14,13203,13388,5284,185,PERF
42283329210000,PI,IP,001,15,13468,13658,5284,190,PERF
42283329210000,PI,IP,001,16,13731,13917,5284,186,PERF
42283329210000,PI,IP,001,17,13988,14182,5284,194,PERF
42283329210000,PI,IP,001,18,14263,14448,5284,185,PERF
42283329220000,PI,IP,001,1,10208,14485,5335,4277,PERF
42283329230000,PI,IP,001,1,9234,13637,5144,4403,PERF
42283329240000,PI,IP,001,1,9270,13422,5154,4152,PERF
42283329260000,PI,IP,001,1,9494,14563,,5069,PERF
42283329270000,PI,IP,001,1,9525,14325,5576,4800,PERF
42283329280000,PI,IP,001,1,9463,14050,4995,4587,PERF
42283329290000,PI,IP,001,1,10475,15612,,5137,PERF
42283329310000,PI,IP,001,1,8165,14900,7027,6735,PERF
42283329320000,PI,IP,001,1,10364,10365,5243,1,PERF
42283329320000,PI,IP,001,2,10424,10425,5243,1,PERF
42283329320000,PI,IP,001,3,10484,10485,5243,1,PERF
42283329320000,PI,IP,001,4,10543,10544,5243,1,PERF
42283329320000,PI,IP,001,5,10603,10604,5243,1,PERF
42283329320000,PI,IP,001,6,10662,10663,5243,1,PERF
42283329320000,PI,IP,001,7,10722,10723,5243,1,PERF
42283329320000,PI,IP,001,8,10782,10783,5243,1,PERF
42283329320000,PI,IP,001,9,10841,10842,5243,1,PERF
42283329320000,PI,IP,001,10,10885,10886,5243,1,PERF
42283329320000,PI,IP,001,11,10960,10961,5243,1,PERF
42283329320000,PI,IP,001,12,11020,11021,5243,1,PERF
42283329320000,PI,IP,001,13,11080,11081,5243,1,PERF
42283329320000,PI,IP,001,14,11139,11140,5243,1,PERF
42283329320000,PI,IP,001,15,11199,11200,5243,1,PERF
42283329320000,PI,IP,001,16,11258,11259,5243,1,PERF
42283329320000,PI,IP,001,17,11318,11319,5243,1,PERF
42283329320000,PI,IP,001,18,11378,11379,5243,1,PERF
42283329320000,PI,IP,001,19,11437,11438,5243,1,PERF
42283329320000,PI,IP,001,20,11497,11498,5243,1,PERF
42283329320000,PI,IP,001,21,11556,11557,5243,1,PERF
42283329320000,PI,IP,001,22,11616,11617,5243,1,PERF
42283329320000,PI,IP,001,23,11676,11677,5243,1,PERF
42283329320000,PI,IP,001,24,11735,11736,5243,1,PERF
42283329320000,PI,IP,001,25,11795,11796,5243,1,PERF
42283329320000,PI,IP,001,26,11854,11855,5243,1,PERF
42283329320000,PI,IP,001,27,11914,11915,5243,1,PERF
42283329320000,PI,IP,001,28,11974,11975,5243,1,PERF
42283329320000,PI,IP,001,29,12033,12034,5243,1,PERF
42283329320000,PI,IP,001,30,12093,12094,5243,1,PERF
42283329320000,PI,IP,001,31,12152,12153,5243,1,PERF
42283329320000,PI,IP,001,32,12212,12213,5243,1,PERF
42283329320000,PI,IP,001,33,12272,12273,5243,1,PERF
42283329320000,PI,IP,001,34,12331,12332,5243,1,PERF
42283329320000,PI,IP,001,35,12381,12382,5243,1,PERF
42283329320000,PI,IP,001,36,12450,12451,5243,1,PERF
42283329320000,PI,IP,001,37,12510,12511,5243,1,PERF
42283329320000,PI,IP,001,38,12570,12571,5243,1,PERF
42283329320000,PI,IP,001,39,12629,12630,5243,1,PERF
42283329320000,PI,IP,001,40,12680,12681,5243,1,PERF
42283329320000,PI,IP,001,41,12748,12749,5243,1,PERF
42283329320000,PI,IP,001,42,12808,12809,5243,1,PERF
42283329320000,PI,IP,001,43,12868,12869,5243,1,PERF
42283329320000,PI,IP,001,44,12927,12928,5243,1,PERF
42283329320000,PI,IP,001,45,12987,12988,5243,1,PERF
42283329320000,PI,IP,001,46,13046,13047,5243,1,PERF
42283329320000,PI,IP,001,47,13106,13107,5243,1,PERF
42283329320000,PI,IP,001,48,13166,13167,5243,1,PERF
42283329320000,PI,IP,001,49,13225,13226,5243,1,PERF
42283329320000,PI,IP,001,50,13285,13286,5243,1,PERF
42283329320000,PI,IP,001,51,13344,13345,5243,1,PERF
42283329320000,PI,IP,001,52,13404,13405,5243,1,PERF
42283329320000,PI,IP,001,53,13464,13465,5243,1,PERF
42283329320000,PI,IP,001,54,13523,13524,5243,1,PERF
42283329320000,PI,IP,001,55,13583,13584,5243,1,PERF
42283329320000,PI,IP,001,56,13642,13643,5243,1,PERF
42283329320000,PI,IP,001,57,13702,13703,5243,1,PERF
42283329320000,PI,IP,001,58,13762,13763,5243,1,PERF
42283329320000,PI,IP,001,59,13805,13806,5243,1,PERF
42283329320000,PI,IP,001,60,13846,13847,5243,1,PERF
42283329320000,PI,IP,001,61,13898,13899,5243,1,PERF
42283329320000,PI,IP,001,62,13929,13930,5243,1,PERF
42283329320000,PI,IP,001,63,13958,13959,5243,1,PERF
42283329320000,PI,IP,001,64,13988,13989,5243,1,PERF
42283329320000,PI,IP,001,65,14018,14019,5243,1,PERF
42283329320000,PI,IP,001,66,14238,14239,5243,1,PERF
42283329320000,PI,IP,001,67,14298,14299,5243,1,PERF
42283329320000,PI,IP,001,68,14358,14359,5243,1,PERF
42283329320000,PI,IP,001,69,14417,14418,5243,1,PERF
42283329320000,PI,IP,001,70,14477,14478,5243,1,PERF
42283329320000,PI,IP,001,71,14537,14539,5243,2,PERF
42283329320000,PI,IP,001,72,14605,14607,5243,2,PERF
42283329320000,PI,IP,001,73,14674,14676,5243,2,PERF
42283329320000,PI,IP,001,74,14743,14745,5243,2,PERF
42283329320000,PI,IP,001,75,14811,14813,5243,2,PERF
42283329330000,PI,IP,001,1,9695,15330,6330,5635,PERF
42283329360000,PI,IP,001,1,10475,19047,9911,8572,PERF
42283329370000,PI,IP,001,1,9036,15177,7276,6141,PERF
42283329380000,PI,IP,001,1,8750,15701,7513,6951,PERF
42283329390000,PI,IP,001,1,8754,15165,6674,6411,PERF
42283329400000,PI,IP,001,1,10465,19151,9869,8686,PERF
42283329420000,PI,IP,001,1,10630,15191,,4561,PERF
42283329480000,PI,IP,001,1,10179,15402,5988,5223,PERF
42283329490000,PI,IP,001,1,11115,14916,4279,3801,PERF
42283329510000,PI,IP,001,1,10032,16205,7128,6173,PERF
42283329520000,PI,IP,001,1,9951,13502,4876,3551,PERF
42283329530000,PI,IP,001,1,9996,16206,7050,6210,COMB
42283329540000,PI,IP,001,1,9455,13824,5716,4369,PERF
42283329560000,PI,IP,001,1,11737,11738,5960,1,PERF
42283329560000,PI,IP,001,2,11797,11798,5960,1,PERF
42283329560000,PI,IP,001,3,11856,11857,5960,1,PERF
42283329560000,PI,IP,001,4,11915,11916,5960,1,PERF
42283329560000,PI,IP,001,5,11975,11976,5960,1,PERF
42283329560000,PI,IP,001,6,12034,12035,5960,1,PERF
42283329560000,PI,IP,001,7,12094,12095,5960,1,PERF
42283329560000,PI,IP,001,8,12153,12154,5960,1,PERF
42283329560000,PI,IP,001,9,12212,12213,5960,1,PERF
42283329560000,PI,IP,001,10,12272,12273,5960,1,PERF
42283329560000,PI,IP,001,11,12331,12332,5960,1,PERF
42283329560000,PI,IP,001,12,12391,12392,5960,1,PERF
42283329560000,PI,IP,001,13,12450,12451,5960,1,PERF
42283329560000,PI,IP,001,14,12509,12510,5960,1,PERF
42283329560000,PI,IP,001,15,12569,12570,5960,1,PERF
42283329560000,PI,IP,001,16,12628,12629,5960,1,PERF
42283329560000,PI,IP,001,17,12688,12689,5960,1,PERF
42283329560000,PI,IP,001,18,12747,12748,5960,1,PERF
42283329560000,PI,IP,001,19,12806,12807,5960,1,PERF
42283329560000,PI,IP,001,20,12866,12867,5960,1,PERF
42283329560000,PI,IP,001,21,12925,12926,5960,1,PERF
42283329560000,PI,IP,001,22,12985,12986,5960,1,PERF
42283329560000,PI,IP,001,23,13044,13045,5960,1,PERF
42283329560000,PI,IP,001,24,13103,13104,5960,1,PERF
42283329560000,PI,IP,001,25,13163,13164,5960,1,PERF
42283329560000,PI,IP,001,26,13222,13223,5960,1,PERF
42283329560000,PI,IP,001,27,13282,13283,5960,1,PERF
42283329560000,PI,IP,001,28,13341,13343,5960,2,PERF
42283329560000,PI,IP,001,29,13400,13401,5960,1,PERF
42283329560000,PI,IP,001,30,13460,13461,5960,1,PERF
42283329560000,PI,IP,001,31,13519,13520,5960,1,PERF
42283329560000,PI,IP,001,32,13579,13580,5960,1,PERF
42283329560000,PI,IP,001,33,13638,13639,5960,1,PERF
42283329560000,PI,IP,001,34,13697,13698,5960,1,PERF
42283329560000,PI,IP,001,35,13757,13758,5960,1,PERF
42283329560000,PI,IP,001,36,13816,13817,5960,1,PERF
42283329560000,PI,IP,001,37,13876,13877,5960,1,PERF
42283329560000,PI,IP,001,38,13935,13936,5960,1,PERF
42283329560000,PI,IP,001,39,13994,13995,5960,1,PERF
42283329560000,PI,IP,001,40,14054,14055,5960,1,PERF
42283329560000,PI,IP,001,41,14113,14114,5960,1,PERF
42283329560000,PI,IP,001,42,14173,14174,5960,1,PERF
42283329560000,PI,IP,001,43,14232,14233,5960,1,PERF
42283329560000,PI,IP,001,44,14291,14292,5960,1,PERF
42283329560000,PI,IP,001,45,14351,14352,5960,1,PERF
42283329560000,PI,IP,001,46,14410,14411,5960,1,PERF
42283329560000,PI,IP,001,47,14470,14471,5960,1,PERF
42283329560000,PI,IP,001,48,14529,14530,5960,1,PERF
42283329560000,PI,IP,001,49,14588,14589,5960,1,PERF
42283329560000,PI,IP,001,50,14648,14649,5960,1,PERF
42283329560000,PI,IP,001,51,14707,14708,5960,1,PERF
42283329560000,PI,IP,001,52,14767,14768,5960,1,PERF
42283329560000,PI,IP,001,53,14826,14827,5960,1,PERF
42283329560000,PI,IP,001,54,14885,14886,5960,1,PERF
42283329560000,PI,IP,001,55,14945,14946,5960,1,PERF
42283329560000,PI,IP,001,56,15004,15005,5960,1,PERF
42283329560000,PI,IP,001,57,15064,15065,5960,1,PERF
42283329560000,PI,IP,001,58,15123,15124,5960,1,PERF
42283329560000,PI,IP,001,59,15182,15183,5960,1,PERF
42283329560000,PI,IP,001,60,15242,15243,5960,1,PERF
42283329560000,PI,IP,001,61,15301,15302,5960,1,PERF
42283329560000,PI,IP,001,62,15361,15362,5960,1,PERF
42283329560000,PI,IP,001,63,15420,15421,5960,1,PERF
42283329560000,PI,IP,001,64,15479,15480,5960,1,PERF
42283329560000,PI,IP,001,65,15539,15540,5960,1,PERF
42283329560000,PI,IP,001,66,15598,15599,5960,1,PERF
42283329560000,PI,IP,001,67,15658,15659,5960,1,PERF
42283329560000,PI,IP,001,68,15717,15718,5960,1,PERF
42283329560000,PI,IP,001,69,15776,15777,5960,1,PERF
42283329560000,PI,IP,001,70,15824,15825,5960,1,PERF
42283329560000,PI,IP,001,71,15895,15896,5960,1,PERF
42283329560000,PI,IP,001,72,15955,15956,5960,1,PERF
42283329560000,PI,IP,001,73,16014,16015,5960,1,PERF
42283329560000,PI,IP,001,74,16073,16074,5960,1,PERF
42283329560000,PI,IP,001,75,16116,16117,5960,1,PERF
42283329560000,PI,IP,001,76,16192,16193,5960,1,PERF
42283329560000,PI,IP,001,77,16252,16253,5960,1,PERF
42283329560000,PI,IP,001,78,16311,16312,5960,1,PERF
42283329560000,PI,IP,001,79,16370,16371,5960,1,PERF
42283329560000,PI,IP,001,80,16382,16383,5960,1,PERF
42283329560000,PI,IP,001,81,16489,16491,5960,2,PERF
42283329560000,PI,IP,001,82,16549,16551,5960,2,PERF
42283329560000,PI,IP,001,83,16609,16611,5960,2,PERF
42283329560000,PI,IP,001,84,16669,16671,5960,2,PERF
42283329560000,PI,IP,001,85,16729,16731,5960,2,PERF
42283329570000,PI,IP,001,1,10427,15117,,4690,PERF
42283329580000,PI,IP,001,1,11127,15973,5530,4846,PERF
42283329590000,PI,IP,001,1,11114,15865,4954,4751,PERF
42283329600000,PI,IP,001,1,7787,15235,7731,7448,PERF
42283329610000,PI,IP,001,1,10904,15854,4996,4950,PERF
42283329620000,PI,IP,001,1,10805,15856,5494,5051,PERF
42283329630000,PI,IP,001,1,8176,12799,4901,4623,PERF
42283329640000,PI,IP,001,1,8320,13246,5722,4926,PERF
42283329670000,PI,IP,001,1,11011,11012,4597,1,PERF
42283329670000,PI,IP,001,2,11069,11070,4597,1,PERF
42283329670000,PI,IP,001,3,11128,11129,4597,1,PERF
42283329670000,PI,IP,001,4,11186,11187,4597,1,PERF
42283329670000,PI,IP,001,5,11244,11245,4597,1,PERF
42283329670000,PI,IP,001,6,11303,11304,4597,1,PERF
42283329670000,PI,IP,001,7,11361,11362,4597,1,PERF
42283329670000,PI,IP,001,8,11420,11421,4597,1,PERF
42283329670000,PI,IP,001,9,11478,11479,4597,1,PERF
42283329670000,PI,IP,001,10,11536,11537,4597,1,PERF
42283329670000,PI,IP,001,11,11595,11596,4597,1,PERF
42283329670000,PI,IP,001,12,11653,11654,4597,1,PERF
42283329670000,PI,IP,001,13,11712,11713,4597,1,PERF
42283329670000,PI,IP,001,14,11770,11771,4597,1,PERF
42283329670000,PI,IP,001,15,11828,11829,4597,1,PERF
42283329670000,PI,IP,001,16,11887,11888,4597,1,PERF
42283329670000,PI,IP,001,17,11945,11946,4597,1,PERF
42283329670000,PI,IP,001,18,12004,12005,4597,1,PERF
42283329670000,PI,IP,001,19,12062,12063,4597,1,PERF
42283329670000,PI,IP,001,20,12120,12121,4597,1,PERF
42283329670000,PI,IP,001,21,12179,12180,4597,1,PERF
42283329670000,PI,IP,001,22,12237,12238,4597,1,PERF
42283329670000,PI,IP,001,23,12296,12297,4597,1,PERF
42283329670000,PI,IP,001,24,12354,12355,4597,1,PERF
42283329670000,PI,IP,001,25,12412,12413,4597,1,PERF
42283329670000,PI,IP,001,26,12471,12472,4597,1,PERF
42283329670000,PI,IP,001,27,12529,12530,4597,1,PERF
42283329670000,PI,IP,001,28,12588,12589,4597,1,PERF
42283329670000,PI,IP,001,29,12646,12647,4597,1,PERF
42283329670000,PI,IP,001,30,12704,12705,4597,1,PERF
42283329670000,PI,IP,001,31,12763,12764,4597,1,PERF
42283329670000,PI,IP,001,32,12821,12822,4597,1,PERF
42283329670000,PI,IP,001,33,12880,12881,4597,1,PERF
42283329670000,PI,IP,001,34,12938,12939,4597,1,PERF
42283329670000,PI,IP,001,35,12986,12987,4597,1,PERF
42283329670000,PI,IP,001,36,13055,13056,4597,1,PERF
42283329670000,PI,IP,001,37,13113,13114,4597,1,PERF
42283329670000,PI,IP,001,38,13172,13173,4597,1,PERF
42283329670000,PI,IP,001,39,13230,13231,4597,1,PERF
42283329670000,PI,IP,001,40,13280,13281,4597,1,PERF
42283329670000,PI,IP,001,41,13347,13348,4597,1,PERF
42283329670000,PI,IP,001,42,13405,13406,4597,1,PERF
42283329670000,PI,IP,001,43,13464,13465,4597,1,PERF
42283329670000,PI,IP,001,44,13522,13523,4597,1,PERF
42283329670000,PI,IP,001,45,13580,13581,4597,1,PERF
42283329670000,PI,IP,001,46,13639,13640,4597,1,PERF
42283329670000,PI,IP,001,47,13697,13698,4597,1,PERF
42283329670000,PI,IP,001,48,13756,13757,4597,1,PERF
42283329670000,PI,IP,001,49,13814,13815,4597,1,PERF
42283329670000,PI,IP,001,50,13872,13873,4597,1,PERF
42283329670000,PI,IP,001,51,13931,13932,4597,1,PERF
42283329670000,PI,IP,001,52,13989,13990,4597,1,PERF
42283329670000,PI,IP,001,53,14048,14049,4597,1,PERF
42283329670000,PI,IP,001,54,14106,14107,4597,1,PERF
42283329670000,PI,IP,001,55,14164,14165,4597,1,PERF
42283329670000,PI,IP,001,56,14223,14224,4597,1,PERF
42283329670000,PI,IP,001,57,14281,14282,4597,1,PERF
42283329670000,PI,IP,001,58,14340,14341,4597,1,PERF
42283329670000,PI,IP,001,59,14398,14399,4597,1,PERF
42283329670000,PI,IP,001,60,14456,14457,4597,1,PERF
42283329670000,PI,IP,001,61,14515,14516,4597,1,PERF
42283329670000,PI,IP,001,62,14573,14574,4597,1,PERF
42283329670000,PI,IP,001,63,14632,14633,4597,1,PERF
42283329670000,PI,IP,001,64,14690,14691,4597,1,PERF
42283329670000,PI,IP,001,65,14748,14749,4597,1,PERF
42283329670000,PI,IP,001,66,14804,14805,4597,1,PERF
42283329670000,PI,IP,001,67,14872,14873,4597,1,PERF
42283329670000,PI,IP,001,68,14941,14942,4597,1,PERF
42283329670000,PI,IP,001,69,15010,15011,4597,1,PERF
42283329670000,PI,IP,001,70,15078,15079,4597,1,PERF
42283329680000,PI,IP,001,1,10967,15980,5598,5013,PERF
42283329690000,PI,IP,001,1,11210,15572,5799,4362,PERF
42283329700100,PI,IP,001,1,9422,14440,5634,5018,PERF
42283329710000,PI,IP,001,1,10304,10526,6118,222,PERF
42283329710000,PI,IP,001,2,10614,10835,6118,221,PERF
42283329710000,PI,IP,001,3,10932,11154,6118,222,PERF
42283329710000,PI,IP,001,4,11246,11468,6118,222,PERF
42283329710000,PI,IP,001,5,11560,11650,6118,90,PERF
42283329710000,PI,IP,001,6,11874,12080,6118,206,PERF
42283329710000,PI,IP,001,7,12178,12384,6118,206,PERF
42283329710000,PI,IP,001,8,12482,12688,6118,206,PERF
42283329710000,PI,IP,001,9,12786,12992,6118,206,PERF
42283329710000,PI,IP,001,10,13090,13312,6118,222,PERF
42283329710000,PI,IP,001,11,13404,13626,6118,222,PERF
42283329710000,PI,IP,001,12,13718,13938,6118,220,PERF
42283329710000,PI,IP,001,13,14032,14254,6118,222,PERF
42283329710000,PI,IP,001,14,14346,14552,6118,206,PERF
42283329710000,PI,IP,001,15,14650,14856,6118,206,PERF
42283329710000,PI,IP,001,16,14954,15160,6118,206,PERF
42283329710000,PI,IP,001,17,15258,15464,6118,206,PERF
42283329710000,PI,IP,001,18,15562,15784,6118,222,PERF
42283329710000,PI,IP,001,19,15876,16106,6118,230,PERF
42283329730000,PI,IP,001,1,8939,14100,5516,5161,PERF
42283329740100,PI,IP,001,1,9848,15210,5907,5362,PERF
42283329750000,PI,IP,001,1,8065,8262,4694,197,PERF
42283329750000,PI,IP,001,2,8335,8537,4694,202,PERF
42283329750000,PI,IP,001,3,8605,8807,4694,202,PERF
42283329750000,PI,IP,001,4,8875,9077,4694,202,PERF
42283329750000,PI,IP,001,5,9145,9347,4694,202,PERF
42283329750000,PI,IP,001,6,9415,9617,4694,202,PERF
42283329750000,PI,IP,001,7,9690,9887,4694,197,PERF
42283329750000,PI,IP,001,8,9955,10157,4694,202,PERF
42283329750000,PI,IP,001,9,10225,10427,4694,202,PERF
42283329750000,PI,IP,001,10,10495,10697,4694,202,PERF
42283329750000,PI,IP,001,11,10765,10956,4694,191,PERF
42283329750000,PI,IP,001,12,11035,11232,4694,197,PERF
42283329750000,PI,IP,001,13,11305,11507,4694,202,PERF
42283329750000,PI,IP,001,14,11580,11777,4694,197,PERF
42283329750000,PI,IP,001,15,11845,12047,4694,202,PERF
42283329750000,PI,IP,001,16,12132,12320,4694,188,PERF
42283329760000,PI,IP,001,1,11269,17882,7489,6613,PERF
42283329770000,PI,IP,001,1,10404,17660,7549,7256,PERF
42283329780000,PI,IP,001,1,9940,16338,6705,6398,PERF
42283329790000,PI,IP,001,1,8640,13702,5774,5062,PERF
42283329800000,PI,IP,001,1,8568,13220,4818,4652,PERF
42283329810000,PI,IP,001,1,10499,18450,8492,7951,PERF
42283329860000,PI,IP,001,1,9925,15055,5590,5130,PERF
42283329870000,PI,IP,001,1,10070,15484,5700,5414,PERF
42283329880000,PI,IP,001,1,9910,15662,,5752,PERF
42283329890000,PI,IP,001,1,10789,18174,7632,7385,PERF
42283329900000,PI,IP,001,1,12475,18628,8662,6153,PERF
42283329910000,PI,IP,001,1,8944,15755,,6811,PERF
42283329920000,PI,IP,001,1,11464,15424,4548,3960,PERF
42283329930000,PI,IP,001,1,10652,14584,5220,3932,PERF
42283329940000,PI,IP,001,1,10896,16733,5751,5837,PERF
42283329950000,PI,IP,001,1,9552,14015,4516,4463,PERF
42283329960000,PI,IP,001,1,11410,16042,5476,4632,PERF
42283329970000,PI,IP,001,1,11063,15943,5391,4880,PERF
42283329980000,PI,IP,001,1,8879,12743,4264,3864,PERF
42283329990000,PI,IP,001,1,9529,14210,5083,4681,PERF
42283330010100,PI,IP,001,1,8871,8881,6222,10,PERF
42283330010100,PI,IP,001,2,9126,9136,6222,10,PERF
42283330010100,PI,IP,001,3,9381,9391,6222,10,PERF
42283330010100,PI,IP,001,4,9636,9646,6222,10,PERF
42283330010100,PI,IP,001,5,9891,9901,6222,10,PERF
42283330010100,PI,IP,001,6,10146,10156,6222,10,PERF
42283330010100,PI,IP,001,7,10401,10411,6222,10,PERF
42283330010100,PI,IP,001,8,10656,10666,6222,10,PERF
42283330010100,PI,IP,001,9,10911,10921,6222,10,PERF
42283330010100,PI,IP,001,10,11166,11176,6222,10,PERF
42283330010100,PI,IP,001,11,11421,11431,6222,10,PERF
42283330010100,PI,IP,001,12,11676,11686,6222,10,PERF
42283330010100,PI,IP,001,13,11931,11941,6222,10,PERF
42283330010100,PI,IP,001,14,12186,12196,6222,10,PERF
42283330010100,PI,IP,001,15,12441,12451,6222,10,PERF
42283330010100,PI,IP,001,16,12696,12706,6222,10,PERF
42283330010100,PI,IP,001,17,12951,12961,6222,10,PERF
42283330010100,PI,IP,001,18,13206,13216,6222,10,PERF
42283330010100,PI,IP,001,19,13466,13476,6222,10,PERF
42283330010100,PI,IP,001,20,13726,13736,6222,10,PERF
42283330010100,PI,IP,001,21,13971,13981,6222,10,PERF
42283330010100,PI,IP,001,22,14226,14228,6222,2,PERF
42283330030000,PI,IP,001,1,10530,16630,,6100,PERF
42283330050000,PI,IP,001,1,10487,17527,,7040,PERF
42283330060000,PI,IP,001,1,10332,16326,7000,5994,PERF
42283330070000,PI,IP,001,1,9209,13655,4975,4446,PERF
42283330080000,PI,IP,001,1,9225,15748,7158,6523,PERF
42283330090000,PI,IP,001,1,9932,10133,5868,201,PERF
42283330090000,PI,IP,001,2,10212,10413,5868,201,PERF
42283330090000,PI,IP,001,3,10495,10690,5868,195,PERF
42283330090000,PI,IP,001,4,10770,10973,5868,203,PERF
42283330090000,PI,IP,001,5,11052,11253,5868,201,PERF
42283330090000,PI,IP,001,6,11332,11533,5868,201,PERF
42283330090000,PI,IP,001,7,11612,11818,5868,206,PERF
42283330090000,PI,IP,001,8,11892,12093,5868,201,PERF
42283330090000,PI,IP,001,9,12172,12373,5868,201,PERF
42283330090000,PI,IP,001,10,12452,12653,5868,201,PERF
42283330090000,PI,IP,001,11,12732,12933,5868,201,PERF
42283330090000,PI,IP,001,12,13012,13213,5868,201,PERF
42283330090000,PI,IP,001,13,13292,13492,5868,200,PERF
42283330090000,PI,IP,001,14,13572,13772,5868,200,PERF
42283330090000,PI,IP,001,15,13852,14053,5868,201,PERF
42283330090000,PI,IP,001,16,14132,14333,5868,201,PERF
42283330090000,PI,IP,001,17,14412,14613,5868,201,PERF
42283330100000,PI,IP,001,1,9971,10168,6122,197,PERF
42283330100000,PI,IP,001,2,10246,10443,6122,197,PERF
42283330100000,PI,IP,001,3,10521,10718,6122,197,PERF
42283330100000,PI,IP,001,4,10796,10993,6122,197,PERF
42283330100000,PI,IP,001,5,11071,11268,6122,197,PERF
42283330100000,PI,IP,001,6,11350,11541,6122,191,PERF
42283330100000,PI,IP,001,7,11621,11818,6122,197,PERF
42283330100000,PI,IP,001,8,11896,12093,6122,197,PERF
42283330100000,PI,IP,001,9,12171,12368,6122,197,PERF
42283330100000,PI,IP,001,10,12446,12643,6122,197,PERF
42283330100000,PI,IP,001,11,12721,12918,6122,197,PERF
42283330100000,PI,IP,001,12,12996,13193,6122,197,PERF
42283330100000,PI,IP,001,13,13271,13469,6122,198,PERF
42283330100000,PI,IP,001,14,13546,13746,6122,200,PERF
42283330100000,PI,IP,001,15,13821,14018,6122,197,PERF
42283330100000,PI,IP,001,16,14096,14293,6122,197,PERF
42283330100000,PI,IP,001,17,14371,14568,6122,197,PERF
42283330100000,PI,IP,001,18,14646,14842,6122,196,PERF
42283330100000,PI,IP,001,19,14921,15118,6122,197,PERF
42283330110000,PI,IP,001,1,7982,15638,8223,7656,PERF
42283330120000,PI,IP,001,1,9380,16115,7049,6735,PERF
42283330130000,PI,IP,001,1,9468,13540,5262,4072,PERF
42283330150000,PI,IP,001,1,9230,13651,5589,4421,PERF
42283330160000,PI,IP,001,1,9259,13900,5928,4641,PERF
42283330170000,PI,IP,001,1,9262,14219,6278,4957,PERF
42283330180000,PI,IP,001,1,9288,14647,6645,5359,PERF
42283330190000,PI,IP,001,1,9240,15073,7022,5833,PERF
42283330200000,PI,IP,001,1,11316,15675,4975,4359,PERF
42283330210000,PI,IP,001,1,9059,13954,5740,4895,PERF
42283330250000,PI,IP,001,1,7864,12741,5188,4877,PERF
42283330270000,PI,IP,001,1,11186,16035,5452,4849,PERF
42283330290000,PI,IP,001,1,8810,8820,7677,10,PERF
42283330290000,PI,IP,001,2,9070,9080,7677,10,PERF
42283330290000,PI,IP,001,3,9330,9340,7677,10,PERF
42283330290000,PI,IP,001,4,9590,9600,7677,10,PERF
42283330290000,PI,IP,001,5,9850,9860,7677,10,PERF
42283330290000,PI,IP,001,6,10110,10120,7677,10,PERF
42283330290000,PI,IP,001,7,10370,10380,7677,10,PERF
42283330290000,PI,IP,001,8,10630,10640,7677,10,PERF
42283330290000,PI,IP,001,9,10890,10900,7677,10,PERF
42283330290000,PI,IP,001,10,11005,11007,7677,2,PERF
42283330290000,PI,IP,001,11,11095,11097,7677,2,PERF
42283330290000,PI,IP,001,12,11265,11267,7677,2,PERF
42283330290000,PI,IP,001,13,11355,11357,7677,2,PERF
42283330290000,PI,IP,001,14,11670,11680,7677,10,PERF
42283330290000,PI,IP,001,15,11930,11940,7677,10,PERF
42283330290000,PI,IP,001,16,12190,12200,7677,10,PERF
42283330290000,PI,IP,001,17,12450,12460,7677,10,PERF
42283330290000,PI,IP,001,18,12710,12720,7677,10,PERF
42283330290000,PI,IP,001,19,12970,12980,7677,10,PERF
42283330290000,PI,IP,001,20,13230,13240,7677,10,PERF
42283330290000,PI,IP,001,21,13490,13500,7677,10,PERF
42283330290000,PI,IP,001,22,13735,13745,7677,10,PERF
42283330290000,PI,IP,001,23,14350,14360,7677,10,PERF
42283330290000,PI,IP,001,24,15153,15163,7677,10,PERF
42283330290000,PI,IP,001,25,15453,15455,7677,2,PERF
42283330300000,PI,IP,001,1,9097,9323,5486,226,PERF
42283330300000,PI,IP,001,2,9397,9623,5486,226,PERF
42283330300000,PI,IP,001,3,9697,9923,5486,226,PERF
42283330300000,PI,IP,001,4,9997,10223,5486,226,PERF
42283330300000,PI,IP,001,5,10297,10523,5486,226,PERF
42283330300000,PI,IP,001,6,10597,10823,5486,226,PERF
42283330300000,PI,IP,001,7,10897,11123,5486,226,PERF
42283330300000,PI,IP,001,8,11197,11423,5486,226,PERF
42283330300000,PI,IP,001,9,11497,11723,5486,226,PERF
42283330300000,PI,IP,001,10,11797,12023,5486,226,PERF
42283330300000,PI,IP,001,11,12097,12323,5486,226,PERF
42283330300000,PI,IP,001,12,12397,12623,5486,226,PERF
42283330300000,PI,IP,001,13,12697,12926,5486,229,PERF
42283330300000,PI,IP,001,14,12997,13223,5486,226,PERF
42283330300000,PI,IP,001,15,13297,13523,5486,226,PERF
42283330300000,PI,IP,001,16,13547,13697,5486,150,PERF
42283330310000,PI,IP,001,1,10051,15150,,5099,PERF
42283330330000,PI,IP,001,1,9392,13680,4959,4288,PERF
42283330350000,PI,IP,001,1,8913,13892,5470,4979,PERF
42283330360000,PI,IP,001,1,8860,12579,5547,3719,PERF
42283330370000,PI,IP,001,1,8846,16524,8415,7678,PERF
42283330380000,PI,IP,001,1,8820,8981,6943,161,PERF
42283330380000,PI,IP,001,2,9140,9301,6943,161,PERF
42283330380000,PI,IP,001,3,9460,9621,6943,161,PERF
42283330380000,PI,IP,001,4,9780,9941,6943,161,PERF
42283330380000,PI,IP,001,5,10100,10261,6943,161,PERF
42283330380000,PI,IP,001,6,10420,10581,6943,161,PERF
42283330380000,PI,IP,001,7,10740,10901,6943,161,PERF
42283330380000,PI,IP,001,8,11060,11221,6943,161,PERF
42283330380000,PI,IP,001,9,11380,11541,6943,161,PERF
42283330380000,PI,IP,001,10,11700,11861,6943,161,PERF
42283330380000,PI,IP,001,11,12020,12181,6943,161,PERF
42283330380000,PI,IP,001,12,12340,12501,6943,161,PERF
42283330380000,PI,IP,001,13,12660,12821,6943,161,PERF
42283330380000,PI,IP,001,14,12980,13141,6943,161,PERF
42283330380000,PI,IP,001,15,13300,13461,6943,161,PERF
42283330380000,PI,IP,001,16,13620,13781,6943,161,PERF
42283330380000,PI,IP,001,17,13940,15422,6943,1482,PERF
42283330390000,PI,IP,001,1,8719,16418,8504,7699,PERF
42283330400000,PI,IP,001,1,8804,14303,,5499,PERF
42283330410000,PI,IP,001,1,8809,15236,,6427,PERF
42283330420000,PI,IP,001,1,11120,16272,5553,5152,PERF
42283330430000,PI,IP,001,1,8860,12579,4370,3719,PERF
42283330440000,PI,IP,001,1,8929,12577,4530,3648,PERF
42283330480000,PI,IP,001,1,10022,15710,6704,5688,PERF
42283330490000,PI,IP,001,1,9961,15730,6679,5769,PERF
42283330500000,PI,IP,001,1,8149,16610,8849,8461,PERF
42283330510000,PI,IP,001,1,8068,16555,8844,8487,PERF
42283330550000,PI,IP,001,1,8460,14844,6817,6384,PERF
42283330560000,PI,IP,001,1,8460,14501,6855,6041,PERF
42283330570000,PI,IP,001,1,9639,14315,5276,4676,PERF
42283330580000,PI,IP,001,1,11194,15556,4898,4362,PERF
42283330590000,PI,IP,001,1,9002,9203,,201,PERF
42283330590000,PI,IP,001,2,9272,9473,,201,PERF
42283330590000,PI,IP,001,3,9542,9743,,201,PERF
42283330590000,PI,IP,001,4,9812,10013,,201,PERF
42283330590000,PI,IP,001,5,10082,10283,,201,PERF
42283330590000,PI,IP,001,6,10352,10553,,201,PERF
42283330590000,PI,IP,001,7,10622,10823,,201,PERF
42283330590000,PI,IP,001,8,10892,11093,,201,PERF
42283330590000,PI,IP,001,9,11162,11363,,201,PERF
42283330590000,PI,IP,001,10,11432,11633,,201,PERF
42283330590000,PI,IP,001,11,11702,11903,,201,PERF
42283330590000,PI,IP,001,12,11972,12173,,201,PERF
42283330590000,PI,IP,001,13,12242,12443,,201,PERF
42283330590000,PI,IP,001,14,12512,12713,,201,PERF
42283330590000,PI,IP,001,15,12782,12983,,201,PERF
42283330590000,PI,IP,001,16,13052,13253,,201,PERF
42283330590000,PI,IP,001,17,13322,13523,,201,PERF
42283330590000,PI,IP,001,18,13592,13793,,201,PERF
42283330590000,PI,IP,001,19,13862,14063,,201,PERF
42283330590000,PI,IP,001,20,14132,14333,,201,PERF
42283330590000,PI,IP,001,21,14402,14603,,201,PERF
42283330590000,PI,IP,001,22,14672,14873,,201,PERF
42283330590000,PI,IP,001,23,14942,15143,,201,PERF
42283330590000,PI,IP,001,24,15212,15413,,201,PERF
42283330590000,PI,IP,001,25,15482,15683,,201,PERF
42283330600100,PI,IP,001,1,9248,13578,5062,4330,PERF
42283330610000,PI,IP,001,1,10099,10304,5757,205,PERF
42283330610000,PI,IP,001,2,10374,10579,5757,205,PERF
42283330610000,PI,IP,001,3,10649,10854,5757,205,PERF
42283330610000,PI,IP,001,4,10924,11129,5757,205,PERF
42283330610000,PI,IP,001,5,11199,11404,5757,205,PERF
42283330610000,PI,IP,001,6,11474,11679,5757,205,PERF
42283330610000,PI,IP,001,7,11749,11954,5757,205,PERF
42283330610000,PI,IP,001,8,12024,12228,5757,204,PERF
42283330610000,PI,IP,001,9,12310,12503,5757,193,PERF
42283330610000,PI,IP,001,10,12574,12779,5757,205,PERF
42283330610000,PI,IP,001,11,12860,13045,5757,185,PERF
42283330610000,PI,IP,001,12,13124,13329,5757,205,PERF
42283330610000,PI,IP,001,13,13399,13607,5757,208,PERF
42283330610000,PI,IP,001,14,13674,13879,5757,205,PERF
42283330610000,PI,IP,001,15,14000,14154,5757,154,PERF
42283330610000,PI,IP,001,16,14224,14429,5757,205,PERF
42283330610000,PI,IP,001,17,14449,14704,5757,255,PERF
42283330610000,PI,IP,001,18,14774,14979,5757,205,PERF
42283330610000,PI,IP,001,19,15049,15254,5757,205,PERF
42283330610000,PI,IP,001,20,15324,15529,5757,205,PERF
42283330620000,PI,IP,001,1,7924,14225,6622,6301,PERF
42283330630000,PI,IP,001,1,7942,14401,,6459,PERF
42283330640000,PI,IP,001,1,8600,14378,6986,5778,PERF
42283330690000,PI,IP,001,1,8894,15571,6858,6677,PERF
42283330700000,PI,IP,001,1,9099,12980,5373,3881,PERF
42283330710000,PI,IP,001,1,9273,13725,5121,4452,PERF
42283330720000,PI,IP,001,1,8463,15375,7215,6912,PERF
42283330750000,PI,IP,001,1,7984,15275,,7291,PERF
42283330760000,PI,IP,001,1,10180,15106,5275,4926,PERF
42283330770000,PI,IP,001,1,10245,14671,4752,4426,PERF
42283330780000,PI,IP,001,1,7879,15010,7532,7131,PERF
42283330790000,PI,IP,001,1,7853,14845,7461,6992,PERF
42283330800000,PI,IP,001,1,9447,14452,,5005,PERF
42283330810000,PI,IP,001,1,10425,16891,7172,6466,PERF
42283330820000,PI,IP,001,1,10918,15369,4977,4451,PERF
42283330840000,PI,IP,001,1,8506,12559,4738,4053,PERF
42283330850000,PI,IP,001,1,10216,14649,,4433,PERF
42283330860000,PI,IP,001,1,10157,15513,5793,5356,PERF
42283330870000,PI,IP,001,1,9978,16796,7682,6818,PERF
42283330890000,PI,IP,001,1,8841,9042,7499,201,PERF
42283330890000,PI,IP,001,2,9111,9312,7499,201,PERF
42283330890000,PI,IP,001,3,9381,9582,7499,201,PERF
42283330890000,PI,IP,001,4,9651,9852,7499,201,PERF
42283330890000,PI,IP,001,5,9921,10122,7499,201,PERF
42283330890000,PI,IP,001,6,10191,10392,7499,201,PERF
42283330890000,PI,IP,001,7,10461,10662,7499,201,PERF
42283330890000,PI,IP,001,8,10731,10932,7499,201,PERF
42283330890000,PI,IP,001,9,11001,11202,7499,201,PERF
42283330890000,PI,IP,001,10,11271,11472,7499,201,PERF
42283330890000,PI,IP,001,11,11541,11742,7499,201,PERF
42283330890000,PI,IP,001,12,11811,12012,7499,201,PERF
42283330890000,PI,IP,001,13,12081,12282,7499,201,PERF
42283330890000,PI,IP,001,14,12351,12552,7499,201,PERF
42283330890000,PI,IP,001,15,12621,12822,7499,201,PERF
42283330890000,PI,IP,001,16,12891,13092,7499,201,PERF
42283330890000,PI,IP,001,17,13161,13362,7499,201,PERF
42283330890000,PI,IP,001,18,13431,13632,7499,201,PERF
42283330890000,PI,IP,001,19,13701,13902,7499,201,PERF
42283330890000,PI,IP,001,20,13971,14172,7499,201,PERF
42283330890000,PI,IP,001,21,14241,14442,7499,201,PERF
42283330890000,PI,IP,001,22,14511,14712,7499,201,PERF
42283330890000,PI,IP,001,23,14781,14982,7499,201,PERF
42283330890000,PI,IP,001,24,15051,15252,7499,201,PERF
42283330890000,PI,IP,001,25,15231,15522,7499,291,PERF
42283330890000,PI,IP,001,26,15591,15792,7499,201,PERF
42283330890000,PI,IP,001,27,15861,16062,7499,201,PERF
42283330890000,PI,IP,001,28,16131,16332,7499,201,PERF
42283330900000,PI,IP,001,1,10059,15415,5795,5356,PERF
42283330910000,PI,IP,001,1,9020,9225,6903,205,PERF
42283330910000,PI,IP,001,2,9305,9505,6903,200,PERF
42283330910000,PI,IP,001,3,9590,9799,6903,209,PERF
42283330910000,PI,IP,001,4,9875,10083,6903,208,PERF
42283330910000,PI,IP,001,5,10160,10365,6903,205,PERF
42283330910000,PI,IP,001,6,10445,10650,6903,205,PERF
42283330910000,PI,IP,001,7,10730,10935,6903,205,PERF
42283330910000,PI,IP,001,8,11010,11219,6903,209,PERF
42283330910000,PI,IP,001,9,11300,11504,6903,204,PERF
42283330910000,PI,IP,001,10,11585,11790,6903,205,PERF
42283330910000,PI,IP,001,11,11870,12075,6903,205,PERF
42283330910000,PI,IP,001,12,12155,12360,6903,205,PERF
42283330910000,PI,IP,001,13,12440,12644,6903,204,PERF
42283330910000,PI,IP,001,14,12725,12989,6903,264,PERF
42283330910000,PI,IP,001,15,13010,13210,6903,200,PERF
42283330910000,PI,IP,001,16,13295,13503,6903,208,PERF
42283330910000,PI,IP,001,17,13580,13785,6903,205,PERF
42283330910000,PI,IP,001,18,13866,14070,6903,204,PERF
42283330910000,PI,IP,001,19,14151,14355,6903,204,PERF
42283330910000,PI,IP,001,20,14435,14640,6903,205,PERF
42283330910000,PI,IP,001,21,14720,14925,6903,205,PERF
42283330920000,PI,IP,002,1,8254,13754,,5500,PERF
42283330920000,PI,PT,001,1,13609,13754,,145,PERF
42283330930000,PI,IP,001,1,7664,14902,7417,7238,PERF
42283330940000,PI,IP,001,1,7639,14993,7487,7354,PERF
42283330950000,PI,IP,001,1,9937,16798,7697,6861,PERF
42283330980000,PI,IP,001,1,9807,14663,5440,4856,PERF
42283331000000,PI,IP,001,1,7739,15037,7474,7298,PERF
42283331010000,PI,IP,001,1,7681,14956,7525,7275,PERF
42283331020000,PI,IP,001,1,7787,12478,4865,4691,PERF
42283331030000,PI,IP,001,1,7909,12588,5040,4679,PERF
42283331040000,PI,IP,001,1,8826,9027,6272,201,PERF
42283331040000,PI,IP,001,2,9096,9297,6272,201,PERF
42283331040000,PI,IP,001,3,9366,9567,6272,201,PERF
42283331040000,PI,IP,001,4,9636,9837,6272,201,PERF
42283331040000,PI,IP,001,5,9906,10107,6272,201,PERF
42283331040000,PI,IP,001,6,10176,10377,6272,201,PERF
42283331040000,PI,IP,001,7,10446,10647,6272,201,PERF
42283331040000,PI,IP,001,8,10716,10917,6272,201,PERF
42283331040000,PI,IP,001,9,10986,11187,6272,201,PERF
42283331040000,PI,IP,001,10,11256,11457,6272,201,PERF
42283331040000,PI,IP,001,11,11526,11727,6272,201,PERF
42283331040000,PI,IP,001,12,11796,11997,6272,201,PERF
42283331040000,PI,IP,001,13,12066,12267,6272,201,PERF
42283331040000,PI,IP,001,14,12336,12537,6272,201,PERF
42283331040000,PI,IP,001,15,12606,12807,6272,201,PERF
42283331040000,PI,IP,001,16,12876,13077,6272,201,PERF
42283331040000,PI,IP,001,17,13146,13347,6272,201,PERF
42283331040000,PI,IP,001,18,13416,13617,6272,201,PERF
42283331040000,PI,IP,001,19,13686,13887,6272,201,PERF
42283331040000,PI,IP,001,20,13956,14157,6272,201,PERF
42283331040000,PI,IP,001,21,14266,14427,6272,161,PERF
42283331040000,PI,IP,001,22,14496,14697,6272,201,PERF
42283331060000,PI,PT,001,1,,,,,PERF
42283331070000,PI,IP,001,1,9191,14159,5494,4968,PERF
42283331080000,PI,IP,001,1,9400,13972,4982,4572,PERF
42283331090000,PI,IP,001,1,9864,16724,7350,6860,PERF
42283331120000,PI,IP,001,1,7760,12353,4823,4593,PERF
42283331190000,PI,IP,001,1,7743,14978,7546,7235,PERF
42283331210000,PI,IP,001,1,10083,15306,5537,5223,PERF
42283331240000,PI,IP,001,1,7952,15279,7664,7327,PERF
42283331280000,PI,IP,001,1,9842,14591,5307,4749,PERF
42283331290000,PI,IP,001,1,10551,14638,5008,4087,PERF
42283331310000,PI,IP,001,1,9180,15469,6952,6289,PERF
42283331320000,PI,PT,001,1,,,,,PERF
42283331330000,PI,IP,001,1,9087,16044,7715,6957,PERF
42283331340000,PI,IP,001,1,7601,12398,5008,4797,PERF
42283331350000,PI,IP,001,1,7588,12376,5033,4788,PERF
42283331360000,PI,IP,001,1,9631,14112,4680,4481,PERF
42283331380000,PI,IP,001,1,8707,13345,4945,4638,PERF
42283331390000,PI,IP,001,1,9884,16427,7044,6543,PERF
42283331410000,PI,IP,001,1,9888,16377,7081,6489,PERF
42283331420000,PI,IP,001,1,9680,13979,4837,4299,PERF
42283331430000,PI,IP,001,1,9893,16492,7083,6599,PERF
42283331450000,PI,IP,001,1,7794,15169,7677,7375,PERF
42283331460000,PI,IP,001,1,7960,12537,4952,4577,PERF
42283331470000,PI,IP,001,1,8522,8722,5722,200,PERF
42283331470000,PI,IP,001,2,8807,9011,5722,204,PERF
42283331470000,PI,IP,001,3,9092,9297,5722,205,PERF
42283331470000,PI,IP,001,4,9382,9582,5722,200,PERF
42283331470000,PI,IP,001,5,9662,9867,5722,205,PERF
42283331470000,PI,IP,001,6,9947,10152,5722,205,PERF
42283331470000,PI,IP,001,7,10232,10439,5722,207,PERF
42283331470000,PI,IP,001,8,10517,10722,5722,205,PERF
42283331470000,PI,IP,001,9,10807,11007,5722,200,PERF
42283331470000,PI,IP,001,10,11087,11292,5722,205,PERF
42283331470000,PI,IP,001,11,11371,11577,5722,206,PERF
42283331470000,PI,IP,001,12,11657,11862,5722,205,PERF
42283331470000,PI,IP,001,13,11942,12147,5722,205,PERF
42283331470000,PI,IP,001,14,12227,12432,5722,205,PERF
42283331470000,PI,IP,001,15,12517,12717,5722,200,PERF
42283331470000,PI,IP,001,16,12797,13002,5722,205,PERF
42283331470000,PI,IP,001,17,13082,13287,5722,205,PERF
42283331500000,PI,IP,001,1,9878,14770,5444,4892,PERF
42283331510000,PI,IP,001,1,9859,14829,5330,4970,PERF
42283331530000,PI,IP,001,1,9821,15170,6130,5349,PERF
42283331540000,PI,IP,001,1,8355,15952,,7597,PERF
42283331550000,PI,IP,001,1,9441,14537,5505,5096,PERF
42283331560000,PI,IP,001,1,9981,15944,6727,5963,PERF
42283331580000,PI,IP,001,1,9951,15601,6470,5650,PERF
42283331610000,PI,IP,001,1,8400,8605,5729,205,PERF
42283331610000,PI,IP,001,2,8684,8889,5729,205,PERF
42283331610000,PI,IP,001,3,8968,9173,5729,205,PERF
42283331610000,PI,IP,001,4,9252,9457,5729,205,PERF
42283331610000,PI,IP,001,5,9536,9741,5729,205,PERF
42283331610000,PI,IP,001,6,9820,10025,5729,205,PERF
42283331610000,PI,IP,001,7,10104,10309,5729,205,PERF
42283331610000,PI,IP,001,8,10388,10593,5729,205,PERF
42283331610000,PI,IP,001,9,10672,10877,5729,205,PERF
42283331610000,PI,IP,001,10,10956,11157,5729,201,PERF
42283331610000,PI,IP,001,11,11240,11445,5729,205,PERF
42283331610000,PI,IP,001,12,11524,11729,5729,205,PERF
42283331610000,PI,IP,001,13,11806,12013,5729,207,PERF
42283331610000,PI,IP,001,14,12102,12297,5729,195,PERF
42283331610000,PI,IP,001,15,12376,12581,5729,205,PERF
42283331640000,PI,IP,001,1,10231,16129,6277,5898,PERF
42283331650100,PI,IP,001,1,10207,15934,6335,5727,PERF
42283331660000,PI,IP,001,1,10148,15731,6081,5583,PERF
42283331670000,PI,IP,001,1,8040,15423,7756,7383,PERF
42283331680000,PI,IP,001,1,9964,16082,6781,6118,PERF
42283331690000,PI,IP,001,1,7940,14144,6691,6204,PERF
42283331700000,PI,IP,001,1,8716,8917,7083,201,PERF
42283331700000,PI,IP,001,2,8986,9187,7083,201,PERF
42283331700000,PI,IP,001,3,9256,9457,7083,201,PERF
42283331700000,PI,IP,001,4,9526,9727,7083,201,PERF
42283331700000,PI,IP,001,5,9796,9997,7083,201,PERF
42283331700000,PI,IP,001,6,10066,10267,7083,201,PERF
42283331700000,PI,IP,001,7,10336,10537,7083,201,PERF
42283331700000,PI,IP,001,8,10606,10807,7083,201,PERF
42283331700000,PI,IP,001,9,10876,11077,7083,201,PERF
42283331700000,PI,IP,001,10,11146,11347,7083,201,PERF
42283331700000,PI,IP,001,11,11416,11617,7083,201,PERF
42283331700000,PI,IP,001,12,11686,11887,7083,201,PERF
42283331700000,PI,IP,001,13,11956,12157,7083,201,PERF
42283331700000,PI,IP,001,14,12226,12427,7083,201,PERF
42283331700000,PI,IP,001,15,12496,12697,7083,201,PERF
42283331700000,PI,IP,001,16,12766,12967,7083,201,PERF
42283331700000,PI,IP,001,17,13036,13237,7083,201,PERF
42283331700000,PI,IP,001,18,13306,13507,7083,201,PERF
42283331700000,PI,IP,001,19,13576,13777,7083,201,PERF
42283331700000,PI,IP,001,20,13846,14047,7083,201,PERF
42283331700000,PI,IP,001,21,14116,14317,7083,201,PERF
42283331700000,PI,IP,001,22,14386,14587,7083,201,PERF
42283331700000,PI,IP,001,23,14656,14857,7083,201,PERF
42283331700000,PI,IP,001,24,14926,15127,7083,201,PERF
42283331730000,PI,IP,001,1,10628,15335,5408,4707,PERF
42283331740000,PI,IP,001,1,8162,13857,,5695,PERF
42283331750000,PI,IP,001,1,9257,15692,7162,6435,PERF
42283331830000,PI,IP,001,1,8796,14667,6906,5871,PERF
42283331910000,PI,IP,001,1,10422,14668,5029,4246,PERF
42283331940000,PI,IP,001,1,8950,15365,7218,6415,PERF
42283331950000,PI,IP,001,1,8365,15530,7893,7165,PERF
42283331960000,PI,IP,001,1,8590,16741,8009,8151,PERF
42283331970000,PI,IP,001,1,8460,12861,4991,4401,PERF
42283331980000,PI,IP,001,1,9225,15006,6555,5781,PERF
42283331990000,PI,IP,001,1,8581,13325,5459,4744,PERF
42283332000000,PI,IP,001,1,8385,12985,5021,4600,PERF
42283332010000,PI,IP,001,1,7964,8179,4888,215,PERF
42283332010000,PI,IP,001,2,8256,8461,4888,205,PERF
42283332010000,PI,IP,001,3,8538,8743,4888,205,PERF
42283332010000,PI,IP,001,4,8820,9025,4888,205,PERF
42283332010000,PI,IP,001,5,9092,9307,4888,215,PERF
42283332010000,PI,IP,001,6,9384,9589,4888,205,PERF
42283332010000,PI,IP,001,7,9666,9871,4888,205,PERF
42283332010000,PI,IP,001,8,9948,10153,4888,205,PERF
42283332010000,PI,IP,001,9,10230,10421,4888,191,PERF
42283332010000,PI,IP,001,10,10512,10717,4888,205,PERF
42283332010000,PI,IP,001,11,10794,10999,4888,205,PERF
42283332010000,PI,IP,001,12,11076,11281,4888,205,PERF
42283332010000,PI,IP,001,13,11358,11563,4888,205,PERF
42283332010000,PI,IP,001,14,11641,11845,4888,204,PERF
42283332010000,PI,IP,001,15,11922,12127,4888,205,PERF
42283332050000,PI,IP,001,1,9473,14033,4889,4560,PERF
42283332080000,PI,IP,001,1,9609,14591,5535,4982,PERF
42283332090000,PI,IP,001,1,9620,14640,5260,5020,PERF
42283332100000,PI,IP,001,1,9085,13837,5122,4752,PERF
42283332120000,PI,IP,001,1,11455,17875,,6420,PERF
42283332150000,PI,IP,001,1,10220,17569,8174,7349,PERF
42283332170000,PI,IP,001,1,9470,14014,4950,4544,PERF
42283332180000,PI,IP,001,1,10317,15271,5592,4954,PERF
42283332200000,PI,IP,001,1,9439,16694,7657,7255,PERF
42283332240000,PI,IP,001,1,10462,15082,5035,4620,PERF
42283332250000,PI,IP,001,1,10004,15423,5727,5419,PERF
42283332270000,PI,IP,001,1,10034,15376,5711,5342,PERF
42283332280000,PI,IP,001,1,10014,15384,5733,5370,PERF
42283332310000,PI,IP,001,1,10409,17660,7575,7251,PERF
42283332320000,PI,IP,001,1,8952,15363,6972,6411,PERF
42283332350000,PI,IP,001,1,9130,13315,4927,4185,PERF
42283332360000,PI,IP,001,1,9358,15847,7285,6489,PERF
42283332400000,PI,IP,001,1,9000,15473,7067,6473,PERF
42283332430000,PI,IP,001,1,9570,16155,7111,6585,PERF
42283332450000,PI,IP,001,1,8239,8389,6258,150,PERF
42283332450000,PI,IP,001,2,8468,8677,6258,209,PERF
42283332450000,PI,IP,001,3,8748,8957,6258,209,PERF
42283332450000,PI,IP,001,4,9028,9237,6258,209,PERF
42283332450000,PI,IP,001,5,9308,9517,6258,209,PERF
42283332450000,PI,IP,001,6,9588,9789,6258,201,PERF
42283332450000,PI,IP,001,7,9868,10067,6258,199,PERF
42283332450000,PI,IP,001,8,10148,10348,6258,200,PERF
42283332450000,PI,IP,001,9,10428,10629,6258,201,PERF
42283332450000,PI,IP,001,10,10708,10913,6258,205,PERF
42283332450000,PI,IP,001,11,10988,11191,6258,203,PERF
42283332450000,PI,IP,001,12,11268,11473,6258,205,PERF
42283332450000,PI,IP,001,13,11548,11753,6258,205,PERF
42283332450000,PI,IP,001,14,11828,12033,6258,205,PERF
42283332450000,PI,IP,001,15,12103,12313,6258,210,PERF
42283332450000,PI,IP,001,16,12388,12593,6258,205,PERF
42283332450000,PI,IP,001,17,12668,12873,6258,205,PERF
42283332500000,PI,IP,001,1,9986,17083,,7097,PERF
42283332510000,PI,IP,001,1,8681,16947,8886,8266,PERF
42283332560000,PI,PT,001,1,,,,,PERF
42283332570000,PI,IP,001,1,8260,16387,8559,8127,PERF
42283332580000,PI,IP,001,1,8350,16626,8871,8276,PERF
42283332620000,PI,IP,001,1,9620,14453,,4833,PERF
42283332630000,PI,IP,001,1,9578,15153,,5575,PERF
42283332660000,PI,IP,001,1,9755,17491,8545,7736,PERF
42283332680000,PI,IP,001,1,9131,13908,5143,4777,PERF
42283332690000,PI,IP,001,1,9089,9330,5611,241,PERF
42283332690000,PI,IP,001,2,9399,9640,5611,241,PERF
42283332690000,PI,IP,001,3,9709,9950,5611,241,PERF
42283332690000,PI,IP,001,4,10019,10260,5611,241,PERF
42283332690000,PI,IP,001,5,10329,10560,5611,231,PERF
42283332690000,PI,IP,001,6,10629,10870,5611,241,PERF
42283332690000,PI,IP,001,7,10939,11180,5611,241,PERF
42283332690000,PI,IP,001,8,11249,11490,5611,241,PERF
42283332690000,PI,IP,001,9,11559,11800,5611,241,PERF
42283332690000,PI,IP,001,10,11869,12110,5611,241,PERF
42283332690000,PI,IP,001,11,12179,12420,5611,241,PERF
42283332690000,PI,IP,001,12,12489,12730,5611,241,PERF
42283332690000,PI,IP,001,13,12799,13040,5611,241,PERF
42283332690000,PI,IP,001,14,13109,13350,5611,241,PERF
42283332690000,PI,IP,001,15,13419,13660,5611,241,PERF
42283332690000,PI,IP,001,16,13729,13970,5611,241,PERF
42283332690000,PI,IP,001,17,14079,14280,5611,201,PERF
42283332700000,PI,IP,001,1,8749,8950,6797,201,PERF
42283332700000,PI,IP,001,2,9009,9210,6797,201,PERF
42283332700000,PI,IP,001,3,9269,9470,6797,201,PERF
42283332700000,PI,IP,001,4,9529,9730,6797,201,PERF
42283332700000,PI,IP,001,5,9799,10000,6797,201,PERF
42283332700000,PI,IP,001,6,10069,10270,6797,201,PERF
42283332700000,PI,IP,001,7,10339,10540,6797,201,PERF
42283332700000,PI,IP,001,8,10609,10810,6797,201,PERF
42283332700000,PI,IP,001,9,10879,11080,6797,201,PERF
42283332700000,PI,IP,001,10,11149,11350,6797,201,PERF
42283332700000,PI,IP,001,11,11419,11620,6797,201,PERF
42283332700000,PI,IP,001,12,11689,11890,6797,201,PERF
42283332700000,PI,IP,001,13,11959,12160,6797,201,PERF
42283332700000,PI,IP,001,14,12229,12430,6797,201,PERF
42283332700000,PI,IP,001,15,12499,12700,6797,201,PERF
42283332700000,PI,IP,001,16,12769,12970,6797,201,PERF
42283332700000,PI,IP,001,17,13039,13240,6797,201,PERF
42283332700000,PI,IP,001,18,13309,13510,6797,201,PERF
42283332700000,PI,IP,001,19,13579,13780,6797,201,PERF
42283332700000,PI,IP,001,20,13849,14050,6797,201,PERF
42283332700000,PI,IP,001,21,14119,14320,6797,201,PERF
42283332700000,PI,IP,001,22,14389,14590,6797,201,PERF
42283332700000,PI,IP,001,23,14659,14860,6797,201,PERF
42283332700000,PI,IP,001,24,14929,15130,6797,201,PERF
42283332700000,PI,IP,001,25,15199,15400,6797,201,PERF
42283332720000,PI,IP,001,1,9100,9301,6394,201,PERF
42283332720000,PI,IP,001,2,9370,9571,6394,201,PERF
42283332720000,PI,IP,001,3,9640,9841,6394,201,PERF
42283332720000,PI,IP,001,4,9910,10111,6394,201,PERF
42283332720000,PI,IP,001,5,10180,10381,6394,201,PERF
42283332720000,PI,IP,001,6,10450,10651,6394,201,PERF
42283332720000,PI,IP,001,7,10720,10921,6394,201,PERF
42283332720000,PI,IP,001,8,10990,11191,6394,201,PERF
42283332720000,PI,IP,001,9,11260,11461,6394,201,PERF
42283332720000,PI,IP,001,10,11530,11731,6394,201,PERF
42283332720000,PI,IP,001,11,11800,12001,6394,201,PERF
42283332720000,PI,IP,001,12,12070,12271,6394,201,PERF
42283332720000,PI,IP,001,13,12340,12541,6394,201,PERF
42283332720000,PI,IP,001,14,12610,12811,6394,201,PERF
42283332720000,PI,IP,001,15,12880,13081,6394,201,PERF
42283332720000,PI,IP,001,16,13150,13351,6394,201,PERF
42283332720000,PI,IP,001,17,13420,13621,6394,201,PERF
42283332720000,PI,IP,001,18,13690,13891,6394,201,PERF
42283332720000,PI,IP,001,19,13960,14161,6394,201,PERF
42283332720000,PI,IP,001,20,14230,14431,6394,201,PERF
42283332720000,PI,IP,001,21,14500,14701,6394,201,PERF
42283332720000,PI,IP,001,22,14770,14971,6394,201,PERF
42283332720000,PI,IP,001,23,15040,15241,6394,201,PERF
42283332730000,PI,IP,001,1,7508,12292,4971,4784,PERF
42283332750000,PI,IP,001,1,9018,9256,7596,238,PERF
42283332750000,PI,IP,001,2,9334,9572,7596,238,PERF
42283332750000,PI,IP,001,3,9650,9888,7596,238,PERF
42283332750000,PI,IP,001,4,9966,10204,7596,238,PERF
42283332750000,PI,IP,001,5,10282,10520,7596,238,PERF
42283332750000,PI,IP,001,6,10598,10836,7596,238,PERF
42283332750000,PI,IP,001,7,10914,11152,7596,238,PERF
42283332750000,PI,IP,001,8,11230,11468,7596,238,PERF
42283332750000,PI,IP,001,9,11546,11784,7596,238,PERF
42283332750000,PI,IP,001,10,11862,12100,7596,238,PERF
42283332750000,PI,IP,001,11,12178,12416,7596,238,PERF
42283332750000,PI,IP,001,12,12494,12732,7596,238,PERF
42283332750000,PI,IP,001,13,12810,13048,7596,238,PERF
42283332750000,PI,IP,001,14,13126,13364,7596,238,PERF
42283332750000,PI,IP,001,15,13442,13680,7596,238,PERF
42283332750000,PI,IP,001,16,13758,13996,7596,238,PERF
42283332750000,PI,IP,001,17,14074,14312,7596,238,PERF
42283332750000,PI,IP,001,18,14390,14628,7596,238,PERF
42283332750000,PI,IP,001,19,14706,14945,7596,239,PERF
42283332750000,PI,IP,001,20,15022,15260,7596,238,PERF
42283332750000,PI,IP,001,21,15338,15576,7596,238,PERF
42283332750000,PI,IP,001,22,15725,15735,7596,10,PERF
42283332770000,PI,IP,001,1,11685,16947,5960,5262,PERF
42283332820000,PI,IP,001,1,9806,16866,7450,7060,PERF
42283332860000,PI,IP,001,1,10254,16360,7495,6106,PERF
42283332870000,PI,IP,001,1,8654,12896,5436,4242,PERF
42283332880000,PI,IP,001,1,8133,12649,5246,4516,PERF
42283332890000,PI,IP,001,1,8777,16328,8043,7551,PERF
42283332900000,PI,IP,001,1,8767,15932,7672,7165,PERF
42283332910000,PI,IP,001,1,10063,16582,7527,6519,PERF
42283332940000,PI,IP,001,1,9855,14971,5904,5116,PERF
42283333010000,PI,IP,001,1,9577,14397,5183,4820,PERF
42283333020000,PI,IP,001,1,10293,17674,7600,7381,PERF
42283333060000,PI,IP,001,1,8821,16630,8163,7809,PERF
42283333140000,PI,IP,001,1,10504,15185,5179,4681,PERF
42283333150000,PI,IP,001,1,9865,15557,,5692,PERF
42283333170000,PI,IP,001,1,10057,15939,6412,5882,PERF
42283333190000,PI,IP,001,1,10122,16550,7489,6428,PERF
42283333210000,PI,IP,001,1,9579,14464,5310,4885,PERF
42283333220000,PI,IP,001,1,9855,16054,,6199,PERF
42283333260000,PI,IP,001,1,8941,13869,,4928,PERF
42283333310000,PI,IP,001,1,9105,13464,5125,4359,PERF
42283333330000,PI,PT,001,1,,,,,PERF
42283333360000,PI,IP,001,1,8988,13383,,4395,PERF
42283333370000,PI,IP,001,1,7810,13440,6642,5630,PERF
42283333380000,PI,IP,001,1,7678,15127,7532,7449,PERF
42283333390000,PI,IP,001,1,9754,14247,4903,4493,PERF
42283333410000,PI,IP,001,1,9094,13090,4069,3996,PERF
42283333420000,PI,IP,001,1,8910,14406,6273,5496,PERF
42283333430000,PI,IP,001,1,7696,14214,6831,6518,PERF
42283333480000,PI,IP,001,1,9522,15040,,5518,PERF
42283333490000,PI,IP,001,1,8824,13779,6218,4955,PERF
42283333500000,PI,IP,001,1,8211,14876,7063,6665,PERF
42283333520000,PI,IP,001,1,8491,8696,6606,205,PERF
42283333520000,PI,IP,001,2,8773,8978,6606,205,PERF
42283333520000,PI,IP,001,3,9055,9260,6606,205,PERF
42283333520000,PI,IP,001,4,9338,9542,6606,204,PERF
42283333520000,PI,IP,001,5,9619,9824,6606,205,PERF
42283333520000,PI,IP,001,6,9901,10106,6606,205,PERF
42283333520000,PI,IP,001,7,10183,10388,6606,205,PERF
42283333520000,PI,IP,001,8,10465,10670,6606,205,PERF
42283333520000,PI,IP,001,9,10747,10952,6606,205,PERF
42283333520000,PI,IP,001,10,11029,11231,6606,202,PERF
42283333520000,PI,IP,001,11,11311,11511,6606,200,PERF
42283333520000,PI,IP,001,12,11593,11795,6606,202,PERF
42283333520000,PI,IP,001,13,11875,12080,6606,205,PERF
42283333520000,PI,IP,001,14,12157,12362,6606,205,PERF
42283333520000,PI,IP,001,15,12442,12644,6606,202,PERF
42283333520000,PI,IP,001,16,12721,12926,6606,205,PERF
42283333520000,PI,IP,001,17,13003,13208,6606,205,PERF
42283333520000,PI,IP,001,18,13285,13490,6606,205,PERF
42283333520000,PI,IP,001,19,13567,13772,6606,205,PERF
42283333520000,PI,IP,001,20,13849,14003,6606,154,PERF
42283333520000,PI,IP,001,21,14131,14132,6606,1,PERF
42283333530000,PI,IP,001,1,8304,15443,,7139,PERF
42283333580000,PI,IP,001,1,8174,15253,7359,7079,PERF
42283333640000,PI,IP,001,1,9306,14830,5681,5524,PERF
42283333650000,PI,IP,001,1,11018,15828,5122,4810,PERF
42283333730000,PI,IP,001,1,11400,17812,7046,6412,PERF
42283333780000,PI,IP,001,1,9581,14489,5246,4908,PERF
42283333840000,PI,IP,001,1,8563,13916,5733,5353,PERF
42283333870000,PI,IP,001,1,11153,16494,6472,5341,PERF
42283333880000,PI,IP,001,1,10873,16153,6012,5280,PERF
42283333890000,PI,IP,001,1,9857,14802,,4945,PERF
42283333940000,PI,IP,001,1,9593,13473,4410,3880,PERF
42283333950000,PI,IP,001,1,8485,8690,6672,205,PERF
42283333950000,PI,IP,001,2,8971,8977,6672,6,PERF
42283333950000,PI,IP,001,3,9059,9264,6672,205,PERF
42283333950000,PI,IP,001,4,9346,9551,6672,205,PERF
42283333950000,PI,IP,001,5,9637,9838,6672,201,PERF
42283333950000,PI,IP,001,6,9920,10125,6672,205,PERF
42283333950000,PI,IP,001,7,10207,10412,6672,205,PERF
42283333950000,PI,IP,001,8,10494,10699,6672,205,PERF
42283333950000,PI,IP,001,9,10781,10986,6672,205,PERF
42283333950000,PI,IP,001,10,11068,11271,6672,203,PERF
42283333950000,PI,IP,001,11,11355,11560,6672,205,PERF
42283333950000,PI,IP,001,12,11646,11847,6672,201,PERF
42283333950000,PI,IP,001,13,11929,12134,6672,205,PERF
42283333950000,PI,IP,001,14,12216,12417,6672,201,PERF
42283333950000,PI,IP,001,15,12503,12708,6672,205,PERF
42283333950000,PI,IP,001,16,12795,12995,6672,200,PERF
42283333950000,PI,IP,001,17,13077,13282,6672,205,PERF
42283333950000,PI,IP,001,18,13364,13569,6672,205,PERF
42283333950000,PI,IP,001,19,13651,13856,6672,205,PERF
42283333950000,PI,IP,001,20,13938,14136,6672,198,PERF
42283333950000,PI,IP,001,21,14225,14226,6672,1,PERF
42283333990000,PI,IP,001,1,9507,13843,5232,4336,PERF
42283334000000,PI,PT,001,1,,,,,PERF
42283334030000,PI,IP,001,1,9795,15835,6624,6040,PERF
42283334040000,PI,IP,001,1,9720,15438,6586,5718,PERF
42283334110000,PI,IP,001,1,7361,13865,,6504,PERF
42283334120000,PI,IP,001,1,8377,8531,5579,154,PERF
42283334120000,PI,IP,001,2,8880,9085,5579,205,PERF
42283334120000,PI,IP,001,3,9166,9371,5579,205,PERF
42283334120000,PI,IP,001,4,9452,9657,5579,205,PERF
42283334120000,PI,IP,001,5,9738,9943,5579,205,PERF
42283334120000,PI,IP,001,6,10020,10229,5579,209,PERF
42283334120000,PI,IP,001,7,10310,10515,5579,205,PERF
42283334120000,PI,IP,001,8,10596,10801,5579,205,PERF
42283334120000,PI,IP,001,9,10882,11083,5579,201,PERF
42283334120000,PI,IP,001,10,11168,11373,5579,205,PERF
42283334120000,PI,IP,001,11,11454,11659,5579,205,PERF
42283334120000,PI,IP,001,12,11740,11948,5579,208,PERF
42283334120000,PI,IP,001,13,12026,12231,5579,205,PERF
42283334120000,PI,IP,001,14,12312,12517,5579,205,PERF
42283334120000,PI,IP,001,15,12598,12803,5579,205,PERF
42283334120000,PI,IP,001,16,12884,12885,5579,1,PERF
42283334160000,PI,IP,001,1,10234,14529,4725,4295,PERF
42283334230000,PI,IP,001,1,9289,18058,,8769,PERF
42283334250000,PI,IP,001,1,9789,17423,8525,7634,PERF
42283334260000,PI,IP,001,1,9822,17562,8520,7740,PERF
42283334270000,PI,IP,001,1,9865,15784,6717,5919,PERF
42283334280000,PI,IP,001,1,9927,15819,6700,5892,PERF
42283334300100,PI,IP,001,1,10159,15404,5564,5245,PERF
42283334330000,PI,IP,001,1,8146,14845,7404,6699,PERF
42283334360000,PI,IP,001,1,8815,15063,,6248,PERF
42283334430000,PI,IP,001,1,8767,8971,5674,204,PERF
42283334430000,PI,IP,001,2,9068,9272,5674,204,PERF
42283334430000,PI,IP,001,3,9369,9573,5674,204,PERF
42283334430000,PI,IP,001,4,9671,9875,5674,204,PERF
42283334430000,PI,IP,001,5,9972,10176,5674,204,PERF
42283334430000,PI,IP,001,6,10274,10477,5674,203,PERF
42283334430000,PI,IP,001,7,10574,10780,5674,206,PERF
42283334430000,PI,IP,001,8,10877,11080,5674,203,PERF
42283334430000,PI,IP,001,9,11177,11385,5674,208,PERF
42283334430000,PI,IP,001,10,11484,11691,5674,207,PERF
42283334430000,PI,IP,001,11,11786,11936,5674,150,PERF
42283334430000,PI,IP,001,12,12030,12235,5674,205,PERF
42283334430000,PI,IP,001,13,12325,12514,5674,189,PERF
42283334430000,PI,IP,001,14,12608,12804,5674,196,PERF
42283334430000,PI,IP,001,15,12898,13087,5674,189,PERF
42283334510000,PI,IP,001,1,8286,12744,5733,4458,PERF
42283334520000,PI,IP,001,1,8272,12732,4662,4460,PERF
42283334560000,PI,IP,001,1,8260,12738,4689,4478,PERF
42283334580000,PI,IP,001,1,9627,15327,6358,5700,PERF
42283334590000,PI,IP,001,1,10124,10395,5727,271,PERF
42283334590000,PI,IP,001,2,10464,10735,5727,271,PERF
42283334590000,PI,IP,001,3,10804,11075,5727,271,PERF
42283334590000,PI,IP,001,4,11144,11415,5727,271,PERF
42283334590000,PI,IP,001,5,11803,12074,5727,271,PERF
42283334590000,PI,IP,001,6,12144,12415,5727,271,PERF
42283334590000,PI,IP,001,7,12485,12756,5727,271,PERF
42283334590000,PI,IP,001,8,12826,13097,5727,271,PERF
42283334590000,PI,IP,001,9,13167,13438,5727,271,PERF
42283334590000,PI,IP,001,10,13508,13779,5727,271,PERF
42283334590000,PI,IP,001,11,13849,14120,5727,271,PERF
42283334590000,PI,IP,001,12,14190,14461,5727,271,PERF
42283334590000,PI,IP,001,13,14531,14802,5727,271,PERF
42283334590000,PI,IP,001,14,14872,15143,5727,271,PERF
42283334610000,PI,IP,001,1,8830,13157,,4327,PERF
42283334740000,PI,IP,001,1,8702,8907,6525,205,PERF
42283334740000,PI,IP,001,2,8986,9191,6525,205,PERF
42283334740000,PI,IP,001,3,9270,9474,6525,204,PERF
42283334740000,PI,IP,001,4,9554,9758,6525,204,PERF
42283334740000,PI,IP,001,5,9838,10042,6525,204,PERF
42283334740000,PI,IP,001,6,10122,10321,6525,199,PERF
42283334740000,PI,IP,001,7,10406,10604,6525,198,PERF
42283334740000,PI,IP,001,8,10690,10895,6525,205,PERF
42283334740000,PI,IP,001,9,10974,11178,6525,204,PERF
42283334740000,PI,IP,001,10,11252,11462,6525,210,PERF
42283334740000,PI,IP,001,11,11542,11746,6525,204,PERF
42283334740000,PI,IP,001,12,11826,12031,6525,205,PERF
42283334740000,PI,IP,001,13,12110,12315,6525,205,PERF
42283334740000,PI,IP,001,14,12394,12599,6525,205,PERF
42283334740000,PI,IP,001,15,12678,12882,6525,204,PERF
42283334740000,PI,IP,001,16,12962,13166,6525,204,PERF
42283334740000,PI,IP,001,17,13246,13448,6525,202,PERF
42283334740000,PI,IP,001,18,13530,13727,6525,197,PERF
42283334740000,PI,IP,001,19,13814,14021,6525,207,PERF
42283334740000,PI,IP,001,20,14098,14302,6525,204,PERF
42283334740000,PI,IP,001,21,14382,14587,6525,205,PERF
42283334740000,PI,IP,001,22,14666,14871,6525,205,PERF
42283334880000,PI,IP,001,1,8287,13086,5043,4799,PERF
42283334920000,PI,IP,001,1,10131,16873,7587,6742,PERF
42283335080000,PI,IP,001,1,9155,15867,7327,6712,PERF
42283335150000,PI,IP,001,1,8155,14683,7128,6528,PERF
42283335160000,PI,IP,001,1,8410,8612,5175,202,PERF
42283335160000,PI,IP,001,2,8694,8902,5175,208,PERF
42283335160000,PI,IP,001,3,8991,9182,5175,191,PERF
42283335160000,PI,IP,001,4,9262,9467,5175,205,PERF
42283335160000,PI,IP,001,5,9548,9751,5175,203,PERF
42283335160000,PI,IP,001,6,9830,10035,5175,205,PERF
42283335160000,PI,IP,001,7,10114,10319,5175,205,PERF
42283335160000,PI,IP,001,8,10398,10603,5175,205,PERF
42283335160000,PI,IP,001,9,10682,10890,5175,208,PERF
42283335160000,PI,IP,001,10,10966,11171,5175,205,PERF
42283335160000,PI,IP,001,11,11250,11455,5175,205,PERF
42283335160000,PI,IP,001,12,11534,11739,5175,205,PERF
42283335160000,PI,IP,001,13,11815,12023,5175,208,PERF
42283335160000,PI,IP,001,14,12102,12307,5175,205,PERF
42283335160000,PI,IP,001,15,12386,12590,5175,204,PERF
42283335160000,PI,IP,001,16,12670,12875,5175,205,PERF
42283335210000,PI,IP,001,1,9010,13646,4980,4636,PERF
42283335290000,PI,IP,001,1,8915,13654,4944,4739,PERF
42283335300000,PI,IP,001,1,8797,13999,5762,5202,PERF
42283335310000,PI,IP,001,1,8265,14749,6795,6484,PERF
42283335340000,PI,IP,001,1,9363,15113,6128,5750,PERF
42283335420000,PI,IP,001,1,9653,15304,6199,5651,PERF
42283335480000,PI,IP,001,1,8790,8988,,198,PERF
42283335480000,PI,IP,001,2,9062,9267,,205,PERF
42283335480000,PI,IP,001,3,9341,9546,,205,PERF
42283335480000,PI,IP,001,4,9620,9825,,205,PERF
42283335480000,PI,IP,001,5,9899,10104,,205,PERF
42283335480000,PI,IP,001,6,10178,10383,,205,PERF
42283335480000,PI,IP,001,7,10457,10662,,205,PERF
42283335480000,PI,IP,001,8,10736,10941,,205,PERF
42283335480000,PI,IP,001,9,11015,11220,,205,PERF
42283335480000,PI,IP,001,10,11394,11499,,105,PERF
42283335480000,PI,IP,001,11,11573,11770,,197,PERF
42283335480000,PI,IP,001,12,11852,12051,,199,PERF
42283335480000,PI,IP,001,13,12131,12331,,200,PERF
42283335480000,PI,IP,001,14,12410,12615,,205,PERF
42283335480000,PI,IP,001,15,12689,12894,,205,PERF
42283335570000,PI,IP,001,1,8624,14443,6380,5819,PERF
42283335580000,PI,IP,001,1,8564,15030,6801,6466,PERF
42283335590000,PI,IP,001,1,8560,14573,6334,6013,PERF
42283335680000,PI,IP,001,1,8570,14484,6214,5914,PERF
42283335710000,PI,IP,001,1,9169,15579,6940,6410,PERF
42283335730000,PI,IP,001,1,8266,14477,6723,6211,PERF
42283335740000,PI,IP,001,1,9274,13091,4958,3817,PERF
42283335770000,PI,IP,001,1,8940,9301,7885,361,PERF
42283335770000,PI,IP,001,2,9354,9715,7885,361,PERF
42283335770000,PI,IP,001,3,9768,10129,7885,361,PERF
42283335770000,PI,IP,001,4,10182,10543,7885,361,PERF
42283335770000,PI,IP,001,5,10596,10957,7885,361,PERF
42283335770000,PI,IP,001,6,11010,11371,7885,361,PERF
42283335770000,PI,IP,001,7,11424,11785,7885,361,PERF
42283335770000,PI,IP,001,8,11838,12199,7885,361,PERF
42283335770000,PI,IP,001,9,12252,12613,7885,361,PERF
42283335770000,PI,IP,001,10,12667,13027,7885,360,PERF
42283335770000,PI,IP,001,11,13080,13441,7885,361,PERF
42283335770000,PI,IP,001,12,13494,13855,7885,361,PERF
42283335770000,PI,IP,001,13,13908,14269,7885,361,PERF
42283335770000,PI,IP,001,14,14322,14683,7885,361,PERF
42283335770000,PI,IP,001,15,14736,15097,7885,361,PERF
42283335770000,PI,IP,001,16,15150,15511,7885,361,PERF
42283335770000,PI,IP,001,17,15564,15925,7885,361,PERF
42283335770000,PI,IP,001,18,15978,16339,7885,361,PERF
42285335850000,PI,IP,001,1,12237,16387,4613,4150,PERF
42285335850000,PI,PT,001,1,12237,15897,4613,3660,PERF
42285335850000,PI,PT,001,2,15973,16208,4613,235,PERF
42285335850000,PI,PT,001,3,16387,16387,4613,0,PERF
42285335880100,PI,IP,001,1,13690,13932,4539,242,PERF
42285335880100,PI,IP,001,2,14010,14252,4539,242,PERF
42285335880100,PI,IP,001,3,14330,14572,4539,242,PERF
42285335880100,PI,IP,001,4,14650,14892,4539,242,PERF
42285335880100,PI,IP,001,5,14970,15212,4539,242,PERF
42285335880100,PI,IP,001,6,15290,15532,4539,242,PERF
42285335880100,PI,IP,001,7,15710,15952,4539,242,PERF
42285335880100,PI,IP,001,8,16030,16272,4539,242,PERF
42285335880100,PI,IP,001,9,16350,16592,4539,242,PERF
42285335880100,PI,IP,001,10,16670,16912,4539,242,PERF
42285335880100,PI,IP,001,11,16990,17232,4539,242,PERF
42285335880100,PI,IP,001,12,17310,17552,4539,242,PERF
42285335970000,PI,IP,001,1,14000,18802,5294,4802,PERF
42285335980000,PI,IP,001,1,13174,17230,4758,4056,PERF
42285336000200,PI,IP,002,1,11539,16809,6714,5270,PERF
42285336000200,PI,PT,001,1,11539,12112,6714,573,PERF
42285336000200,PI,PT,001,2,12557,15168,6714,2611,PERF
42285336000200,PI,PT,001,3,15629,16809,6714,1180,PERF
42285336020000,PI,IP,002,1,10755,15722,5949,4967,PERF
42285336020000,PI,PT,001,1,12162,12212,5949,50,PERF
42285336020000,PI,PT,001,2,13858,14075,5949,217,PERF
42285336020000,PI,PT,001,3,14892,15626,5949,734,PERF
42285336020000,PI,PT,001,4,15722,15722,5949,0,PERF
42285336030000,PI,IP,001,1,11266,11953,5077,687,PERF
42285336030000,PI,IP,001,2,12016,14866,5077,2850,PERF
42285336030000,PI,IP,001,3,14876,15575,5077,699,PERF
42285336090000,PI,IP,002,1,11266,16157,5760,4891,PERF
42285336090000,PI,PT,001,1,12883,14826,5760,1943,PERF
42285336090000,PI,PT,001,2,15113,15301,5760,188,PERF
42285336090000,PI,PT,001,3,15405,16157,5760,752,PERF
42285336100000,PI,IP,001,1,10705,14131,6105,3426,PERF
42285336100000,PI,IP,001,2,14421,15969,6105,1548,PERF
42285336120000,PI,IP,001,1,11318,15256,6242,3938,PERF
42285336120000,PI,IP,001,2,15358,16894,6242,1536,PERF
42285336140000,PI,IP,001,1,11041,15419,6716,4378,PERF
42285336140000,PI,IP,001,2,15757,16006,6716,249,PERF
42285336140000,PI,IP,001,3,16154,16689,6716,535,PERF
42285336150000,PI,IP,001,1,11296,17676,7221,6380,PERF
42285336180000,PI,IP,001,1,12225,18095,6128,5870,PERF
42285336200000,PI,IP,001,1,11366,11366,6935,0,PERF
42285336200000,PI,IP,001,2,11428,11428,6935,0,PERF
42285336200000,PI,IP,001,3,11490,11490,6935,0,PERF
42285336200000,PI,IP,001,4,11552,11552,6935,0,PERF
42285336200000,PI,IP,001,5,11614,11614,6935,0,PERF
42285336200000,PI,IP,001,6,11676,11676,6935,0,PERF
42285336200000,PI,IP,001,7,11738,11738,6935,0,PERF
42285336200000,PI,IP,001,8,11800,11800,6935,0,PERF
42285336200000,PI,IP,001,9,11862,11862,6935,0,PERF
42285336200000,PI,IP,001,10,11924,11924,6935,0,PERF
42285336200000,PI,IP,001,11,11986,11986,6935,0,PERF
42285336200000,PI,IP,001,12,12048,12048,6935,0,PERF
42285336200000,PI,IP,001,13,12110,12110,6935,0,PERF
42285336200000,PI,IP,001,14,12172,12172,6935,0,PERF
42285336200000,PI,IP,001,15,12234,12234,6935,0,PERF
42285336200000,PI,IP,001,16,12296,12296,6935,0,PERF
42285336200000,PI,IP,001,17,12358,12358,6935,0,PERF
42285336200000,PI,IP,001,18,12420,12420,6935,0,PERF
42285336200000,PI,IP,001,19,12482,12482,6935,0,PERF
42285336200000,PI,IP,001,20,12544,12544,6935,0,PERF
42285336200000,PI,IP,001,21,12606,12606,6935,0,PERF
42285336200000,PI,IP,001,22,12668,12668,6935,0,PERF
42285336200000,PI,IP,001,23,12730,12730,6935,0,PERF
42285336200000,PI,IP,001,24,12792,12792,6935,0,PERF
42285336200000,PI,IP,001,25,12854,12854,6935,0,PERF
42285336200000,PI,IP,001,26,12916,12916,6935,0,PERF
42285336200000,PI,IP,001,27,12978,12978,6935,0,PERF
42285336200000,PI,IP,001,28,13040,13040,6935,0,PERF
42285336200000,PI,IP,001,29,13102,13102,6935,0,PERF
42285336200000,PI,IP,001,30,13164,13164,6935,0,PERF
42285336200000,PI,IP,001,31,13226,13226,6935,0,PERF
42285336200000,PI,IP,001,32,13288,13288,6935,0,PERF
42285336200000,PI,IP,001,33,13350,13350,6935,0,PERF
42285336200000,PI,IP,001,34,13412,13412,6935,0,PERF
42285336200000,PI,IP,001,35,13474,13474,6935,0,PERF
42285336200000,PI,IP,001,36,13536,13536,6935,0,PERF
42285336200000,PI,IP,001,37,13598,13598,6935,0,PERF
42285336200000,PI,IP,001,38,13660,13660,6935,0,PERF
42285336200000,PI,IP,001,39,13722,13722,6935,0,PERF
42285336200000,PI,IP,001,40,13784,13784,6935,0,PERF
42285336200000,PI,IP,001,41,13846,13846,6935,0,PERF
42285336200000,PI,IP,001,42,13908,13908,6935,0,PERF
42285336200000,PI,IP,001,43,13970,13970,6935,0,PERF
42285336200000,PI,IP,001,44,14032,14032,6935,0,PERF
42285336200000,PI,IP,001,45,14094,14094,6935,0,PERF
42285336200000,PI,IP,001,46,14156,14156,6935,0,PERF
42285336200000,PI,IP,001,47,14218,14218,6935,0,PERF
42285336200000,PI,IP,001,48,14280,14280,6935,0,PERF
42285336200000,PI,IP,001,49,14342,14342,6935,0,PERF
42285336200000,PI,IP,001,50,14404,14404,6935,0,PERF
42285336200000,PI,IP,001,51,14466,14466,6935,0,PERF
42285336200000,PI,IP,001,52,14528,14528,6935,0,PERF
42285336200000,PI,IP,001,53,14590,14590,6935,0,PERF
42285336200000,PI,IP,001,54,14652,14652,6935,0,PERF
42285336200000,PI,IP,001,55,14714,14714,6935,0,PERF
42285336200000,PI,IP,001,56,14776,14776,6935,0,PERF
42285336200000,PI,IP,001,57,14838,14838,6935,0,PERF
42285336200000,PI,IP,001,58,14900,14900,6935,0,PERF
42285336200000,PI,IP,001,59,14962,14962,6935,0,PERF
42285336200000,PI,IP,001,60,15024,15024,6935,0,PERF
42285336200000,PI,IP,001,61,15086,15086,6935,0,PERF
42285336200000,PI,IP,001,62,15148,15148,6935,0,PERF
42285336200000,PI,IP,001,63,15210,15210,6935,0,PERF
42285336200000,PI,IP,001,64,15272,15272,6935,0,PERF
42285336200000,PI,IP,001,65,15334,15334,6935,0,PERF
42285336200000,PI,IP,001,66,15396,15396,6935,0,PERF
42285336200000,PI,IP,001,67,15458,15458,6935,0,PERF
42285336200000,PI,IP,001,68,15520,15520,6935,0,PERF
42285336200000,PI,IP,001,69,15582,15582,6935,0,PERF
42285336200000,PI,IP,001,70,15644,15644,6935,0,PERF
42285336200000,PI,IP,001,71,15706,15706,6935,0,PERF
42285336200000,PI,IP,001,72,15768,15768,6935,0,PERF
42285336200000,PI,IP,001,73,15870,15870,6935,0,PERF
42285336200000,PI,IP,001,74,16063,16063,6935,0,PERF
42285336200000,PI,IP,001,75,16256,16256,6935,0,PERF
42285336200000,PI,IP,001,76,16448,16448,6935,0,PERF
42285336200000,PI,IP,001,77,16640,16640,6935,0,PERF
42285336200000,PI,IP,001,78,16832,16832,6935,0,PERF
42285336200000,PI,IP,001,79,17025,17025,6935,0,PERF
42285336200000,PI,IP,001,80,17218,17218,6935,0,PERF
42285336200000,PI,IP,001,81,17408,17408,6935,0,PERF
42285336220000,PI,IP,001,1,10745,15755,5770,5010,PERF
42285336230000,PI,IP,001,1,11257,16534,6291,5277,PERF
42285336250100,PI,IP,001,1,11610,16560,5470,4950,PERF
42285336260000,PI,IP,001,1,11886,15078,5164,3192,PERF
42285336270000,PI,IP,001,1,10776,10776,5572,0,PERF
42285336270000,PI,IP,001,2,10839,10839,5572,0,PERF
42285336270000,PI,IP,001,3,10901,10901,5572,0,PERF
42285336270000,PI,IP,001,4,10964,10964,5572,0,PERF
42285336270000,PI,IP,001,5,11026,11026,5572,0,PERF
42285336270000,PI,IP,001,6,11089,11089,5572,0,PERF
42285336270000,PI,IP,001,7,11151,11151,5572,0,PERF
42285336270000,PI,IP,001,8,11214,11214,5572,0,PERF
42285336270000,PI,IP,001,9,11276,11276,5572,0,PERF
42285336270000,PI,IP,001,10,11339,11339,5572,0,PERF
42285336270000,PI,IP,001,11,11401,11401,5572,0,PERF
42285336270000,PI,IP,001,12,11464,11464,5572,0,PERF
42285336270000,PI,IP,001,13,11526,11526,5572,0,PERF
42285336270000,PI,IP,001,14,11589,11589,5572,0,PERF
42285336270000,PI,IP,001,15,11651,11651,5572,0,PERF
42285336270000,PI,IP,001,16,11714,11714,5572,0,PERF
42285336270000,PI,IP,001,17,11776,11776,5572,0,PERF
42285336270000,PI,IP,001,18,11839,11839,5572,0,PERF
42285336270000,PI,IP,001,19,11901,11901,5572,0,PERF
42285336270000,PI,IP,001,20,11964,11964,5572,0,PERF
42285336270000,PI,IP,001,21,12026,12026,5572,0,PERF
42285336270000,PI,IP,001,22,12089,12089,5572,0,PERF
42285336270000,PI,IP,001,23,12151,12151,5572,0,PERF
42285336270000,PI,IP,001,24,12214,12214,5572,0,PERF
42285336270000,PI,IP,001,25,12276,12276,5572,0,PERF
42285336270000,PI,IP,001,26,12339,12339,5572,0,PERF
42285336270000,PI,IP,001,27,12401,12401,5572,0,PERF
42285336270000,PI,IP,001,28,12464,12464,5572,0,PERF
42285336270000,PI,IP,001,29,12526,12526,5572,0,PERF
42285336270000,PI,IP,001,30,12589,12589,5572,0,PERF
42285336270000,PI,IP,001,31,12651,12651,5572,0,PERF
42285336270000,PI,IP,001,32,12714,12714,5572,0,PERF
42285336270000,PI,IP,001,33,12776,12776,5572,0,PERF
42285336270000,PI,IP,001,34,12839,12839,5572,0,PERF
42285336270000,PI,IP,001,35,12901,12901,5572,0,PERF
42285336270000,PI,IP,001,36,12964,12964,5572,0,PERF
42285336270000,PI,IP,001,37,13026,13026,5572,0,PERF
42285336270000,PI,IP,001,38,13089,13089,5572,0,PERF
42285336270000,PI,IP,001,39,13151,13151,5572,0,PERF
42285336270000,PI,IP,001,40,13214,13214,5572,0,PERF
42285336270000,PI,IP,001,41,13276,13276,5572,0,PERF
42285336270000,PI,IP,001,42,13339,13339,5572,0,PERF
42285336270000,PI,IP,001,43,13401,13401,5572,0,PERF
42285336270000,PI,IP,001,44,13464,13464,5572,0,PERF
42285336270000,PI,IP,001,45,13526,13526,5572,0,PERF
42285336270000,PI,IP,001,46,13589,13589,5572,0,PERF
42285336270000,PI,IP,001,47,13651,13651,5572,0,PERF
42285336270000,PI,IP,001,48,13714,13714,5572,0,PERF
42285336270000,PI,IP,001,49,13776,13776,5572,0,PERF
42285336270000,PI,IP,001,50,13839,13839,5572,0,PERF
42285336270000,PI,IP,001,51,13901,13901,5572,0,PERF
42285336270000,PI,IP,001,52,13964,13964,5572,0,PERF
42285336270000,PI,IP,001,53,14066,14066,5572,0,PERF
42285336270000,PI,IP,001,54,14259,14259,5572,0,PERF
42285336270000,PI,IP,001,55,14451,14451,5572,0,PERF
42285336270000,PI,IP,001,56,14644,14644,5572,0,PERF
42285336270000,PI,IP,001,57,14837,14837,5572,0,PERF
42285336270000,PI,IP,001,58,15030,15030,5572,0,PERF
42285336270000,PI,IP,001,59,15223,15223,5572,0,PERF
42285336270000,PI,IP,001,60,15416,15416,5572,0,PERF
42285336270000,PI,IP,001,61,15609,15609,5572,0,PERF
42285336280100,PI,IP,001,1,11358,15201,6134,3843,PERF
42285336280100,PI,IP,001,2,15303,16838,6134,1535,PERF
42285336310000,PI,IP,001,1,11249,17656,7246,6407,PERF
42285336320000,PI,IP,002,1,11877,17330,6067,5453,PERF
42285336320000,PI,PT,001,1,11877,17330,6067,5453,PERF
42285336330100,PI,IP,001,1,12097,16659,5129,4562,PERF
42285336380000,PI,IP,001,1,10859,15680,5737,4821,PERF
42285336430000,PI,IP,001,1,12119,16572,4970,4453,PERF
42285336450000,PI,IP,001,1,11845,15879,4916,4034,PERF
42285336470000,PI,IP,001,1,10716,16046,6144,5330,PERF
42285336490000,PI,IP,001,1,11003,17074,7007,6071,PERF
42285336510000,PI,IP,001,1,11733,16824,6073,5091,PERF
42285336520000,PI,IP,001,1,11901,16771,5469,4870,PERF
42285336530000,PI,IP,001,1,11242,17012,6515,5770,PERF
42285336550000,PI,IP,001,1,12433,18034,5905,5601,PERF
42285336570000,PI,IP,001,1,11755,16718,6076,4963,PERF
42285336580000,PI,IP,001,1,12086,16545,,4459,PERF
42285336600000,PI,IP,001,1,11654,17679,6954,6025,PERF
42285336610100,PI,IP,001,1,12455,16908,5299,4453,PERF
42285336620000,PI,IP,001,1,12481,16682,4764,4201,PERF
42285336630000,PI,IP,001,1,12370,17525,6053,5155,PERF
42285336670000,PI,IP,001,1,11896,16848,5536,4952,PERF
42285336690100,PI,IP,001,1,12450,17900,6120,5450,PERF
42285336700000,PI,IP,001,1,12507,16269,4928,3762,PERF
42285336720000,PI,IP,001,1,12137,16089,4824,3952,PERF
42285336740000,PI,IP,001,1,12576,17028,5374,4452,PERF
42285336750000,PI,IP,001,1,13452,17752,6119,4300,PERF
42285336770100,PI,IP,001,1,12887,18517,6431,5630,PERF
42285336800000,PI,IP,001,1,12939,17673,5735,4734,PERF
42285336830000,PI,IP,001,1,12557,15627,4273,3070,PERF
42285336840000,PI,IP,001,1,12860,18183,6075,5323,PERF
42287325050001,PI,IP,001,1,9040,9060,,20,PERF
42287325480000,PI,IP,001,1,8994,10203,2504,1209,PERF
42287325770100,PI,IP,001,1,7529,12552,5221,5023,OPENHOLE
42287325810000,PI,IP,001,1,7790,12604,4970,4814,OPENHOLE
42287325950000,PI,IP,001,1,7703,12698,5463,4995,PERF
42289316630100,PI,IP,001,1,7260,8100,2781,840,PERF
42289316630100,PI,IP,001,2,8100,8885,2781,785,PERF
42289318590000,PI,IP,001,1,7325,9090,2502,1765,PERF
42289318920000,PI,IP,001,1,8282,12722,7252,4440,PERF
42289318920000,PI,IP,001,2,12778,12940,7252,162,PERF
42289318920000,PI,IP,001,3,13052,13228,7252,176,PERF
42289318920000,PI,IP,001,4,13346,13523,7252,177,PERF
42289318920000,PI,IP,001,5,13625,13870,7252,245,PERF
42289319950200,PI,IP,001,1,9401,13563,6156,4162,PERF
42297348140000,PI,IP,001,1,12832,16920,4972,4088,PERF
42297348460000,PI,IP,001,1,13205,15758,3522,2553,PERF
42297348490000,PI,IP,001,1,14270,18820,5439,4550,PERF
42297348630100,PI,IP,001,1,12780,16903,5407,4123,PERF
42297348710000,PI,IP,001,1,13813,18080,4781,4267,PERF
42297348720000,PI,IP,001,1,12525,16939,4859,4414,PERF
42297348770100,PI,IP,001,1,12997,17500,5544,4503,PERF
42297348780100,PI,IP,001,1,12674,12996,5255,322,PERF
42297348780100,PI,IP,001,2,13074,13396,5255,322,PERF
42297348780100,PI,IP,001,3,13474,13796,5255,322,PERF
42297348780100,PI,IP,001,4,13874,14196,5255,322,PERF
42297348780100,PI,IP,001,5,14274,14596,5255,322,PERF
42297348780100,PI,IP,001,6,14674,14996,5255,322,PERF
42297348780100,PI,IP,001,7,15074,15396,5255,322,PERF
42297348780100,PI,IP,001,8,15474,15796,5255,322,PERF
42297348780100,PI,IP,001,9,15874,16196,5255,322,PERF
42297348780100,PI,IP,001,10,16274,16596,5255,322,PERF
42297348780100,PI,IP,001,11,16674,16996,5255,322,PERF
42297348780100,PI,IP,001,12,17074,17080,5255,6,PERF
42297348790000,PI,IP,001,1,12579,16912,5359,4333,PERF
42297348820000,PI,IP,001,1,14280,19902,4939,5622,PERF
42297348830000,PI,IP,001,1,13137,13424,6075,287,PERF
42297348830000,PI,IP,001,2,13526,13835,6075,309,PERF
42297348830000,PI,IP,001,3,13911,14220,6075,309,PERF
42297348830000,PI,IP,001,4,14296,14604,6075,308,PERF
42297348830000,PI,IP,001,5,14681,14990,6075,309,PERF
42297348830000,PI,IP,001,6,15066,15376,6075,310,PERF
42297348830000,PI,IP,001,7,15451,15760,6075,309,PERF
42297348830000,PI,IP,001,8,15836,16150,6075,314,PERF
42297348830000,PI,IP,001,9,16221,16535,6075,314,PERF
42297348830000,PI,IP,001,10,16606,16915,6075,309,PERF
42297348830000,PI,IP,001,11,16986,17300,6075,314,PERF
42297348830000,PI,IP,001,12,17376,17685,6075,309,PERF
42297348830000,PI,IP,001,13,17761,18053,6075,292,PERF
42297348830000,PI,IP,001,14,18148,18475,6075,327,PERF
42297348830000,PI,IP,001,15,18599,18796,6075,197,PERF
42297348840000,PI,IP,001,1,15840,16815,2918,975,PERF
42297348850000,PI,IP,001,1,17520,18502,5489,982,PERF
42297348860000,PI,IP,001,1,12005,17956,6482,5951,PERF
42297348880000,PI,IP,001,1,12246,19357,7534,7111,PERF
42297348900100,PI,IP,001,1,11892,16097,5073,4205,PERF
42297348940100,PI,IP,001,1,11960,15752,4647,3792,PERF
42297348950000,PI,IP,001,1,12860,17482,5240,4622,PERF
42297348960000,PI,IP,001,1,13165,18062,5453,4897,PERF
42297348980000,PI,IP,001,1,12530,16880,5405,4350,PERF
42297349000000,PI,IP,001,1,14587,18154,4829,3567,PERF
42297349010000,PI,IP,001,1,13418,17702,4990,4284,PERF
42297349020000,PI,IP,001,1,13262,19422,,6160,PERF
42297349050000,PI,IP,001,1,12472,17822,6052,5350,PERF
42297349060000,PI,IP,001,1,11543,17333,6464,5790,PERF
42297349070000,PI,IP,001,1,12316,16743,5407,4427,PERF
42297349090000,PI,IP,001,1,11600,12002,5429,402,PERF
42297349090000,PI,IP,001,2,12080,12402,5429,322,PERF
42297349090000,PI,IP,001,3,12480,12802,5429,322,PERF
42297349090000,PI,IP,001,4,12880,13202,5429,322,PERF
42297349090000,PI,IP,001,5,13280,13602,5429,322,PERF
42297349090000,PI,IP,001,6,13680,14002,5429,322,PERF
42297349090000,PI,IP,001,7,14298,14600,5429,302,PERF
42297349090000,PI,IP,001,8,14720,15122,5429,402,PERF
42297349090000,PI,IP,001,9,15200,15602,5429,402,PERF
42297349090000,PI,IP,001,10,15680,16002,5429,322,PERF
42297349110000,PI,IP,001,1,11434,14809,4065,3375,PERF
42297349120000,PI,IP,001,1,12750,17652,5520,4902,PERF
42297349160000,PI,IP,001,1,12296,17092,5765,4796,PERF
42297349170000,PI,IP,001,1,12045,16428,5505,4383,PERF
42297349180000,PI,IP,001,1,11520,16350,5309,4830,PERF
42297349190000,PI,IP,001,1,12107,12364,5162,257,PERF
42297349190000,PI,IP,001,2,12443,12764,5162,321,PERF
42297349190000,PI,IP,001,3,12843,13164,5162,321,PERF
42297349190000,PI,IP,001,4,13243,13564,5162,321,PERF
42297349190000,PI,IP,001,5,13643,13964,5162,321,PERF
42297349190000,PI,IP,001,6,14043,14364,5162,321,PERF
42297349190000,PI,IP,001,7,14443,14764,5162,321,PERF
42297349190000,PI,IP,001,8,14843,15164,5162,321,PERF
42297349190000,PI,IP,001,9,15243,15564,5162,321,PERF
42297349190000,PI,IP,001,10,15643,15964,5162,321,PERF
42297349190000,PI,IP,001,11,16043,16365,5162,322,PERF
42297349200000,PI,IP,001,1,11700,12048,5735,348,PERF
42297349200000,PI,IP,001,2,12131,12470,5735,339,PERF
42297349200000,PI,IP,001,3,12553,12892,5735,339,PERF
42297349200000,PI,IP,001,4,12974,13314,5735,340,PERF
42297349200000,PI,IP,001,5,13396,13736,5735,340,PERF
42297349200000,PI,IP,001,6,13818,14157,5735,339,PERF
42297349200000,PI,IP,001,7,14250,14579,5735,329,PERF
42297349200000,PI,IP,001,8,14661,15001,5735,340,PERF
42297349200000,PI,IP,001,9,15083,15423,5735,340,PERF
42297349200000,PI,IP,001,10,15505,15844,5735,339,PERF
42297349200000,PI,IP,001,11,15927,16266,5735,339,PERF
42297349200000,PI,IP,001,12,16349,16688,5735,339,PERF
42297349210000,PI,IP,001,1,13237,17840,5403,4603,PERF
42297349220000,PI,IP,001,1,11660,16698,5482,5038,PERF
42297349250000,PI,IP,001,1,11983,16363,6429,4380,PERF
42297349260000,PI,IP,001,1,12103,16589,5522,4486,PERF
42297349270000,PI,IP,001,1,12387,17761,6107,5374,PERF
42297349290000,PI,IP,001,1,11693,16875,5837,5182,PERF
42297349310000,PI,IP,001,1,11700,16666,5830,4966,PERF
42297349330000,PI,IP,001,1,11796,16884,5818,5088,PERF
42297349340000,PI,IP,001,1,12006,16141,5470,4135,PERF
42297349350000,PI,IP,001,1,11803,16898,5842,5095,PERF
42297349360000,PI,IP,001,1,12005,16156,5240,4151,PERF
42297349370000,PI,IP,001,1,11860,16977,5957,5117,PERF
42297349400000,PI,IP,001,1,12016,16558,5336,4542,PERF
42297349410000,PI,IP,001,1,12370,16853,5378,4483,PERF
42297349420000,PI,IP,001,1,12325,12529,6189,204,PERF
42297349420000,PI,IP,001,2,12600,12804,6189,204,PERF
42297349420000,PI,IP,001,3,12875,13079,6189,204,PERF
42297349420000,PI,IP,001,4,13150,13354,6189,204,PERF
42297349420000,PI,IP,001,5,13425,13629,6189,204,PERF
42297349420000,PI,IP,001,6,13700,13904,6189,204,PERF
42297349420000,PI,IP,001,7,13975,14179,6189,204,PERF
42297349420000,PI,IP,001,8,14250,14454,6189,204,PERF
42297349420000,PI,IP,001,9,14525,14729,6189,204,PERF
42297349420000,PI,IP,001,10,14800,15004,6189,204,PERF
42297349420000,PI,IP,001,11,15075,15279,6189,204,PERF
42297349420000,PI,IP,001,12,15350,15554,6189,204,PERF
42297349420000,PI,IP,001,13,15625,15829,6189,204,PERF
42297349420000,PI,IP,001,14,15900,16104,6189,204,PERF
42297349420000,PI,IP,001,15,16175,16379,6189,204,PERF
42297349420000,PI,IP,001,16,16450,16654,6189,204,PERF
42297349420000,PI,IP,001,17,16725,16929,6189,204,PERF
42297349420000,PI,IP,001,18,17000,17204,6189,204,PERF
42297349420000,PI,IP,001,19,17612,17616,6189,4,PERF
42297349430000,PI,IP,001,1,12056,16290,5130,4234,PERF
42297349450000,PI,IP,001,1,11800,16682,5421,4882,PERF
42297349470000,PI,IP,001,1,13134,17695,5942,4561,PERF
42297349480000,PI,IP,001,1,11610,15682,4631,4072,PERF
42297349490000,PI,IP,001,1,14056,17347,3732,3291,PERF
42297349500200,PI,IP,001,1,12196,17250,5943,5054,PERF
42297349520000,PI,IP,001,1,12593,16933,4975,4340,PERF
42297349540000,PI,IP,001,1,12456,17726,6284,5270,PERF
42297349550000,PI,IP,001,1,12488,17026,5637,4538,PERF
42297349560000,PI,IP,001,1,12214,16878,5835,4664,PERF
42297349570000,PI,IP,001,1,12020,16490,5058,4470,PERF
42297349580100,PI,IP,001,1,11816,16335,5289,4519,PERF
42297349590000,PI,IP,001,1,11781,17618,6343,5837,PERF
42297349600000,PI,IP,001,1,12119,17300,6480,5181,PERF
42297349610000,PI,IP,001,1,12339,16929,5245,4590,PERF
42297349630000,PI,IP,001,1,12060,15742,6047,3682,PERF
42297349640000,PI,IP,001,1,12110,17256,5660,5146,PERF
42297349650000,PI,IP,001,1,12083,16229,5149,4146,PERF
42297349660000,PI,IP,001,1,12405,16907,6393,4502,PERF
42297349670000,PI,IP,001,1,12546,17746,6021,5200,PERF
42297349680000,PI,IP,001,1,12173,16475,6324,4302,PERF
42297349690000,PI,IP,001,1,12019,17929,,5910,PERF
42297349700000,PI,IP,001,1,12956,17581,4833,4625,PERF
42297349710000,PI,IP,001,1,13180,18782,6058,5602,PERF
42297349720000,PI,IP,001,1,12193,16689,5294,4496,PERF
42297349730000,PI,IP,001,1,11672,17253,6619,5581,PERF
42297349740000,PI,IP,001,1,11445,16680,5693,5235,PERF
42297349750000,PI,IP,001,1,11406,15995,5107,4589,PERF
42297349760000,PI,IP,001,1,12325,17568,5812,5243,PERF
42297349780000,PI,IP,001,1,11558,15488,4476,3930,PERF
42297349800000,PI,IP,001,1,11753,16750,5922,4997,PERF
42297349820000,PI,IP,001,1,12207,16811,5622,4604,PERF
42297349840000,PI,IP,001,1,12125,17435,6461,5310,PERF
42297349860000,PI,IP,001,1,11760,18221,6939,6461,PERF
42297349900000,PI,IP,001,1,12110,18396,7613,6286,PERF
42297349910000,PI,IP,001,1,13062,17950,6969,4888,PERF
42297349920000,PI,IP,001,1,11725,16273,5637,4548,PERF
42297349930000,PI,IP,001,1,11589,16255,5161,4666,PERF
42297349940000,PI,IP,001,1,12069,16429,4946,4360,PERF
42297349970000,PI,IP,001,1,11837,16849,5705,5012,PERF
42297349980000,PI,IP,001,1,12252,16035,4669,3783,PERF
42297349990000,PI,IP,001,1,11958,16140,4968,4182,PERF
42297350040000,PI,IP,001,1,12361,16643,5082,4282,PERF
42297350050000,PI,IP,001,1,11843,18157,6287,6314,PERF
42297350080000,PI,IP,001,1,12320,17354,5574,5034,PERF
42297350090000,PI,IP,001,1,12675,17625,5999,4950,PERF
42297350100000,PI,IP,001,1,13453,18783,8036,5330,PERF
42297350110100,PI,IP,001,1,12775,13021,6283,246,PERF
42297350110100,PI,IP,001,2,13085,13386,6283,301,PERF
42297350110100,PI,IP,001,3,13450,13756,6283,306,PERF
42297350110100,PI,IP,001,4,13820,14126,6283,306,PERF
42297350110100,PI,IP,001,5,14190,14491,6283,301,PERF
42297350110100,PI,IP,001,6,14550,14851,6283,301,PERF
42297350110100,PI,IP,001,7,14910,15216,6283,306,PERF
42297350110100,PI,IP,001,8,15278,15581,6283,303,PERF
42297350110100,PI,IP,001,9,15640,15944,6283,304,PERF
42297350110100,PI,IP,001,10,16010,16311,6283,301,PERF
42297350110100,PI,IP,001,11,16375,16676,6283,301,PERF
42297350110100,PI,IP,001,12,16740,17041,6283,301,PERF
42297350110100,PI,IP,001,13,17105,17406,6283,301,PERF
42297350110100,PI,IP,001,14,17470,17776,6283,306,PERF
42297350110100,PI,IP,001,15,17840,18141,6283,301,PERF
42297350110100,PI,IP,001,16,18200,18491,6283,291,PERF
42297350120000,PI,IP,001,1,12132,17262,5822,5130,PERF
42297350130000,PI,IP,001,1,12308,17005,5505,4697,PERF
42297350140000,PI,IP,001,1,11530,17392,6742,5862,PERF
42297350150000,PI,IP,001,1,12044,15912,4949,3868,PERF
42297350160000,PI,IP,001,1,11843,17099,5638,5256,PERF
42297350180000,PI,IP,001,1,11886,17208,5737,5322,PERF
42297350200000,PI,IP,001,1,13198,18269,5702,5071,PERF
42297350210000,PI,IP,001,1,12518,16108,4968,3590,PERF
42297350220000,PI,IP,001,1,12378,17701,6909,5323,PERF
42297350230000,PI,IP,001,1,11679,16265,5502,4586,PERF
42297350240000,PI,IP,001,1,11983,16337,5060,4354,PERF
42297350250100,PI,IP,001,1,11985,17824,6624,5839,PERF
42297350260000,PI,IP,001,1,11840,16166,6106,4326,PERF
42297350270000,PI,IP,001,1,12727,18472,6236,5745,PERF
42297350280000,PI,IP,001,1,12780,18102,6208,5322,PERF
42297350290000,PI,IP,001,1,12815,12816,5752,1,PERF
42297350290000,PI,IP,001,2,12870,12871,5752,1,PERF
42297350290000,PI,IP,001,3,12930,12931,5752,1,PERF
42297350290000,PI,IP,001,4,12990,12991,5752,1,PERF
42297350290000,PI,IP,001,5,13050,13051,5752,1,PERF
42297350290000,PI,IP,001,6,13110,13111,5752,1,PERF
42297350290000,PI,IP,001,7,13170,13171,5752,1,PERF
42297350290000,PI,IP,001,8,13230,13231,5752,1,PERF
42297350290000,PI,IP,001,9,13290,13291,5752,1,PERF
42297350290000,PI,IP,001,10,13353,13354,5752,1,PERF
42297350290000,PI,IP,001,11,13410,13411,5752,1,PERF
42297350290000,PI,IP,001,12,13470,13471,5752,1,PERF
42297350290000,PI,IP,001,13,13533,13534,5752,1,PERF
42297350290000,PI,IP,001,14,13590,13591,5752,1,PERF
42297350290000,PI,IP,001,15,13650,13651,5752,1,PERF
42297350290000,PI,IP,001,16,13713,13714,5752,1,PERF
42297350290000,PI,IP,001,17,13770,13771,5752,1,PERF
42297350290000,PI,IP,001,18,13833,13834,5752,1,PERF
42297350290000,PI,IP,001,19,13893,13894,5752,1,PERF
42297350290000,PI,IP,001,20,13950,13951,5752,1,PERF
42297350290000,PI,IP,001,21,14010,14011,5752,1,PERF
42297350290000,PI,IP,001,22,14072,14073,5752,1,PERF
42297350290000,PI,IP,001,23,14130,14131,5752,1,PERF
42297350290000,PI,IP,001,24,14190,14191,5752,1,PERF
42297350290000,PI,IP,001,25,14250,14251,5752,1,PERF
42297350290000,PI,IP,001,26,14310,14311,5752,1,PERF
42297350290000,PI,IP,001,27,14370,14371,5752,1,PERF
42297350290000,PI,IP,001,28,14430,14431,5752,1,PERF
42297350290000,PI,IP,001,29,14490,14491,5752,1,PERF
42297350290000,PI,IP,001,30,14550,14551,5752,1,PERF
42297350290000,PI,IP,001,31,14610,14611,5752,1,PERF
42297350290000,PI,IP,001,32,14670,14671,5752,1,PERF
42297350290000,PI,IP,001,33,14730,14731,5752,1,PERF
42297350290000,PI,IP,001,34,14790,14791,5752,1,PERF
42297350290000,PI,IP,001,35,14850,14851,5752,1,PERF
42297350290000,PI,IP,001,36,14910,14911,5752,1,PERF
42297350290000,PI,IP,001,37,14970,14971,5752,1,PERF
42297350290000,PI,IP,001,38,15030,15031,5752,1,PERF
42297350290000,PI,IP,001,39,15090,15091,5752,1,PERF
42297350290000,PI,IP,001,40,15150,15151,5752,1,PERF
42297350290000,PI,IP,001,41,15210,15211,5752,1,PERF
42297350290000,PI,IP,001,42,15270,15271,5752,1,PERF
42297350290000,PI,IP,001,43,15330,15331,5752,1,PERF
42297350290000,PI,IP,001,44,15390,15391,5752,1,PERF
42297350290000,PI,IP,001,45,15450,15451,5752,1,PERF
42297350290000,PI,IP,001,46,15510,15511,5752,1,PERF
42297350290000,PI,IP,001,47,15570,15571,5752,1,PERF
42297350290000,PI,IP,001,48,15630,15631,5752,1,PERF
42297350290000,PI,IP,001,49,15690,15691,5752,1,PERF
42297350290000,PI,IP,001,50,15750,15751,5752,1,PERF
42297350290000,PI,IP,001,51,15810,15811,5752,1,PERF
42297350290000,PI,IP,001,52,15870,15871,5752,1,PERF
42297350290000,PI,IP,001,53,15930,15931,5752,1,PERF
42297350290000,PI,IP,001,54,15990,15991,5752,1,PERF
42297350290000,PI,IP,001,55,16050,16051,5752,1,PERF
42297350290000,PI,IP,001,56,16110,16111,5752,1,PERF
42297350290000,PI,IP,001,57,16170,16171,5752,1,PERF
42297350290000,PI,IP,001,58,16230,16231,5752,1,PERF
42297350290000,PI,IP,001,59,16290,16291,5752,1,PERF
42297350290000,PI,IP,001,60,16350,16351,5752,1,PERF
42297350290000,PI,IP,001,61,16410,16411,5752,1,PERF
42297350290000,PI,IP,001,62,16470,16471,5752,1,PERF
42297350290000,PI,IP,001,63,16530,16531,5752,1,PERF
42297350290000,PI,IP,001,64,16590,16591,5752,1,PERF
42297350290000,PI,IP,001,65,16651,16652,5752,1,PERF
42297350290000,PI,IP,001,66,16710,16711,5752,1,PERF
42297350290000,PI,IP,001,67,16770,16771,5752,1,PERF
42297350290000,PI,IP,001,68,16830,16831,5752,1,PERF
42297350290000,PI,IP,001,69,16890,16891,5752,1,PERF
42297350290000,PI,IP,001,70,16950,16951,5752,1,PERF
42297350290000,PI,IP,001,71,17013,17014,5752,1,PERF
42297350290000,PI,IP,001,72,17070,17071,5752,1,PERF
42297350290000,PI,IP,001,73,17130,17131,5752,1,PERF
42297350290000,PI,IP,001,74,17188,17189,5752,1,PERF
42297350290000,PI,IP,001,75,17250,17251,5752,1,PERF
42297350290000,PI,IP,001,76,17310,17311,5752,1,PERF
42297350290000,PI,IP,001,77,17370,17371,5752,1,PERF
42297350290000,PI,IP,001,78,17430,17431,5752,1,PERF
42297350290000,PI,IP,001,79,17490,17491,5752,1,PERF
42297350290000,PI,IP,001,80,17550,17551,5752,1,PERF
42297350290000,PI,IP,001,81,17610,17611,5752,1,PERF
42297350290000,PI,IP,001,82,17670,17671,5752,1,PERF
42297350290000,PI,IP,001,83,17730,17731,5752,1,PERF
42297350290000,PI,IP,001,84,17790,17791,5752,1,PERF
42297350290000,PI,IP,001,85,17850,17851,5752,1,PERF
42297350290000,PI,IP,001,86,17910,17911,5752,1,PERF
42297350290000,PI,IP,001,87,17970,17970,5752,0,PERF
42297350290000,PI,IP,001,88,18030,18031,5752,1,PERF
42297350290000,PI,IP,001,89,18090,18091,5752,1,PERF
42297350290000,PI,IP,001,90,18150,18151,5752,1,PERF
42297350290000,PI,IP,001,91,18210,18211,5752,1,PERF
42297350290000,PI,IP,001,92,18270,18271,5752,1,PERF
42297350290000,PI,IP,001,93,18330,18331,5752,1,PERF
42297350290000,PI,IP,001,94,18390,18391,5752,1,PERF
42297350300000,PI,IP,001,1,12500,16982,5032,4482,PERF
42297350310000,PI,IP,001,1,12930,18252,5853,5322,PERF
42297350320000,PI,IP,001,1,13118,19702,6861,6584,PERF
42297350340000,PI,IP,001,1,13090,17942,4961,4852,PERF
42297350350000,PI,IP,001,1,13097,18142,5020,5045,PERF
42297350360000,PI,IP,001,1,13640,18432,,4792,PERF
42297350380000,PI,IP,001,1,11600,15503,4585,3903,PERF
42297350390000,PI,IP,001,1,12043,16525,4768,4482,PERF
42297350400000,PI,IP,001,1,12305,17567,5642,5262,PERF
42297350430000,PI,IP,001,1,11882,18399,7280,6517,PERF
42297350440000,PI,IP,001,1,13240,18004,5335,4764,PERF
42297350450000,PI,IP,001,1,12756,17071,4975,4315,PERF
42297350460000,PI,IP,001,1,12250,16312,4339,4062,PERF
42297350470100,PI,IP,001,1,11531,15830,5255,4299,PERF
42297350480000,PI,IP,001,1,11700,15856,5418,4156,PERF
42297350490000,PI,IP,001,1,14174,18702,4825,4528,PERF
42297350500000,PI,IP,001,1,12664,17176,5736,4512,PERF
42297350520000,PI,IP,001,1,12403,17486,5539,5083,PERF
42297350530000,PI,IP,001,1,8303,16571,5762,8268,OPENHOLE
42297350550000,PI,IP,001,1,11937,18078,6886,6141,PERF
42297350560000,PI,IP,001,1,11997,17401,6178,5404,PERF
42297350570000,PI,IP,001,1,11630,15782,5234,4152,PERF
42297350580000,PI,IP,001,1,13050,17442,5268,4392,PERF
42297350590000,PI,IP,001,1,11628,15820,5419,4192,PERF
42297350600000,PI,IP,001,1,11541,15312,4829,3771,PERF
42297350620000,PI,IP,001,1,13460,18503,5220,5043,PERF
42297350630000,PI,IP,001,1,12976,18047,5699,5071,PERF
42297350650000,PI,IP,001,1,12915,18079,5114,5164,PERF
42297350660000,PI,IP,001,1,11533,16185,5289,4652,PERF
42297350670000,PI,IP,001,1,14240,18602,4708,4362,PERF
42297350680000,PI,IP,001,1,13256,18502,5646,5246,PERF
42297350690000,PI,IP,001,1,11842,15397,4537,3555,PERF
42297350700000,PI,IP,001,1,12226,17641,6676,5415,PERF
42297350710000,PI,IP,001,1,12555,17221,5402,4666,PERF
42297350720000,PI,IP,001,1,11819,18080,7281,6261,PERF
42297350730000,PI,IP,001,1,12257,16682,,4425,PERF
42297350750000,PI,IP,001,1,12628,17827,5451,5199,PERF
42297350770000,PI,IP,001,1,11743,15425,4480,3682,PERF
42297350780000,PI,IP,001,1,11712,17340,6515,5628,PERF
42297350790000,PI,IP,001,1,11874,17221,5939,5347,PERF
42297350800000,PI,IP,001,1,11691,16713,5250,5022,PERF
42297350830000,PI,IP,001,1,8725,19067,6149,10342,OPENHOLE
42297350870000,PI,IP,001,1,12914,17896,6241,4982,PERF
42297350880000,PI,IP,001,1,11918,15541,4501,3623,PERF
42297350910000,PI,IP,001,1,11550,15410,4202,3860,PERF
42297350920000,PI,IP,001,1,14745,19226,5202,4481,PERF
42297350930000,PI,IP,001,1,12020,12021,,1,PERF
42297350930000,PI,IP,001,2,12088,12089,,1,PERF
42297350930000,PI,IP,001,3,12156,12157,,1,PERF
42297350930000,PI,IP,001,4,12224,12225,,1,PERF
42297350930000,PI,IP,001,5,12289,12290,,1,PERF
42297350930000,PI,IP,001,6,12354,12355,,1,PERF
42297350930000,PI,IP,001,7,12424,12425,,1,PERF
42297350930000,PI,IP,001,8,12489,12490,,1,PERF
42297350930000,PI,IP,001,9,12554,12555,,1,PERF
42297350930000,PI,IP,001,10,12624,12625,,1,PERF
42297350930000,PI,IP,001,11,12689,12690,,1,PERF
42297350930000,PI,IP,001,12,12754,12755,,1,PERF
42297350930000,PI,IP,001,13,12824,12825,,1,PERF
42297350930000,PI,IP,001,14,12887,12888,,1,PERF
42297350930000,PI,IP,001,15,12950,12951,,1,PERF
42297350930000,PI,IP,001,16,13013,13014,,1,PERF
42297350930000,PI,IP,001,17,13078,13079,,1,PERF
42297350930000,PI,IP,001,18,13141,13142,,1,PERF
42297350930000,PI,IP,001,19,13206,13207,,1,PERF
42297350930000,PI,IP,001,20,13268,13269,,1,PERF
42297350930000,PI,IP,001,21,13331,13332,,1,PERF
42297350930000,PI,IP,001,22,13394,13395,,1,PERF
42297350930000,PI,IP,001,23,13454,13455,,1,PERF
42297350930000,PI,IP,001,24,13514,13515,,1,PERF
42297350930000,PI,IP,001,25,13579,13580,,1,PERF
42297350930000,PI,IP,001,26,13639,13640,,1,PERF
42297350930000,PI,IP,001,27,13699,13700,,1,PERF
42297350930000,PI,IP,001,28,13760,13761,,1,PERF
42297350930000,PI,IP,001,29,13821,13822,,1,PERF
42297350930000,PI,IP,001,30,13882,13883,,1,PERF
42297350930000,PI,IP,001,31,13947,13948,,1,PERF
42297350930000,PI,IP,001,32,14007,14008,,1,PERF
42297350930000,PI,IP,001,33,14067,14068,,1,PERF
42297350930000,PI,IP,001,34,14129,14130,,1,PERF
42297350930000,PI,IP,001,35,14191,14192,,1,PERF
42297350930000,PI,IP,001,36,14253,14254,,1,PERF
42297350930000,PI,IP,001,37,14318,14319,,1,PERF
42297350930000,PI,IP,001,38,14378,14379,,1,PERF
42297350930000,PI,IP,001,39,14438,14439,,1,PERF
42297350930000,PI,IP,001,40,14501,14502,,1,PERF
42297350930000,PI,IP,001,41,14564,14565,,1,PERF
42297350930000,PI,IP,001,42,14627,14628,,1,PERF
42297350930000,PI,IP,001,43,14688,14689,,1,PERF
42297350930000,PI,IP,001,44,14750,14751,,1,PERF
42297350930000,PI,IP,001,45,14812,14813,,1,PERF
42297350930000,PI,IP,001,46,14874,14875,,1,PERF
42297350930000,PI,IP,001,47,14934,14935,,1,PERF
42297350930000,PI,IP,001,48,14994,14995,,1,PERF
42297350930000,PI,IP,001,49,15054,15055,,1,PERF
42297350930000,PI,IP,001,50,15114,15115,,1,PERF
42297350930000,PI,IP,001,51,15174,15175,,1,PERF
42297350930000,PI,IP,001,52,15232,15233,,1,PERF
42297350930000,PI,IP,001,53,15290,15291,,1,PERF
42297350930000,PI,IP,001,54,15350,15351,,1,PERF
42297350930000,PI,IP,001,55,15408,15409,,1,PERF
42297350930000,PI,IP,001,56,15466,15467,,1,PERF
42297350930000,PI,IP,001,57,15524,15525,,1,PERF
42297350930000,PI,IP,001,58,15585,15586,,1,PERF
42297350930000,PI,IP,001,59,15646,15647,,1,PERF
42297350930000,PI,IP,001,60,15707,15708,,1,PERF
42297350930000,PI,IP,001,61,15767,15768,,1,PERF
42297350930000,PI,IP,001,62,15824,15825,,1,PERF
42297350930000,PI,IP,001,63,15884,15885,,1,PERF
42297350930000,PI,IP,001,64,15944,15945,,1,PERF
42297350930000,PI,IP,001,65,16004,16005,,1,PERF
42297350930000,PI,IP,001,66,16064,16065,,1,PERF
42297350930000,PI,IP,001,67,16124,16125,,1,PERF
42297350930000,PI,IP,001,68,16184,16185,,1,PERF
42297350930000,PI,IP,001,69,16239,16240,,1,PERF
42297350930000,PI,IP,001,70,16296,16297,,1,PERF
42297350930000,PI,IP,001,71,16353,16354,,1,PERF
42297350930000,PI,IP,001,72,16413,16414,,1,PERF
42297350930000,PI,IP,001,73,16468,16469,,1,PERF
42297350930000,PI,IP,001,74,16525,16526,,1,PERF
42297350930000,PI,IP,001,75,16581,16582,,1,PERF
42297350930000,PI,IP,001,76,16636,16637,,1,PERF
42297350930000,PI,IP,001,77,16691,16692,,1,PERF
42297350930000,PI,IP,001,78,16746,16747,,1,PERF
42297350930000,PI,IP,001,79,16801,16802,,1,PERF
42297350930000,PI,IP,001,80,16855,16856,,1,PERF
42297350930000,PI,IP,001,81,16910,16911,,1,PERF
42297350930000,PI,IP,001,82,16965,16966,,1,PERF
42297350930000,PI,IP,001,83,17015,17016,,1,PERF
42297350930000,PI,IP,001,84,17065,17066,,1,PERF
42297350930000,PI,IP,001,85,17115,17116,,1,PERF
42297350930000,PI,IP,001,86,17164,17165,,1,PERF
42297350930000,PI,IP,001,87,17211,17212,,1,PERF
42297350940000,PI,IP,001,1,11996,17634,5733,5638,PERF
42297350950000,PI,IP,001,1,13128,17549,5022,4421,PERF
42297350960000,PI,IP,001,1,11900,16794,5965,4894,PERF
42297350980000,PI,IP,001,1,11628,17829,6968,6201,PERF
42297350990000,PI,IP,001,1,11567,16540,5951,4973,PERF
42297351000000,PI,IP,001,1,11679,17062,6812,5383,PERF
42297351030000,PI,IP,001,1,11661,17343,5964,5682,PERF
42297351040000,PI,IP,001,1,12100,15709,4390,3609,PERF
42297351050000,PI,IP,001,1,14135,19036,5711,4901,PERF
42297351090000,PI,IP,001,1,12342,18384,6222,6042,PERF
42297351110000,PI,IP,001,1,12421,16576,4957,4155,PERF
42297351120000,PI,IP,001,1,11354,16387,5804,5033,PERF
42297351130000,PI,IP,001,1,13720,17852,5302,4132,PERF
42297351140000,PI,IP,001,1,14803,19424,5420,4621,PERF
42297351150000,PI,IP,001,1,13280,17451,4444,4171,PERF
42297351160000,PI,IP,001,1,11501,16262,5405,4761,PERF
42297351170000,PI,IP,001,1,11584,14685,,3101,PERF
42297351180000,PI,IP,001,1,11525,13976,3001,2451,PERF
42297351190000,PI,IP,001,1,11260,15251,4358,3991,PERF
42297351220000,PI,IP,001,1,11565,15136,4112,3571,PERF
42297351230000,PI,IP,001,1,11978,15884,4736,3906,PERF
42297351240000,PI,IP,001,1,12910,18651,5846,5741,PERF
42297351250000,PI,IP,001,1,12560,16630,4751,4070,PERF
42297351290000,PI,IP,001,1,14679,19190,5075,4511,PERF
42297351300000,PI,IP,001,1,14549,19191,5436,4642,PERF
42297351310000,PI,IP,001,1,12470,17371,5700,4901,PERF
42297351330000,PI,IP,001,1,12570,17451,5937,4881,PERF
42297351350000,PI,IP,001,1,12820,17872,5785,5052,PERF
42297351370000,PI,IP,001,1,12642,16491,4584,3849,PERF
42297351380000,PI,IP,001,1,12905,18578,7165,5673,PERF
42297351400000,PI,IP,001,1,12336,12587,6311,251,PERF
42297351400000,PI,IP,001,2,12635,12847,6311,212,PERF
42297351400000,PI,IP,001,3,12897,13107,6311,210,PERF
42297351400000,PI,IP,001,4,13155,13367,6311,212,PERF
42297351400000,PI,IP,001,5,13415,13627,6311,212,PERF
42297351400000,PI,IP,001,6,13728,13970,6311,242,PERF
42297351400000,PI,IP,001,7,14048,14290,6311,242,PERF
42297351400000,PI,IP,001,8,14368,14610,6311,242,PERF
42297351400000,PI,IP,001,9,14670,14930,6311,260,PERF
42297351400000,PI,IP,001,10,15008,15250,6311,242,PERF
42297351400000,PI,IP,001,11,15330,15570,6311,240,PERF
42297351400000,PI,IP,001,12,15648,15890,6311,242,PERF
42297351400000,PI,IP,001,13,15970,16210,6311,240,PERF
42297351400000,PI,IP,001,14,16288,16530,6311,242,PERF
42297351400000,PI,IP,001,15,16608,16850,6311,242,PERF
42297351400000,PI,IP,001,16,16946,17113,6311,167,PERF
42297351410000,PI,IP,001,1,13269,18561,6981,5292,PERF
42297351420000,PI,IP,001,1,14370,19321,5087,4951,PERF
42297351430000,PI,IP,001,1,11716,11898,5921,182,PERF
42297351430000,PI,IP,001,2,11951,12142,5921,191,PERF
42297351430000,PI,IP,001,3,12201,12398,5921,197,PERF
42297351430000,PI,IP,001,4,12451,12648,5921,197,PERF
42297351430000,PI,IP,001,5,12701,12952,5921,251,PERF
42297351430000,PI,IP,001,6,12968,13132,5921,164,PERF
42297351430000,PI,IP,001,7,13180,13347,5921,167,PERF
42297351430000,PI,IP,001,8,13395,13562,5921,167,PERF
42297351430000,PI,IP,001,9,13610,13777,5921,167,PERF
42297351430000,PI,IP,001,10,13821,14018,5921,197,PERF
42297351430000,PI,IP,001,11,14086,14328,5921,242,PERF
42297351430000,PI,IP,001,12,14406,14648,5921,242,PERF
42297351430000,PI,IP,001,13,14726,14968,5921,242,PERF
42297351430000,PI,IP,001,14,15046,15288,5921,242,PERF
42297351430000,PI,IP,001,15,15366,15608,5921,242,PERF
42297351430000,PI,IP,001,16,15686,15930,5921,244,PERF
42297351430000,PI,IP,001,17,16006,16248,5921,242,PERF
42297351430000,PI,IP,001,18,16326,16568,5921,242,PERF
42297351430000,PI,IP,001,19,16646,16868,5921,222,PERF
42297351430000,PI,IP,001,20,16966,17238,5921,272,PERF
42297351440000,PI,IP,001,1,11532,16673,6024,5141,PERF
42297351450000,PI,IP,001,1,12370,18842,6241,6472,PERF
42297351460000,PI,IP,001,1,12270,18381,6374,6111,PERF
42297351470000,PI,IP,001,1,11870,16929,5940,5059,PERF
42297351480000,PI,IP,001,1,12103,17013,5840,4910,PERF
42297351490000,PI,IP,001,1,13190,18246,5869,5056,PERF
42297351500000,PI,IP,001,1,12000,12402,5815,402,PERF
42297351500000,PI,IP,001,2,12460,12642,5815,182,PERF
42297351500000,PI,IP,001,3,12706,12882,5815,176,PERF
42297351500000,PI,IP,001,4,12940,13122,5815,182,PERF
42297351500000,PI,IP,001,5,13180,13362,5815,182,PERF
42297351500000,PI,IP,001,6,13420,13602,5815,182,PERF
42297351500000,PI,IP,001,7,13644,13841,5815,197,PERF
42297351500000,PI,IP,001,8,13884,14126,5815,242,PERF
42297351500000,PI,IP,001,9,14204,14442,5815,238,PERF
42297351500000,PI,IP,001,10,14525,14766,5815,241,PERF
42297351500000,PI,IP,001,11,14844,15082,5815,238,PERF
42297351500000,PI,IP,001,12,15164,15406,5815,242,PERF
42297351500000,PI,IP,001,13,15484,15722,5815,238,PERF
42297351500000,PI,IP,001,14,15804,16048,5815,244,PERF
42297351500000,PI,IP,001,15,16124,16366,5815,242,PERF
42297351500000,PI,IP,001,16,16444,16686,5815,242,PERF
42297351500000,PI,IP,001,17,16764,17000,5815,236,PERF
42297351510000,PI,IP,001,1,12620,17041,4818,4421,PERF
42297351540000,PI,IP,001,1,12167,16905,,4738,PERF
42297351560000,PI,IP,001,1,12250,18941,6882,6691,PERF
42297351570000,PI,IP,001,1,14373,19974,6016,5601,PERF
42297351620000,PI,IP,001,1,13158,18901,6364,5743,PERF
42297351630000,PI,IP,001,1,13498,18881,5567,5383,PERF
42297351640000,PI,IP,001,1,12140,16739,5564,4599,PERF
42297351660000,PI,IP,001,1,13080,18401,5980,5321,PERF
42297351670000,PI,IP,001,1,14300,20065,,5765,PERF
42297351680000,PI,IP,001,1,13550,18551,5624,5001,PERF
42297351760000,PI,IP,001,1,12167,17756,,5589,PERF
42297351770100,PI,IP,001,1,12169,17664,5064,5495,PERF
42297351780000,PI,IP,001,1,11970,17003,6653,5033,PERF
42297351790000,PI,IP,001,1,11666,15647,4597,3981,PERF
42297351800000,PI,IP,001,1,12510,12766,8134,256,PERF
42297351800000,PI,IP,001,2,12843,13114,8134,271,PERF
42297351800000,PI,IP,001,3,13191,13462,8134,271,PERF
42297351800000,PI,IP,001,4,13539,13810,8134,271,PERF
42297351800000,PI,IP,001,5,13887,14158,8134,271,PERF
42297351800000,PI,IP,001,6,14235,14506,8134,271,PERF
42297351800000,PI,IP,001,7,14583,14854,8134,271,PERF
42297351800000,PI,IP,001,8,14931,15202,8134,271,PERF
42297351800000,PI,IP,001,9,15279,15550,8134,271,PERF
42297351800000,PI,IP,001,10,15627,15898,8134,271,PERF
42297351800000,PI,IP,001,11,15975,16247,8134,272,PERF
42297351800000,PI,IP,001,12,16323,16595,8134,272,PERF
42297351800000,PI,IP,001,13,16671,16943,8134,272,PERF
42297351810000,PI,IP,001,1,12554,12830,,276,PERF
42297351810000,PI,IP,001,2,12907,13188,,281,PERF
42297351810000,PI,IP,001,3,13265,13546,,281,PERF
42297351810000,PI,IP,001,4,13623,13904,,281,PERF
42297351810000,PI,IP,001,5,13981,14262,,281,PERF
42297351810000,PI,IP,001,6,14339,14620,,281,PERF
42297351810000,PI,IP,001,7,14697,14978,,281,PERF
42297351810000,PI,IP,001,8,15055,15336,,281,PERF
42297351810000,PI,IP,001,9,15413,15694,,281,PERF
42297351810000,PI,IP,001,10,15771,16051,,280,PERF
42297351810000,PI,IP,001,11,16129,16410,,281,PERF
42297351810000,PI,IP,001,12,16487,16765,,278,PERF
42297351810000,PI,IP,001,13,16845,17126,,281,PERF
42297351810000,PI,IP,001,14,17214,17541,,327,PERF
42297351810000,PI,IP,001,15,17639,17920,,281,PERF
42297351810000,PI,IP,001,16,17999,18280,,281,PERF
42297351810000,PI,IP,001,17,18359,18641,,282,PERF
42297351810000,PI,IP,001,18,18720,19000,,280,PERF
42297351810000,PI,IP,001,19,19080,19360,,280,PERF
42297351810000,PI,IP,001,20,19439,19620,,181,PERF
42297351810000,PI,IP,001,21,19709,19981,,272,PERF
42297351840000,PI,IP,001,1,13522,18601,5510,5079,PERF
42297351860000,PI,IP,001,1,12840,17302,,4462,PERF
42297351880000,PI,IP,001,1,11305,15056,4218,3751,PERF
42297351900000,PI,IP,001,1,12857,17679,5139,4822,PERF
42297351910000,PI,IP,001,1,12857,18687,5993,5830,PERF
42297351940000,PI,IP,001,1,13030,19402,,6372,PERF
42297351950000,PI,IP,001,1,13140,19301,6713,6161,PERF
42297351960000,PI,IP,001,1,13080,17981,5402,4901,PERF
42311323700001,PI,IP,001,1,10926,10956,,30,PERF
42311323700001,PI,IP,001,2,10964,10984,,20,PERF
42311323700001,PI,PT,001,1,8986,9002,,16,PERF
42311335760200,PI,IP,001,1,9898,13175,4003,3277,OPENHOLE
42311341160100,PI,IP,001,1,11905,12203,3990,298,PERF
42311341160100,PI,IP,001,2,12275,12573,3990,298,PERF
42311341160100,PI,IP,001,3,12645,12943,3990,298,PERF
42311341160100,PI,IP,001,4,13015,13313,3990,298,PERF
42311341160100,PI,IP,001,5,13385,13683,3990,298,PERF
42311341160100,PI,IP,001,6,13754,14052,3990,298,PERF
42311341160100,PI,IP,001,7,14124,14422,3990,298,PERF
42311341160100,PI,IP,001,8,14494,14792,3990,298,PERF
42311341160100,PI,IP,001,9,14864,15162,3990,298,PERF
42311341160100,PI,IP,001,10,15234,15532,3990,298,PERF
42311341300100,PI,IP,001,1,10991,11029,3629,38,PERF
42311341310100,PI,IP,001,1,11654,11977,4732,323,PERF
42311341310100,PI,IP,001,2,12022,12345,4732,323,PERF
42311341310100,PI,IP,001,3,12390,12713,4732,323,PERF
42311341310100,PI,IP,001,4,12758,13081,4732,323,PERF
42311341310100,PI,IP,001,5,13126,13449,4732,323,PERF
42311341310100,PI,IP,001,6,13494,13817,4732,323,PERF
42311341310100,PI,IP,001,7,13862,14185,4732,323,PERF
42311341310100,PI,IP,001,8,14230,14553,4732,323,PERF
42311341310100,PI,IP,001,9,14598,14921,4732,323,PERF
42311341310100,PI,IP,001,10,14966,15289,4732,323,PERF
42311341310100,PI,IP,001,11,15334,15657,4732,323,PERF
42311341310100,PI,IP,001,12,15702,16025,4732,323,PERF
42311341370000,PI,IP,001,1,12062,15871,4339,3809,PERF
42311341390000,PI,IP,001,1,13600,13811,4188,211,PERF
42311341390000,PI,IP,001,2,13872,14062,4188,190,PERF
42311341390000,PI,IP,001,3,14120,14310,4188,190,PERF
42311341390000,PI,IP,001,4,14368,14558,4188,190,PERF
42311341390000,PI,IP,001,5,14616,14806,4188,190,PERF
42311341390000,PI,IP,001,6,14864,15054,4188,190,PERF
42311341390000,PI,IP,001,7,15112,15302,4188,190,PERF
42311341390000,PI,IP,001,8,15360,15550,4188,190,PERF
42311341390000,PI,IP,001,9,15608,15798,4188,190,PERF
42311341390000,PI,IP,001,10,15856,16046,4188,190,PERF
42311341390000,PI,IP,001,11,16104,16294,4188,190,PERF
42311341390000,PI,IP,001,12,16352,16542,4188,190,PERF
42311341390000,PI,IP,001,13,16600,16790,4188,190,PERF
42311341420000,PI,IP,001,1,12085,12331,4957,246,PERF
42311341420000,PI,IP,001,2,12365,12611,4957,246,PERF
42311341420000,PI,IP,001,3,12645,12891,4957,246,PERF
42311341420000,PI,IP,001,4,12925,13171,4957,246,PERF
42311341420000,PI,IP,001,5,13205,13452,4957,247,PERF
42311341420000,PI,IP,001,6,13485,13731,4957,246,PERF
42311341420000,PI,IP,001,7,13765,14011,4957,246,PERF
42311341420000,PI,IP,001,8,14045,14291,4957,246,PERF
42311341420000,PI,IP,001,9,14325,14571,4957,246,PERF
42311341420000,PI,IP,001,10,14605,14851,4957,246,PERF
42311341420000,PI,IP,001,11,14885,15131,4957,246,PERF
42311341420000,PI,IP,001,12,15165,15411,4957,246,PERF
42311341420000,PI,IP,001,13,15445,15691,4957,246,PERF
42311341420000,PI,IP,001,14,15725,15971,4957,246,PERF
42311341420000,PI,IP,001,15,16005,16251,4957,246,PERF
42311341530000,PI,IP,001,1,11754,11915,4021,161,PERF
42311341530000,PI,IP,001,2,11994,12115,4021,121,PERF
42311341530000,PI,IP,001,3,12154,12316,4021,162,PERF
42311341530000,PI,IP,001,4,12354,12515,4021,161,PERF
42311341530000,PI,IP,001,5,12554,12715,4021,161,PERF
42311341530000,PI,IP,001,6,12754,12915,4021,161,PERF
42311341530000,PI,IP,001,7,12954,13115,4021,161,PERF
42311341530000,PI,IP,001,8,13154,13315,4021,161,PERF
42311341530000,PI,IP,001,9,13354,13515,4021,161,PERF
42311341530000,PI,IP,001,10,13554,13715,4021,161,PERF
42311341530000,PI,IP,001,11,13754,13915,4021,161,PERF
42311341530000,PI,IP,001,12,13954,14115,4021,161,PERF
42311341530000,PI,IP,001,13,14154,14315,4021,161,PERF
42311341530000,PI,IP,001,14,14354,14475,4021,121,PERF
42311341530000,PI,IP,001,15,14554,14715,4021,161,PERF
42311341580000,PI,IP,001,1,15655,17547,,1892,PERF
42311341610000,PI,IP,001,1,10400,10406,4516,6,PERF
42311341610000,PI,IP,001,2,10550,10556,4516,6,PERF
42311341610000,PI,IP,001,3,10687,10693,4516,6,PERF
42311341610000,PI,IP,001,4,10850,10856,4516,6,PERF
42311341610000,PI,IP,001,5,11000,11006,4516,6,PERF
42311341610000,PI,IP,001,6,11152,11158,4516,6,PERF
42311341610000,PI,IP,001,7,11300,11306,4516,6,PERF
42311341610000,PI,IP,001,8,11450,11456,4516,6,PERF
42311341610000,PI,IP,001,9,11600,11606,4516,6,PERF
42311341610000,PI,IP,001,10,11750,11756,4516,6,PERF
42311341610000,PI,IP,001,11,11890,11896,4516,6,PERF
42311341610000,PI,IP,001,12,12050,12056,4516,6,PERF
42311341610000,PI,IP,001,13,12197,12203,4516,6,PERF
42311341610000,PI,IP,001,14,12338,12344,4516,6,PERF
42311341610000,PI,IP,001,15,12500,12506,4516,6,PERF
42311341610000,PI,IP,001,16,12644,12650,4516,6,PERF
42311341610000,PI,IP,001,17,12800,12806,4516,6,PERF
42311341610000,PI,IP,001,18,12952,12956,4516,4,PERF
42311341610000,PI,IP,001,19,13100,13106,4516,6,PERF
42311341610000,PI,IP,001,20,13250,13256,4516,6,PERF
42311341610000,PI,IP,001,21,13397,13403,4516,6,PERF
42311341610000,PI,IP,001,22,13550,13556,4516,6,PERF
42311341610000,PI,IP,001,23,13700,13706,4516,6,PERF
42311341610000,PI,IP,001,24,13869,13875,4516,6,PERF
42311341700000,PI,IP,001,1,10180,10186,5011,6,PERF
42311341700000,PI,IP,001,2,10480,10486,5011,6,PERF
42311341700000,PI,IP,001,3,10780,10786,5011,6,PERF
42311341700000,PI,IP,001,4,11080,11086,5011,6,PERF
42311341700000,PI,IP,001,5,11380,11386,5011,6,PERF
42311341700000,PI,IP,001,6,11680,11686,5011,6,PERF
42311341700000,PI,IP,001,7,11980,11986,5011,6,PERF
42311341700000,PI,IP,001,8,12220,12226,5011,6,PERF
42311341700000,PI,IP,001,9,12280,12286,5011,6,PERF
42311341700000,PI,IP,001,10,12580,12586,5011,6,PERF
42311341700000,PI,IP,001,11,12884,12890,5011,6,PERF
42311341700000,PI,IP,001,12,13180,13186,5011,6,PERF
42311341700000,PI,IP,001,13,13390,13396,5011,6,PERF
42311341700000,PI,IP,001,14,13480,13486,5011,6,PERF
42311341700000,PI,IP,001,15,13780,13786,5011,6,PERF
42311341700000,PI,IP,001,16,14077,14083,5011,6,PERF
42311341700000,PI,IP,001,17,14380,14386,5011,6,PERF
42311341720100,PI,IP,001,1,12141,16725,5005,4584,PERF
42311341760000,PI,IP,001,1,12024,12249,4843,225,PERF
42311341760000,PI,IP,001,2,12334,12566,4843,232,PERF
42311341760000,PI,IP,001,3,12634,12866,4843,232,PERF
42311341760000,PI,IP,001,4,12934,13166,4843,232,PERF
42311341760000,PI,IP,001,5,13234,13466,4843,232,PERF
42311341760000,PI,IP,001,6,13534,13766,4843,232,PERF
42311341760000,PI,IP,001,7,13834,14066,4843,232,PERF
42311341760000,PI,IP,001,8,14134,14366,4843,232,PERF
42311341760000,PI,IP,001,9,14434,14666,4843,232,PERF
42311341760000,PI,IP,001,10,14734,14966,4843,232,PERF
42311341760000,PI,IP,001,11,15034,15266,4843,232,PERF
42311341760000,PI,IP,001,12,15334,15566,4843,232,PERF
42311341760000,PI,IP,001,13,15646,15941,4843,295,PERF
42311341770000,PI,IP,001,1,12710,13208,7298,498,PERF
42311341770000,PI,IP,001,2,13278,13776,7298,498,PERF
42311341770000,PI,IP,001,3,13846,14344,7298,498,PERF
42311341770000,PI,IP,001,4,14414,14912,7298,498,PERF
42311341770000,PI,IP,001,5,14982,15480,7298,498,PERF
42311341770000,PI,IP,001,6,15550,16048,7298,498,PERF
42311341770000,PI,IP,001,7,16118,16616,7298,498,PERF
42311341770000,PI,IP,001,8,16686,17184,7298,498,PERF
42311341770000,PI,IP,001,9,17254,17752,7298,498,PERF
42311341770000,PI,IP,001,10,17822,18320,7298,498,PERF
42311341770000,PI,IP,001,11,18390,18888,7298,498,PERF
42311341860000,PI,IP,001,1,12427,18195,6268,5768,PERF
42311341870000,PI,IP,001,1,12522,17468,5694,4946,PERF
42311341960100,PI,IP,001,1,12450,12700,4595,250,PERF
42311341960100,PI,IP,001,2,12750,13000,4595,250,PERF
42311341960100,PI,IP,001,3,13850,14100,4595,250,PERF
42311341960100,PI,IP,001,4,14150,14400,4595,250,PERF
42311341960100,PI,IP,001,5,14450,14700,4595,250,PERF
42311341960100,PI,IP,001,6,14750,15000,4595,250,PERF
42311341960100,PI,IP,001,7,15050,15300,4595,250,PERF
42311341960100,PI,IP,001,8,15350,15600,4595,250,PERF
42311341960100,PI,IP,001,9,15700,15950,4595,250,PERF
42311341970000,PI,IP,001,1,11017,11249,4785,232,PERF
42311341970000,PI,IP,001,2,11314,11546,4785,232,PERF
42311341970000,PI,IP,001,3,11611,11843,4785,232,PERF
42311341970000,PI,IP,001,4,11908,12140,4785,232,PERF
42311341970000,PI,IP,001,5,12205,12437,4785,232,PERF
42311341970000,PI,IP,001,6,12502,12734,4785,232,PERF
42311341970000,PI,IP,001,7,12799,13031,4785,232,PERF
42311341970000,PI,IP,001,8,13096,13328,4785,232,PERF
42311341970000,PI,IP,001,9,13393,13625,4785,232,PERF
42311341970000,PI,IP,001,10,13685,13827,4785,142,PERF
42311341970000,PI,IP,001,11,13937,14134,4785,197,PERF
42311341970000,PI,IP,001,12,14189,14386,4785,197,PERF
42311341990000,PI,IP,001,1,13113,18801,6335,5688,PERF
42311342010000,PI,IP,001,1,13272,18953,6242,5681,PERF
42311342070100,PI,IP,001,1,13150,18201,5588,5051,PERF
42311342090000,PI,IP,001,1,11929,12196,5142,267,PERF
42311342090000,PI,IP,001,2,12271,12538,5142,267,PERF
42311342090000,PI,IP,001,3,12613,12880,5142,267,PERF
42311342090000,PI,IP,001,4,12955,13222,5142,267,PERF
42311342090000,PI,IP,001,5,13297,13564,5142,267,PERF
42311342090000,PI,IP,001,6,13639,13906,5142,267,PERF
42311342090000,PI,IP,001,7,13981,14248,5142,267,PERF
42311342090000,PI,IP,001,8,14323,14590,5142,267,PERF
42311342090000,PI,IP,001,9,14665,14932,5142,267,PERF
42311342090000,PI,IP,001,10,15007,15274,5142,267,PERF
42311342090000,PI,IP,001,11,15349,15616,5142,267,PERF
42311342090000,PI,IP,001,12,15681,15878,5142,197,PERF
42311342090000,PI,IP,001,13,15933,16130,5142,197,PERF
42311342090000,PI,IP,001,14,16185,16382,5142,197,PERF
42311342110000,PI,IP,001,1,11350,11666,4689,316,PERF
42311342110000,PI,IP,001,2,11747,12070,4689,323,PERF
42311342110000,PI,IP,001,3,12152,12475,4689,323,PERF
42311342110000,PI,IP,001,4,12557,12880,4689,323,PERF
42311342110000,PI,IP,001,5,12962,13285,4689,323,PERF
42311342110000,PI,IP,001,6,13367,13690,4689,323,PERF
42311342110000,PI,IP,001,7,13772,14095,4689,323,PERF
42311342110000,PI,IP,001,8,14375,14635,4689,260,PERF
42311342110000,PI,IP,001,9,14708,14968,4689,260,PERF
42311342170000,PI,IP,001,1,10895,11068,4420,173,PERF
42311342180000,PI,IP,001,1,11144,11295,4479,151,PERF
42311342180000,PI,IP,001,2,11407,11558,4479,151,PERF
42311342180000,PI,IP,001,3,11670,11821,4479,151,PERF
42311342180000,PI,IP,001,4,11933,12084,4479,151,PERF
42311342180000,PI,IP,001,5,12196,12347,4479,151,PERF
42311342180000,PI,IP,001,6,12459,12610,4479,151,PERF
42311342180000,PI,IP,001,7,12722,12873,4479,151,PERF
42311342180000,PI,IP,001,8,12985,13136,4479,151,PERF
42311342180000,PI,IP,001,9,13248,13399,4479,151,PERF
42311342180000,PI,IP,001,10,13511,13662,4479,151,PERF
42311342180000,PI,IP,001,11,13774,13925,4479,151,PERF
42311342180000,PI,IP,001,12,14037,14188,4479,151,PERF
42311342180000,PI,IP,001,13,14300,14451,4479,151,PERF
42311342180000,PI,IP,001,14,14563,14714,4479,151,PERF
42311342180000,PI,IP,001,15,14826,14977,4479,151,PERF
42311342180000,PI,IP,001,16,15089,15240,4479,151,PERF
42311342190000,PI,IP,001,1,10889,14700,4250,3811,PERF
42311342200000,PI,IP,001,1,9743,9994,7532,251,PERF
42311342200000,PI,IP,001,2,10086,10383,7532,297,PERF
42311342200000,PI,IP,001,3,10429,10680,7532,251,PERF
42311342200000,PI,IP,001,4,10772,11023,7532,251,PERF
42311342200000,PI,IP,001,5,11115,11366,7532,251,PERF
42311342200000,PI,IP,001,6,11458,11709,7532,251,PERF
42311342200000,PI,IP,001,7,11801,12051,7532,250,PERF
42311342200000,PI,IP,001,8,12144,12395,7532,251,PERF
42311342200000,PI,IP,001,9,12487,12738,7532,251,PERF
42311342200000,PI,IP,001,10,12830,13081,7532,251,PERF
42311342200000,PI,IP,001,11,13173,13424,7532,251,PERF
42311342200000,PI,IP,001,12,13516,13767,7532,251,PERF
42311342200000,PI,IP,001,13,13859,14110,7532,251,PERF
42311342200000,PI,IP,001,14,14202,14453,7532,251,PERF
42311342200000,PI,IP,001,15,14545,14796,7532,251,PERF
42311342200000,PI,IP,001,16,14888,15139,7532,251,PERF
42311342200000,PI,IP,001,17,15231,15482,7532,251,PERF
42311342200000,PI,IP,001,18,15574,15825,7532,251,PERF
42311342200000,PI,IP,001,19,15917,16168,7532,251,PERF
42311342200000,PI,IP,001,20,16243,16495,7532,252,PERF
42311342230000,PI,IP,001,1,12704,18809,6655,6105,PERF
42311342240000,PI,IP,001,1,11788,16031,5031,4243,PERF
42311342270000,PI,IP,001,1,12024,16336,5029,4312,PERF
42311342290000,PI,IP,001,1,13128,18217,5816,5089,PERF
42311342300000,PI,IP,001,1,12107,15379,4957,3272,PERF
42311342320000,PI,IP,001,1,11597,15774,5084,4177,PERF
42311342330000,PI,IP,001,1,9953,10164,5212,211,PERF
42311342330000,PI,IP,001,2,10263,11094,5212,831,PERF
42311342330000,PI,IP,001,3,11193,11714,5212,521,PERF
42311342330000,PI,IP,001,4,11813,12024,5212,211,PERF
42311342330000,PI,IP,001,5,12123,12334,5212,211,PERF
42311342330000,PI,IP,001,6,12433,12644,5212,211,PERF
42311342330000,PI,IP,001,7,12743,12954,5212,211,PERF
42311342330000,PI,IP,001,8,13053,13234,5212,181,PERF
42311342330000,PI,IP,001,9,13263,13264,5212,1,PERF
42311342330000,PI,IP,001,10,13363,13574,5212,211,PERF
42311342330000,PI,IP,001,11,13673,13884,5212,211,PERF
42311342330000,PI,IP,001,12,13983,14194,5212,211,PERF
42311342330000,PI,IP,001,13,14293,14500,5212,207,PERF
42311342360000,PI,IP,003,1,11627,16276,4986,4649,PERF
42311342390000,PI,IP,001,1,9864,9866,6130,2,PERF
42311342390000,PI,IP,001,2,9924,9926,6130,2,PERF
42311342390000,PI,IP,001,3,9984,9986,6130,2,PERF
42311342390000,PI,IP,001,4,10044,10046,6130,2,PERF
42311342390000,PI,IP,001,5,10104,10106,6130,2,PERF
42311342390000,PI,IP,001,6,10164,10166,6130,2,PERF
42311342390000,PI,IP,001,7,10224,10226,6130,2,PERF
42311342390000,PI,IP,001,8,10318,10320,6130,2,PERF
42311342390000,PI,IP,001,9,10378,10380,6130,2,PERF
42311342390000,PI,IP,001,10,10438,10440,6130,2,PERF
42311342390000,PI,IP,001,11,10498,10500,6130,2,PERF
42311342390000,PI,IP,001,12,10558,10560,6130,2,PERF
42311342390000,PI,IP,001,13,10618,10620,6130,2,PERF
42311342390000,PI,IP,001,14,10678,10680,6130,2,PERF
42311342390000,PI,IP,001,15,10772,10774,6130,2,PERF
42311342390000,PI,IP,001,16,10832,10834,6130,2,PERF
42311342390000,PI,IP,001,17,10892,10894,6130,2,PERF
42311342390000,PI,IP,001,18,10952,10954,6130,2,PERF
42311342390000,PI,IP,001,19,11012,11014,6130,2,PERF
42311342390000,PI,IP,001,20,11072,11074,6130,2,PERF
42311342390000,PI,IP,001,21,11132,11134,6130,2,PERF
42311342390000,PI,IP,001,22,11226,11228,6130,2,PERF
42311342390000,PI,IP,001,23,11286,11288,6130,2,PERF
42311342390000,PI,IP,001,24,11346,11348,6130,2,PERF
42311342390000,PI,IP,001,25,11406,11408,6130,2,PERF
42311342390000,PI,IP,001,26,11466,11468,6130,2,PERF
42311342390000,PI,IP,001,27,11526,11528,6130,2,PERF
42311342390000,PI,IP,001,28,11586,11588,6130,2,PERF
42311342390000,PI,IP,001,29,11680,11682,6130,2,PERF
42311342390000,PI,IP,001,30,11740,11742,6130,2,PERF
42311342390000,PI,IP,001,31,11800,11802,6130,2,PERF
42311342390000,PI,IP,001,32,11860,11862,6130,2,PERF
42311342390000,PI,IP,001,33,11920,11922,6130,2,PERF
42311342390000,PI,IP,001,34,11980,11982,6130,2,PERF
42311342390000,PI,IP,001,35,12040,12042,6130,2,PERF
42311342390000,PI,IP,001,36,12134,12136,6130,2,PERF
42311342390000,PI,IP,001,37,12194,12196,6130,2,PERF
42311342390000,PI,IP,001,38,12254,12256,6130,2,PERF
42311342390000,PI,IP,001,39,12314,12316,6130,2,PERF
42311342390000,PI,IP,001,40,12374,12376,6130,2,PERF
42311342390000,PI,IP,001,41,12434,12436,6130,2,PERF
42311342390000,PI,IP,001,42,12494,12496,6130,2,PERF
42311342390000,PI,IP,001,43,12588,12590,6130,2,PERF
42311342390000,PI,IP,001,44,12648,12650,6130,2,PERF
42311342390000,PI,IP,001,45,12708,12710,6130,2,PERF
42311342390000,PI,IP,001,46,12768,12770,6130,2,PERF
42311342390000,PI,IP,001,47,12828,12830,6130,2,PERF
42311342390000,PI,IP,001,48,12888,12890,6130,2,PERF
42311342390000,PI,IP,001,49,12948,12950,6130,2,PERF
42311342390000,PI,IP,001,50,13042,13044,6130,2,PERF
42311342390000,PI,IP,001,51,13102,13104,6130,2,PERF
42311342390000,PI,IP,001,52,13162,13164,6130,2,PERF
42311342390000,PI,IP,001,53,13222,13224,6130,2,PERF
42311342390000,PI,IP,001,54,13282,13284,6130,2,PERF
42311342390000,PI,IP,001,55,13342,13344,6130,2,PERF
42311342390000,PI,IP,001,56,13402,13404,6130,2,PERF
42311342390000,PI,IP,001,57,13496,13498,6130,2,PERF
42311342390000,PI,IP,001,58,13556,13558,6130,2,PERF
42311342390000,PI,IP,001,59,13616,13618,6130,2,PERF
42311342390000,PI,IP,001,60,13676,13678,6130,2,PERF
42311342390000,PI,IP,001,61,13736,13738,6130,2,PERF
42311342390000,PI,IP,001,62,13796,13798,6130,2,PERF
42311342390000,PI,IP,001,63,13856,13858,6130,2,PERF
42311342390000,PI,IP,001,64,13950,13952,6130,2,PERF
42311342390000,PI,IP,001,65,14010,14012,6130,2,PERF
42311342390000,PI,IP,001,66,14070,14072,6130,2,PERF
42311342390000,PI,IP,001,67,14130,14132,6130,2,PERF
42311342390000,PI,IP,001,68,14190,14192,6130,2,PERF
42311342390000,PI,IP,001,69,14250,14252,6130,2,PERF
42311342390000,PI,IP,001,70,14310,14312,6130,2,PERF
42311342390000,PI,IP,001,71,14404,14406,6130,2,PERF
42311342390000,PI,IP,001,72,14464,14466,6130,2,PERF
42311342390000,PI,IP,001,73,14524,14526,6130,2,PERF
42311342390000,PI,IP,001,74,14584,14586,6130,2,PERF
42311342390000,PI,IP,001,75,14644,14646,6130,2,PERF
42311342390000,PI,IP,001,76,14704,14706,6130,2,PERF
42311342390000,PI,IP,001,77,14764,14766,6130,2,PERF
42311342390000,PI,IP,001,78,14858,14860,6130,2,PERF
42311342390000,PI,IP,001,79,14918,14920,6130,2,PERF
42311342390000,PI,IP,001,80,14978,14980,6130,2,PERF
42311342390000,PI,IP,001,81,15038,15040,6130,2,PERF
42311342390000,PI,IP,001,82,15098,15100,6130,2,PERF
42311342390000,PI,IP,001,83,15158,15160,6130,2,PERF
42311342390000,PI,IP,001,84,15218,15220,6130,2,PERF
42311342410000,PI,IP,001,1,10078,15045,5564,4967,PERF
42311342460000,PI,IP,001,1,12790,18343,6076,5553,PERF
42311342470000,PI,IP,001,1,10870,10872,4891,2,PERF
42311342470000,PI,IP,001,2,10945,10947,4891,2,PERF
42311342470000,PI,IP,001,3,11028,11030,4891,2,PERF
42311342470000,PI,IP,001,4,11095,11099,4891,4,PERF
42311342470000,PI,IP,001,5,11180,11182,4891,2,PERF
42311342470000,PI,IP,001,6,11250,11252,4891,2,PERF
42311342470000,PI,IP,001,7,11330,11332,4891,2,PERF
42311342470000,PI,IP,001,8,11405,11409,4891,4,PERF
42311342470000,PI,IP,001,9,11496,11498,4891,2,PERF
42311342470000,PI,IP,001,10,11545,11567,4891,22,PERF
42311342470000,PI,IP,001,11,11640,11642,4891,2,PERF
42311342470000,PI,IP,001,12,11706,11710,4891,4,PERF
42311342470000,PI,IP,001,13,11800,11802,4891,2,PERF
42311342470000,PI,IP,001,14,11875,11877,4891,2,PERF
42311342470000,PI,IP,001,15,11944,11946,4891,2,PERF
42311342470000,PI,IP,001,16,12025,12059,4891,34,PERF
42311342470000,PI,IP,001,17,12110,12112,4891,2,PERF
42311342470000,PI,IP,001,18,12185,12187,4891,2,PERF
42311342470000,PI,IP,001,19,12260,12262,4891,2,PERF
42311342470000,PI,IP,001,20,12335,12339,4891,4,PERF
42311342470000,PI,IP,001,21,12420,12422,4891,2,PERF
42311342470000,PI,IP,001,22,12495,12497,4891,2,PERF
42311342470000,PI,IP,001,23,12570,12572,4891,2,PERF
42311342470000,PI,IP,001,24,12650,12654,4891,4,PERF
42311342470000,PI,IP,001,25,12728,12730,4891,2,PERF
42311342470000,PI,IP,001,26,12805,12807,4891,2,PERF
42311342470000,PI,IP,001,27,12880,12882,4891,2,PERF
42311342470000,PI,IP,001,28,12955,12959,4891,4,PERF
42311342470000,PI,IP,001,29,13040,13042,4891,2,PERF
42311342470000,PI,IP,001,30,13115,13117,4891,2,PERF
42311342470000,PI,IP,001,31,13188,13190,4891,2,PERF
42311342470000,PI,IP,001,32,13265,13269,4891,4,PERF
42311342470000,PI,IP,001,33,13350,13352,4891,2,PERF
42311342470000,PI,IP,001,34,13418,13420,4891,2,PERF
42311342470000,PI,IP,001,35,13500,13502,4891,2,PERF
42311342470000,PI,IP,001,36,13575,13579,4891,4,PERF
42311342470000,PI,IP,001,37,13650,13652,4891,2,PERF
42311342470000,PI,IP,001,38,13735,13737,4891,2,PERF
42311342470000,PI,IP,001,39,13810,13812,4891,2,PERF
42311342470000,PI,IP,001,40,13885,13889,4891,4,PERF
42311342470000,PI,IP,001,41,13970,13972,4891,2,PERF
42311342470000,PI,IP,001,42,14045,14047,4891,2,PERF
42311342470000,PI,IP,001,43,14130,14132,4891,2,PERF
42311342470000,PI,IP,001,44,14195,14199,4891,4,PERF
42311342470000,PI,IP,001,45,14280,14283,4891,3,PERF
42311342470000,PI,IP,001,46,14355,14358,4891,3,PERF
42311342470000,PI,IP,001,47,14430,14436,4891,6,PERF
42311342480000,PI,IP,001,1,13008,18191,5628,5183,PERF
42311342490000,PI,IP,001,1,9963,14404,6006,4441,PERF
42311342500100,PI,IP,001,1,11169,11320,4943,151,PERF
42311342500100,PI,IP,001,2,11419,11570,4943,151,PERF
42311342500100,PI,IP,001,3,11669,11820,4943,151,PERF
42311342500100,PI,IP,001,4,11919,12070,4943,151,PERF
42311342500100,PI,IP,001,5,12169,12320,4943,151,PERF
42311342500100,PI,IP,001,6,12419,12570,4943,151,PERF
42311342500100,PI,IP,001,7,12669,12820,4943,151,PERF
42311342500100,PI,IP,001,8,12919,13070,4943,151,PERF
42311342500100,PI,IP,001,9,13169,13320,4943,151,PERF
42311342500100,PI,IP,001,10,13419,13570,4943,151,PERF
42311342500100,PI,IP,001,11,13669,13820,4943,151,PERF
42311342500100,PI,IP,001,12,13919,14070,4943,151,PERF
42311342500100,PI,IP,001,13,14169,14320,4943,151,PERF
42311342500100,PI,IP,001,14,14419,14570,4943,151,PERF
42311342500100,PI,IP,001,15,14669,14820,4943,151,PERF
42311342500100,PI,IP,001,16,14919,15070,4943,151,PERF
42311342500100,PI,IP,001,17,15169,15320,4943,151,PERF
42311342560000,PI,IP,001,1,10310,10671,,361,PERF
42311342560000,PI,IP,001,2,10788,11149,,361,PERF
42311342560000,PI,IP,001,3,11266,11627,,361,PERF
42311342560000,PI,IP,001,4,11744,12105,,361,PERF
42311342560000,PI,IP,001,5,12222,12583,,361,PERF
42311342560000,PI,IP,001,6,12700,13061,,361,PERF
42311342560000,PI,IP,001,7,13178,13539,,361,PERF
42311342560000,PI,IP,001,8,13656,14017,,361,PERF
42311342560000,PI,IP,001,9,14134,14495,,361,PERF
42311342560000,PI,IP,001,10,14612,14973,,361,PERF
42311342560000,PI,IP,001,11,15071,15225,,154,PERF
42311342600100,PI,IP,001,1,10971,11204,4648,233,PERF
42311342600100,PI,IP,001,2,11263,11496,4648,233,PERF
42311342600100,PI,IP,001,3,11555,11788,4648,233,PERF
42311342600100,PI,IP,001,4,11847,12080,4648,233,PERF
42311342600100,PI,IP,001,5,12199,12432,4648,233,PERF
42311342600100,PI,IP,001,6,12491,12724,4648,233,PERF
42311342600100,PI,IP,001,7,12800,13016,4648,216,PERF
42311342600100,PI,IP,001,8,13075,13308,4648,233,PERF
42311342600100,PI,IP,001,9,13367,13560,4648,193,PERF
42311342600100,PI,IP,001,10,13659,13892,4648,233,PERF
42311342600100,PI,IP,001,11,13951,14184,4648,233,PERF
42311342600100,PI,IP,001,12,14243,14476,4648,233,PERF
42311342600100,PI,IP,001,13,14534,14768,4648,234,PERF
42311342600100,PI,IP,001,14,14827,15003,4648,176,PERF
42311342650000,PI,IP,001,1,10388,10590,4834,202,PERF
42311342650000,PI,IP,001,2,10705,10790,4834,85,PERF
42311342650000,PI,IP,001,3,10798,10910,4834,112,PERF
42311342650000,PI,IP,001,4,11018,15070,4834,4052,PERF
42311342660000,PI,IP,001,1,11100,15711,5149,4611,PERF
42311342670000,PI,IP,001,1,9479,9481,7008,2,PERF
42311342670000,PI,IP,001,2,9539,9541,7008,2,PERF
42311342670000,PI,IP,001,3,9599,9601,7008,2,PERF
42311342670000,PI,IP,001,4,9659,9661,7008,2,PERF
42311342670000,PI,IP,001,5,9719,9721,7008,2,PERF
42311342670000,PI,IP,001,6,9779,9781,7008,2,PERF
42311342670000,PI,IP,001,7,9902,9904,7008,2,PERF
42311342670000,PI,IP,001,8,9962,9964,7008,2,PERF
42311342670000,PI,IP,001,9,10022,10024,7008,2,PERF
42311342670000,PI,IP,001,10,10082,10084,7008,2,PERF
42311342670000,PI,IP,001,11,10142,10144,7008,2,PERF
42311342670000,PI,IP,001,12,10202,10204,7008,2,PERF
42311342670000,PI,IP,001,13,10325,10327,7008,2,PERF
42311342670000,PI,IP,001,14,10385,10387,7008,2,PERF
42311342670000,PI,IP,001,15,10445,10447,7008,2,PERF
42311342670000,PI,IP,001,16,10505,10507,7008,2,PERF
42311342670000,PI,IP,001,17,10565,10567,7008,2,PERF
42311342670000,PI,IP,001,18,10625,10627,7008,2,PERF
42311342670000,PI,IP,001,19,10748,10750,7008,2,PERF
42311342670000,PI,IP,001,20,10808,10810,7008,2,PERF
42311342670000,PI,IP,001,21,10868,10870,7008,2,PERF
42311342670000,PI,IP,001,22,10928,10930,7008,2,PERF
42311342670000,PI,IP,001,23,11048,11050,7008,2,PERF
42311342670000,PI,IP,001,24,11171,11173,7008,2,PERF
42311342670000,PI,IP,001,25,11231,11233,7008,2,PERF
42311342670000,PI,IP,001,26,11291,11293,7008,2,PERF
42311342670000,PI,IP,001,27,11351,11353,7008,2,PERF
42311342670000,PI,IP,001,28,11411,11413,7008,2,PERF
42311342670000,PI,IP,001,29,11471,11473,7008,2,PERF
42311342670000,PI,IP,001,30,11594,11596,7008,2,PERF
42311342670000,PI,IP,001,31,11654,11656,7008,2,PERF
42311342670000,PI,IP,001,32,11714,11716,7008,2,PERF
42311342670000,PI,IP,001,33,11774,11776,7008,2,PERF
42311342670000,PI,IP,001,34,11834,11836,7008,2,PERF
42311342670000,PI,IP,001,35,11894,11896,7008,2,PERF
42311342670000,PI,IP,001,36,12017,12019,7008,2,PERF
42311342670000,PI,IP,001,37,12077,12079,7008,2,PERF
42311342670000,PI,IP,001,38,12137,12139,7008,2,PERF
42311342670000,PI,IP,001,39,12197,12199,7008,2,PERF
42311342670000,PI,IP,001,40,12257,12259,7008,2,PERF
42311342670000,PI,IP,001,41,12317,12319,7008,2,PERF
42311342670000,PI,IP,001,42,12440,12442,7008,2,PERF
42311342670000,PI,IP,001,43,12500,12502,7008,2,PERF
42311342670000,PI,IP,001,44,12560,12562,7008,2,PERF
42311342670000,PI,IP,001,45,12620,12622,7008,2,PERF
42311342670000,PI,IP,001,46,12680,12682,7008,2,PERF
42311342670000,PI,IP,001,47,12740,12742,7008,2,PERF
42311342670000,PI,IP,001,48,12863,12865,7008,2,PERF
42311342670000,PI,IP,001,49,12923,12925,7008,2,PERF
42311342670000,PI,IP,001,50,12983,12985,7008,2,PERF
42311342670000,PI,IP,001,51,13043,13045,7008,2,PERF
42311342670000,PI,IP,001,52,13103,13105,7008,2,PERF
42311342670000,PI,IP,001,53,13163,13165,7008,2,PERF
42311342670000,PI,IP,001,54,13286,13288,7008,2,PERF
42311342670000,PI,IP,001,55,13346,13348,7008,2,PERF
42311342670000,PI,IP,001,56,13406,13408,7008,2,PERF
42311342670000,PI,IP,001,57,13466,13468,7008,2,PERF
42311342670000,PI,IP,001,58,13526,13528,7008,2,PERF
42311342670000,PI,IP,001,59,13586,13588,7008,2,PERF
42311342670000,PI,IP,001,60,13709,13711,7008,2,PERF
42311342670000,PI,IP,001,61,13769,13771,7008,2,PERF
42311342670000,PI,IP,001,62,13829,13831,7008,2,PERF
42311342670000,PI,IP,001,63,13889,13891,7008,2,PERF
42311342670000,PI,IP,001,64,13949,13951,7008,2,PERF
42311342670000,PI,IP,001,65,14009,14011,7008,2,PERF
42311342670000,PI,IP,001,66,14132,14134,7008,2,PERF
42311342670000,PI,IP,001,67,14192,14194,7008,2,PERF
42311342670000,PI,IP,001,68,14252,14254,7008,2,PERF
42311342670000,PI,IP,001,69,14312,14314,7008,2,PERF
42311342670000,PI,IP,001,70,14372,14374,7008,2,PERF
42311342670000,PI,IP,001,71,14432,14434,7008,2,PERF
42311342670000,PI,IP,001,72,14555,14557,7008,2,PERF
42311342670000,PI,IP,001,73,14615,14617,7008,2,PERF
42311342670000,PI,IP,001,74,14675,14677,7008,2,PERF
42311342670000,PI,IP,001,75,14735,14737,7008,2,PERF
42311342670000,PI,IP,001,76,14795,14797,7008,2,PERF
42311342670000,PI,IP,001,77,14855,14857,7008,2,PERF
42311342670000,PI,IP,001,78,14978,14980,7008,2,PERF
42311342670000,PI,IP,001,79,15038,15040,7008,2,PERF
42311342670000,PI,IP,001,80,15098,15100,7008,2,PERF
42311342670000,PI,IP,001,81,15158,15160,7008,2,PERF
42311342670000,PI,IP,001,82,15218,15220,7008,2,PERF
42311342670000,PI,IP,001,83,15278,15280,7008,2,PERF
42311342670000,PI,IP,001,84,15401,15403,7008,2,PERF
42311342670000,PI,IP,001,85,15461,15463,7008,2,PERF
42311342670000,PI,IP,001,86,15521,15523,7008,2,PERF
42311342670000,PI,IP,001,87,15581,15583,7008,2,PERF
42311342670000,PI,IP,001,88,15641,15643,7008,2,PERF
42311342670000,PI,IP,001,89,15701,15703,7008,2,PERF
42311342670000,PI,IP,001,90,15824,15826,7008,2,PERF
42311342670000,PI,IP,001,91,15884,15886,7008,2,PERF
42311342670000,PI,IP,001,92,15944,15946,7008,2,PERF
42311342670000,PI,IP,001,93,16004,16006,7008,2,PERF
42311342670000,PI,IP,001,94,16064,16066,7008,2,PERF
42311342670000,PI,IP,001,95,16124,16126,7008,2,PERF
42311342670000,PI,IP,001,96,16238,16240,7008,2,PERF
42311342670000,PI,IP,001,97,16278,16280,7008,2,PERF
42311342670000,PI,IP,001,98,16318,16320,7008,2,PERF
42311342670000,PI,IP,001,99,16358,16360,7008,2,PERF
42311342670000,PI,IP,001,100,16398,16400,7008,2,PERF
42311342690000,PI,IP,001,1,11576,11885,6139,309,PERF
42311342690000,PI,IP,001,2,11961,12270,6139,309,PERF
42311342690000,PI,IP,001,3,12346,12655,6139,309,PERF
42311342690000,PI,IP,001,4,12731,13040,6139,309,PERF
42311342690000,PI,IP,001,5,13121,13425,6139,304,PERF
42311342690000,PI,IP,001,6,13501,13810,6139,309,PERF
42311342690000,PI,IP,001,7,13886,14195,6139,309,PERF
42311342690000,PI,IP,001,8,14271,14580,6139,309,PERF
42311342690000,PI,IP,001,9,14656,14965,6139,309,PERF
42311342690000,PI,IP,001,10,15044,15329,6139,285,PERF
42311342690000,PI,IP,001,11,15426,15735,6139,309,PERF
42311342690000,PI,IP,001,12,15811,16120,6139,309,PERF
42311342690000,PI,IP,001,13,16196,16505,6139,309,PERF
42311342690000,PI,IP,001,14,16581,16880,6139,299,PERF
42311342690000,PI,IP,001,15,16966,17275,6139,309,PERF
42311342700000,PI,IP,001,1,12810,19061,6781,6251,PERF
42311342710000,PI,IP,001,1,10029,15760,6041,5731,PERF
42311342720000,PI,IP,001,1,11190,11480,7079,290,PERF
42311342720000,PI,IP,001,2,11550,11840,7079,290,PERF
42311342720000,PI,IP,001,3,11910,12185,7079,275,PERF
42311342720000,PI,IP,001,4,12266,12560,7079,294,PERF
42311342720000,PI,IP,001,5,12630,12920,7079,290,PERF
42311342720000,PI,IP,001,6,12992,13282,7079,290,PERF
42311342720000,PI,IP,001,7,13350,13640,7079,290,PERF
42311342720000,PI,IP,001,8,13710,13982,7079,272,PERF
42311342720000,PI,IP,001,9,14066,14368,7079,302,PERF
42311342720000,PI,IP,001,10,14430,14720,7079,290,PERF
42311342720000,PI,IP,001,11,14790,15080,7079,290,PERF
42311342720000,PI,IP,001,12,15150,15440,7079,290,PERF
42311342720000,PI,IP,001,13,15510,15784,7079,274,PERF
42311342720000,PI,IP,001,14,15870,16160,7079,290,PERF
42311342720000,PI,IP,001,15,16230,16520,7079,290,PERF
42311342720000,PI,IP,001,16,16590,16880,7079,290,PERF
42311342720000,PI,IP,001,17,16950,17240,7079,290,PERF
42311342720000,PI,IP,001,18,17310,17600,7079,290,PERF
42311342720000,PI,IP,001,19,17665,17864,7079,199,PERF
42311342730001,PI,IP,001,1,11632,11927,,295,PERF
42311342730001,PI,IP,001,2,12021,12250,,229,PERF
42311342730001,PI,IP,001,3,12401,12701,,300,PERF
42311342730001,PI,IP,001,4,12786,13086,,300,PERF
42311342730001,PI,IP,001,5,13161,13466,,305,PERF
42311342730001,PI,IP,001,6,13541,13846,,305,PERF
42311342730001,PI,IP,001,7,13926,14226,,300,PERF
42311342730001,PI,IP,001,8,14301,14606,,305,PERF
42311342730001,PI,IP,001,9,14681,14986,,305,PERF
42311342730001,PI,IP,001,10,15058,15348,,290,PERF
42311342730001,PI,IP,001,11,15441,15744,,303,PERF
42311342730001,PI,IP,001,12,15821,16127,,306,PERF
42311342730001,PI,IP,001,13,16201,16507,,306,PERF
42311342730001,PI,IP,001,14,16581,16887,,306,PERF
42311342730001,PI,IP,001,15,16961,17267,,306,PERF
42311342730001,PI,IP,001,16,17341,17647,,306,PERF
42311342730001,PI,IP,001,17,17718,17988,,270,PERF
42311342730001,PI,IP,001,18,18071,18336,,265,PERF
42311342770000,PI,IP,001,1,12000,19113,7815,7113,PERF
42311342780000,PI,IP,001,1,9914,15806,,5892,PERF
42311342790000,PI,IP,001,1,9964,15763,5984,5799,PERF
42311342800000,PI,IP,002,1,10289,17690,7712,7401,PERF
42311342800000,PI,PT,001,1,17339,17340,7712,1,PERF
42311342800000,PI,PT,001,2,17389,17390,7712,1,PERF
42311342800000,PI,PT,001,3,17439,17440,7712,1,PERF
42311342800000,PI,PT,001,4,17489,17490,7712,1,PERF
42311342800000,PI,PT,001,5,17539,17540,7712,1,PERF
42311342800000,PI,PT,001,6,17589,17590,7712,1,PERF
42311342800000,PI,PT,001,7,17639,17640,7712,1,PERF
42311342800000,PI,PT,001,8,17689,17690,7712,1,PERF
42311342810000,PI,IP,001,1,10747,14300,4970,3553,PERF
42311342830000,PI,IP,001,1,10255,16300,6267,6045,PERF
42311342840000,PI,IP,001,1,12000,12250,4967,250,PERF
42311342840000,PI,IP,001,2,12300,12550,4967,250,PERF
42311342840000,PI,IP,001,3,12600,12850,4967,250,PERF
42311342840000,PI,IP,001,4,12900,13150,4967,250,PERF
42311342840000,PI,IP,001,5,13200,13450,4967,250,PERF
42311342840000,PI,IP,001,6,13500,13750,4967,250,PERF
42311342840000,PI,IP,001,7,13800,14050,4967,250,PERF
42311342840000,PI,IP,001,8,14100,14350,4967,250,PERF
42311342840000,PI,IP,001,9,14400,14650,4967,250,PERF
42311342840000,PI,IP,001,10,14700,14950,4967,250,PERF
42311342840000,PI,IP,001,11,15000,15250,4967,250,PERF
42311342840000,PI,IP,001,12,15300,15550,4967,250,PERF
42311342840000,PI,IP,001,13,15600,15850,4967,250,PERF
42311342840000,PI,IP,001,14,15900,16150,4967,250,PERF
42311342840000,PI,IP,001,15,16200,16450,4967,250,PERF
42311342850000,PI,IP,001,1,10979,16616,6390,5637,PERF
42311342860000,PI,IP,001,1,11112,15770,5393,4658,PERF
42311342870000,PI,IP,001,1,10525,15225,5088,4700,PERF
42311342890000,PI,IP,001,1,12157,17478,6028,5321,PERF
42311342910000,PI,IP,001,1,9724,16211,6645,6487,PERF
42311342930000,PI,IP,001,1,9736,15410,5934,5674,PERF
42311342940000,PI,IP,001,1,9521,15580,6338,6059,PERF
42311342950000,PI,IP,001,1,9727,14400,,4673,PERF
42311342960100,PI,IP,001,1,9311,9622,6438,311,PERF
42311342960100,PI,IP,001,2,9686,9997,6438,311,PERF
42311342960100,PI,IP,001,3,10061,10372,6438,311,PERF
42311342960100,PI,IP,001,4,10436,10747,6438,311,PERF
42311342960100,PI,IP,001,5,10811,11122,6438,311,PERF
42311342960100,PI,IP,001,6,11186,11497,6438,311,PERF
42311342960100,PI,IP,001,7,11561,11872,6438,311,PERF
42311342960100,PI,IP,001,8,11936,12247,6438,311,PERF
42311342960100,PI,IP,001,9,12311,12622,6438,311,PERF
42311342960100,PI,IP,001,10,12686,12997,6438,311,PERF
42311342960100,PI,IP,001,11,13061,13372,6438,311,PERF
42311342960100,PI,IP,001,12,13436,13747,6438,311,PERF
42311342960100,PI,IP,001,13,13811,14122,6438,311,PERF
42311342960100,PI,IP,001,14,14186,14497,6438,311,PERF
42311342960100,PI,IP,001,15,14561,14872,6438,311,PERF
42311342960100,PI,IP,001,16,14936,15186,6438,250,PERF
42311342970000,PI,IP,001,1,10149,15135,5951,4986,PERF
42311342990000,PI,IP,002,1,9510,16925,8028,7415,PERF
42311342990000,PI,PT,001,1,9510,16925,8028,7415,PERF
42311343010000,PI,IP,001,1,11043,11211,5634,168,PERF
42311343010000,PI,IP,001,2,11295,11463,5634,168,PERF
42311343010000,PI,IP,001,3,11547,11715,5634,168,PERF
42311343010000,PI,IP,001,4,11809,12014,5634,205,PERF
42311343010000,PI,IP,001,5,12117,12322,5634,205,PERF
42311343010000,PI,IP,001,6,12425,12631,5634,206,PERF
42311343010000,PI,IP,001,7,12733,12939,5634,206,PERF
42311343010000,PI,IP,001,8,13042,13247,5634,205,PERF
42311343010000,PI,IP,001,9,13350,13555,5634,205,PERF
42311343010000,PI,IP,001,10,13608,13864,5634,256,PERF
42311343010000,PI,IP,001,11,13966,14172,5634,206,PERF
42311343010000,PI,IP,001,12,14280,14480,5634,200,PERF
42311343010000,PI,IP,001,13,14583,14788,5634,205,PERF
42311343010000,PI,IP,001,14,14891,15097,5634,206,PERF
42311343010000,PI,IP,001,15,15508,15713,5634,205,PERF
42311343020000,PI,IP,001,1,11692,17147,6320,5455,PERF
42311343040000,PI,IP,001,1,9478,13770,4703,4292,PERF
42311343050100,PI,IP,001,1,12700,12950,5097,250,PERF
42311343050100,PI,IP,001,2,13000,13250,5097,250,PERF
42311343050100,PI,IP,001,3,13300,13550,5097,250,PERF
42311343050100,PI,IP,001,4,13600,13850,5097,250,PERF
42311343050100,PI,IP,001,5,13900,14150,5097,250,PERF
42311343050100,PI,IP,001,6,14200,14450,5097,250,PERF
42311343050100,PI,IP,001,7,14500,14750,5097,250,PERF
42311343050100,PI,IP,001,8,14800,15050,5097,250,PERF
42311343050100,PI,IP,001,9,15100,15350,5097,250,PERF
42311343050100,PI,IP,001,10,15400,15650,5097,250,PERF
42311343050100,PI,IP,001,11,15700,15950,5097,250,PERF
42311343050100,PI,IP,001,12,16000,16250,5097,250,PERF
42311343050100,PI,IP,001,13,16300,16550,5097,250,PERF
42311343050100,PI,IP,001,14,16600,16850,5097,250,PERF
42311343050100,PI,IP,001,15,16900,17150,5097,250,PERF
42311343070000,PI,IP,001,1,10846,10848,4911,2,PERF
42311343070000,PI,IP,001,2,10908,10910,4911,2,PERF
42311343070000,PI,IP,001,3,10972,10974,4911,2,PERF
42311343070000,PI,IP,001,4,11032,11034,4911,2,PERF
42311343070000,PI,IP,001,5,11117,11119,4911,2,PERF
42311343070000,PI,IP,001,6,11179,11181,4911,2,PERF
42311343070000,PI,IP,001,7,11241,11243,4911,2,PERF
42311343070000,PI,IP,001,8,11303,11305,4911,2,PERF
42311343070000,PI,IP,001,9,11388,11390,4911,2,PERF
42311343070000,PI,IP,001,10,11450,11452,4911,2,PERF
42311343070000,PI,IP,001,11,11512,11514,4911,2,PERF
42311343070000,PI,IP,001,12,11574,11576,4911,2,PERF
42311343070000,PI,IP,001,13,11659,11661,4911,2,PERF
42311343070000,PI,IP,001,14,11721,11723,4911,2,PERF
42311343070000,PI,IP,001,15,11783,11785,4911,2,PERF
42311343070000,PI,IP,001,16,11845,11847,4911,2,PERF
42311343070000,PI,IP,001,17,11930,11932,4911,2,PERF
42311343070000,PI,IP,001,18,11992,11994,4911,2,PERF
42311343070000,PI,IP,001,19,12054,12056,4911,2,PERF
42311343070000,PI,IP,001,20,12116,12118,4911,2,PERF
42311343070000,PI,IP,001,21,12263,12265,4911,2,PERF
42311343070000,PI,IP,001,22,12325,12327,4911,2,PERF
42311343070000,PI,IP,001,23,12387,12389,4911,2,PERF
42311343070000,PI,IP,001,24,12472,12474,4911,2,PERF
42311343070000,PI,IP,001,25,12530,12532,4911,2,PERF
42311343070000,PI,IP,001,26,12596,12598,4911,2,PERF
42311343070000,PI,IP,001,27,12658,12660,4911,2,PERF
42311343070000,PI,IP,001,28,12742,12744,4911,2,PERF
42311343070000,PI,IP,001,29,12845,12847,4911,2,PERF
42311343070000,PI,IP,001,30,12866,12868,4911,2,PERF
42311343070000,PI,IP,001,31,12928,12930,4911,2,PERF
42311343070000,PI,IP,001,32,13284,13286,4911,2,PERF
42311343070000,PI,IP,001,33,13346,13348,4911,2,PERF
42311343070000,PI,IP,001,34,13408,13410,4911,2,PERF
42311343070000,PI,IP,001,35,13470,13472,4911,2,PERF
42311343070000,PI,IP,001,36,13555,13557,4911,2,PERF
42311343070000,PI,IP,001,37,13617,13619,4911,2,PERF
42311343070000,PI,IP,001,38,13679,13681,4911,2,PERF
42311343070000,PI,IP,001,39,13741,13743,4911,2,PERF
42311343070000,PI,IP,001,40,13826,13828,4911,2,PERF
42311343070000,PI,IP,001,41,13888,13890,4911,2,PERF
42311343070000,PI,IP,001,42,13950,13952,4911,2,PERF
42311343070000,PI,IP,001,43,14012,14014,4911,2,PERF
42311343070000,PI,IP,001,44,14097,14099,4911,2,PERF
42311343070000,PI,IP,001,45,14159,14161,4911,2,PERF
42311343070000,PI,IP,001,46,14221,14223,4911,2,PERF
42311343070000,PI,IP,001,47,14283,14285,4911,2,PERF
42311343070000,PI,IP,001,48,14368,14370,4911,2,PERF
42311343070000,PI,IP,001,49,14430,14432,4911,2,PERF
42311343070000,PI,IP,001,50,14492,14494,4911,2,PERF
42311343070000,PI,IP,001,51,14554,14556,4911,2,PERF
42311343070000,PI,IP,001,52,14641,14643,4911,2,PERF
42311343070000,PI,IP,001,53,14703,14704,4911,1,PERF
42311343070000,PI,IP,001,54,14764,14766,4911,2,PERF
42311343070000,PI,IP,001,55,14826,14827,4911,1,PERF
42311343080100,PI,IP,001,1,10745,11051,6532,306,PERF
42311343080100,PI,IP,001,2,11112,11418,6532,306,PERF
42311343080100,PI,IP,001,3,11479,11785,6532,306,PERF
42311343080100,PI,IP,001,4,11846,12152,6532,306,PERF
42311343080100,PI,IP,001,5,12213,12519,6532,306,PERF
42311343080100,PI,IP,001,6,12580,12886,6532,306,PERF
42311343080100,PI,IP,001,7,12947,13253,6532,306,PERF
42311343080100,PI,IP,001,8,13314,13620,6532,306,PERF
42311343080100,PI,IP,001,9,13681,13987,6532,306,PERF
42311343080100,PI,IP,001,10,14048,14354,6532,306,PERF
42311343080100,PI,IP,001,11,14415,14721,6532,306,PERF
42311343080100,PI,IP,001,12,14782,15088,6532,306,PERF
42311343080100,PI,IP,001,13,15149,15455,6532,306,PERF
42311343080100,PI,IP,001,14,15516,15822,6532,306,PERF
42311343080100,PI,IP,001,15,15883,16189,6532,306,PERF
42311343080100,PI,IP,001,16,16250,16556,6532,306,PERF
42311343080100,PI,IP,001,17,16617,16863,6532,246,PERF
42311343180000,PI,IP,001,1,10380,15922,5706,5542,PERF
42311343190000,PI,IP,001,1,10779,16560,5908,5781,PERF
42311343200000,PI,IP,001,1,10566,16395,,5829,PERF
42311343210000,PI,PT,001,1,11590,13341,,1751,PERF
42311343270000,PI,IP,001,1,12544,16281,4784,3737,PERF
42311343370000,PI,IP,001,1,10569,15153,5087,4584,PERF
42311343400000,PI,IP,001,1,11977,19088,7823,7111,PERF
42311343690000,PI,IP,001,1,10671,16070,5613,5399,PERF
42311343940000,PI,IP,001,1,10419,15140,5824,4721,PERF
42311344500000,PI,IP,001,1,12679,18351,6515,5672,PERF
42311344530000,PI,IP,001,1,12800,13050,4748,250,PERF
42311344530000,PI,IP,001,2,13100,13350,4748,250,PERF
42311344530000,PI,IP,001,3,13400,13650,4748,250,PERF
42311344530000,PI,IP,001,4,13700,13950,4748,250,PERF
42311344530000,PI,IP,001,5,14000,14250,4748,250,PERF
42311344530000,PI,IP,001,6,14300,14550,4748,250,PERF
42311344530000,PI,IP,001,7,14600,14850,4748,250,PERF
42311344530000,PI,IP,001,8,14900,15150,4748,250,PERF
42311344530000,PI,IP,001,9,15200,15450,4748,250,PERF
42311344530000,PI,IP,001,10,15500,15750,4748,250,PERF
42311344530000,PI,IP,001,11,15800,16050,4748,250,PERF
42311344530000,PI,IP,001,12,16100,16350,4748,250,PERF
42311344530000,PI,IP,001,13,16400,16650,4748,250,PERF
42311344530000,PI,IP,001,14,16700,16950,4748,250,PERF
42311344540000,PI,IP,001,1,10454,15005,5999,4551,PERF
42311344580000,PI,IP,001,1,11800,16205,4769,4405,PERF
42311344590000,PI,IP,001,1,12030,16331,4844,4301,PERF
42311344700000,PI,IP,001,1,10468,15900,5710,5432,PERF
42311344760000,PI,IP,001,1,11836,17291,6111,5455,PERF
42311344780000,PI,IP,001,1,10911,17185,6747,6274,PERF
42311344800000,PI,IP,001,1,10786,17243,6736,6457,PERF
42311344800000,PI,PT,001,1,10786,17243,6736,6457,PERF
42311344840000,PI,IP,002,1,10816,15001,5013,4185,PERF
42311344840000,PI,PT,001,1,10816,15001,5013,4185,PERF
42311344920000,PI,IP,001,1,11178,11504,5533,326,PERF
42311344920000,PI,IP,001,2,11565,11891,5533,326,PERF
42311344920000,PI,IP,001,3,11952,12165,5533,213,PERF
42311344920000,PI,IP,001,4,12224,12515,5533,291,PERF
42311344920000,PI,IP,001,5,12574,12865,5533,291,PERF
42311344920000,PI,IP,001,6,12924,13215,5533,291,PERF
42311344920000,PI,IP,001,7,13274,13565,5533,291,PERF
42311344920000,PI,IP,001,8,13624,13915,5533,291,PERF
42311344920000,PI,IP,001,9,13974,14265,5533,291,PERF
42311344920000,PI,IP,001,10,14324,14615,5533,291,PERF
42311344920000,PI,IP,001,11,14674,14965,5533,291,PERF
42311344920000,PI,IP,001,12,15024,15315,5533,291,PERF
42311344920000,PI,IP,001,13,15374,15665,5533,291,PERF
42311344920000,PI,IP,001,14,15724,16015,5533,291,PERF
42311344920000,PI,IP,001,15,16074,16308,5533,234,PERF
42311344950000,PI,IP,001,1,12800,13000,5325,200,PERF
42311344950000,PI,IP,001,2,13050,13300,5325,250,PERF
42311344950000,PI,IP,001,3,13350,13600,5325,250,PERF
42311344950000,PI,IP,001,4,13900,14100,5325,200,PERF
42311344950000,PI,IP,001,5,14150,14400,5325,250,PERF
42311344950000,PI,IP,001,6,14450,14700,5325,250,PERF
42311344950000,PI,IP,001,7,14750,15000,5325,250,PERF
42311344950000,PI,IP,001,8,15050,15300,5325,250,PERF
42311344950000,PI,IP,001,9,15350,15600,5325,250,PERF
42311344950000,PI,IP,001,10,15650,15900,5325,250,PERF
42311344950000,PI,IP,001,11,15950,16200,5325,250,PERF
42311344950000,PI,IP,001,12,16250,16500,5325,250,PERF
42311344950000,PI,IP,001,13,16550,16800,5325,250,PERF
42311344950000,PI,IP,001,14,16850,17100,5325,250,PERF
42311344950000,PI,IP,001,15,17150,17400,5325,250,PERF
42311344960000,PI,IP,001,1,10360,15792,5566,5432,PERF
42311344980000,PI,IP,001,1,12335,17815,6443,5480,PERF
42311345010100,PI,IP,001,1,10182,10413,5562,231,PERF
42311345010100,PI,IP,001,2,10472,10703,5562,231,PERF
42311345010100,PI,IP,001,3,10762,10993,5562,231,PERF
42311345010100,PI,IP,001,4,11052,11283,5562,231,PERF
42311345010100,PI,IP,001,5,11388,11573,5562,185,PERF
42311345010100,PI,IP,001,6,11632,11863,5562,231,PERF
42311345010100,PI,IP,001,7,11922,12153,5562,231,PERF
42311345010100,PI,IP,001,8,12212,12443,5562,231,PERF
42311345010100,PI,IP,001,9,12502,12733,5562,231,PERF
42311345010100,PI,IP,001,10,12792,13023,5562,231,PERF
42311345010100,PI,IP,001,11,13082,13313,5562,231,PERF
42311345010100,PI,IP,001,12,13372,13603,5562,231,PERF
42311345010100,PI,IP,001,13,13662,13893,5562,231,PERF
42311345010100,PI,IP,001,14,13952,14183,5562,231,PERF
42311345010100,PI,IP,001,15,14242,14473,5562,231,PERF
42311345010100,PI,IP,001,16,14532,14763,5562,231,PERF
42311345010100,PI,IP,001,17,14822,15008,5562,186,PERF
42311345050000,PI,IP,001,1,11763,18983,7763,7220,PERF
42311345060000,PI,IP,001,1,10404,15275,5662,4871,PERF
42311345090000,PI,IP,001,1,13150,13400,5404,250,PERF
42311345090000,PI,IP,001,2,13450,13700,5404,250,PERF
42311345090000,PI,IP,001,3,13750,14000,5404,250,PERF
42311345090000,PI,IP,001,4,14050,14300,5404,250,PERF
42311345090000,PI,IP,001,5,14350,14600,5404,250,PERF
42311345090000,PI,IP,001,6,14650,14900,5404,250,PERF
42311345090000,PI,IP,001,7,14950,15200,5404,250,PERF
42311345090000,PI,IP,001,8,15250,15500,5404,250,PERF
42311345090000,PI,IP,001,9,15550,15800,5404,250,PERF
42311345090000,PI,IP,001,10,15850,16100,5404,250,PERF
42311345090000,PI,IP,001,11,16150,16400,5404,250,PERF
42311345090000,PI,IP,001,12,16450,16700,5404,250,PERF
42311345090000,PI,IP,001,13,16750,17000,5404,250,PERF
42311345090000,PI,IP,001,14,17050,17300,5404,250,PERF
42311345090000,PI,IP,001,15,17350,17600,5404,250,PERF
42311345100000,PI,IP,001,1,11251,16317,5996,5066,PERF
42311345110000,PI,IP,002,1,12031,18543,7072,6512,PERF
42311345110000,PI,PT,001,1,12031,18543,7072,6512,PERF
42311345120000,PI,IP,001,1,13048,19377,7094,6329,PERF
42311345140000,PI,IP,001,1,11978,16544,5243,4566,PERF
42311345180000,PI,IP,001,1,11589,16298,5110,4709,PERF
42311345190000,PI,IP,001,1,10513,17802,,7289,PERF
42311345210000,PI,IP,001,1,11388,11699,5871,311,PERF
42311345210000,PI,IP,001,2,11760,12071,5871,311,PERF
42311345210000,PI,IP,001,3,12132,12443,5871,311,PERF
42311345210000,PI,IP,001,4,12504,12815,5871,311,PERF
42311345210000,PI,IP,001,5,12876,13187,5871,311,PERF
42311345210000,PI,IP,001,6,13248,13559,5871,311,PERF
42311345210000,PI,IP,001,7,13620,13931,5871,311,PERF
42311345210000,PI,IP,001,8,13992,14303,5871,311,PERF
42311345210000,PI,IP,001,9,14364,14675,5871,311,PERF
42311345210000,PI,IP,001,10,14736,15047,5871,311,PERF
42311345210000,PI,IP,001,11,15108,15419,5871,311,PERF
42311345210000,PI,IP,001,12,15480,15791,5871,311,PERF
42311345210000,PI,IP,001,13,15852,16163,5871,311,PERF
42311345210000,PI,IP,001,14,16224,16535,5871,311,PERF
42311345210000,PI,IP,001,15,16596,16846,5871,250,PERF
42311345230000,PI,IP,001,1,12267,17358,5849,5091,PERF
42311345240000,PI,IP,001,1,12460,16301,4451,3841,PERF
42311345250000,PI,IP,001,1,12798,18831,6775,6033,PERF
42311345260000,PI,IP,001,1,12240,17562,6108,5322,PERF
42311345270000,PI,IP,002,1,12236,16660,5014,4424,PERF
42311345270000,PI,PT,001,1,12236,16660,5014,4424,PERF
42311345280000,PI,IP,001,1,9419,9740,6982,321,PERF
42311345280000,PI,IP,001,2,9804,10125,6982,321,PERF
42311345280000,PI,IP,001,3,10189,10510,6982,321,PERF
42311345280000,PI,IP,001,4,10574,10895,6982,321,PERF
42311345280000,PI,IP,001,5,10959,11280,6982,321,PERF
42311345280000,PI,IP,001,6,11344,11665,6982,321,PERF
42311345280000,PI,IP,001,7,11729,12050,6982,321,PERF
42311345280000,PI,IP,001,8,12114,12435,6982,321,PERF
42311345280000,PI,IP,001,9,12499,12820,6982,321,PERF
42311345280000,PI,IP,001,10,12884,13205,6982,321,PERF
42311345280000,PI,IP,001,11,13269,13590,6982,321,PERF
42311345280000,PI,IP,001,12,13654,13975,6982,321,PERF
42311345280000,PI,IP,001,13,14039,14360,6982,321,PERF
42311345280000,PI,IP,001,14,14424,14745,6982,321,PERF
42311345280000,PI,IP,001,15,14809,15130,6982,321,PERF
42311345280000,PI,IP,001,16,15194,15515,6982,321,PERF
42311345280000,PI,IP,001,17,15579,15900,6982,321,PERF
42311345300000,PI,IP,001,1,10972,14989,5021,4017,PERF
42311345310000,PI,IP,001,1,11427,16820,5828,5393,PERF
42311345320000,PI,IP,001,1,11945,16096,4502,4151,PERF
42311345330000,PI,IP,001,1,10411,15895,,5484,PERF
42311345340000,PI,IP,001,1,11343,17000,6526,5657,PERF
42311345350000,PI,IP,001,1,10017,17496,7830,7479,PERF
42311345360000,PI,IP,001,1,10547,16070,5830,5523,PERF
42311345370000,PI,IP,001,1,10566,15915,5529,5349,PERF
42311345380000,PI,IP,001,1,12794,18680,,5886,PERF
42311345390000,PI,IP,001,1,11170,11436,5151,266,PERF
42311345390000,PI,IP,001,2,11493,11759,5151,266,PERF
42311345390000,PI,IP,001,3,11816,12082,5151,266,PERF
42311345390000,PI,IP,001,4,12139,12405,5151,266,PERF
42311345390000,PI,IP,001,5,12462,12728,5151,266,PERF
42311345390000,PI,IP,001,6,12785,13051,5151,266,PERF
42311345390000,PI,IP,001,7,13108,13374,5151,266,PERF
42311345390000,PI,IP,001,8,13431,13697,5151,266,PERF
42311345390000,PI,IP,001,9,13754,14020,5151,266,PERF
42311345390000,PI,IP,001,10,14077,14343,5151,266,PERF
42311345390000,PI,IP,001,11,14400,14666,5151,266,PERF
42311345390000,PI,IP,001,12,14723,14989,5151,266,PERF
42311345390000,PI,IP,001,13,15046,15312,5151,266,PERF
42311345390000,PI,IP,001,14,15369,15635,5151,266,PERF
42311345390000,PI,IP,001,15,15680,15906,5151,226,PERF
42311345400000,PI,IP,001,1,9377,14255,5037,4878,PERF
42311345410000,PI,IP,001,1,11375,17241,6802,5866,PERF
42311345420000,PI,IP,002,1,11020,15658,5537,4638,PERF
42311345420000,PI,PT,001,1,11020,11240,5537,220,PERF
42311345420000,PI,PT,001,2,11300,11490,5537,190,PERF
42311345420000,PI,PT,001,3,11580,11770,5537,190,PERF
42311345420000,PI,PT,001,4,11860,12040,5537,180,PERF
42311345420000,PI,PT,001,5,12130,12320,5537,190,PERF
42311345420000,PI,PT,001,6,12410,12590,5537,180,PERF
42311345420000,PI,PT,001,7,12680,12870,5537,190,PERF
42311345420000,PI,PT,001,8,12960,13145,5537,185,PERF
42311345420000,PI,PT,001,9,13200,13380,5537,180,PERF
42311345420000,PI,PT,001,10,13440,13630,5537,190,PERF
42311345420000,PI,PT,001,11,13710,13940,5537,230,PERF
42311345420000,PI,PT,001,12,14000,14180,5537,180,PERF
42311345420000,PI,PT,001,13,14235,14475,5537,240,PERF
42311345420000,PI,PT,001,14,14560,14750,5537,190,PERF
42311345420000,PI,PT,001,15,14840,15020,5537,180,PERF
42311345420000,PI,PT,001,16,15110,15310,5537,200,PERF
42311345420000,PI,PT,001,17,15380,15658,5537,278,PERF
42311345430000,PI,IP,001,1,9999,15848,6061,5849,PERF
42311345440000,PI,IP,001,1,11306,17021,6791,5715,PERF
42311345450001,PI,IP,001,1,11356,17617,,6261,PERF
42311345460000,PI,IP,001,1,12300,12550,4574,250,PERF
42311345460000,PI,IP,001,2,12600,12850,4574,250,PERF
42311345460000,PI,IP,001,3,12900,13150,4574,250,PERF
42311345460000,PI,IP,001,4,13200,13450,4574,250,PERF
42311345460000,PI,IP,001,5,13500,13750,4574,250,PERF
42311345460000,PI,IP,001,6,13800,14050,4574,250,PERF
42311345460000,PI,IP,001,7,14100,14350,4574,250,PERF
42311345460000,PI,IP,001,8,14400,14650,4574,250,PERF
42311345460000,PI,IP,001,9,14700,14950,4574,250,PERF
42311345460000,PI,IP,001,10,15000,15250,4574,250,PERF
42311345460000,PI,IP,001,11,15300,15550,4574,250,PERF
42311345460000,PI,IP,001,12,15600,15850,4574,250,PERF
42311345460000,PI,IP,001,13,15900,16150,4574,250,PERF
42311345470000,PI,IP,001,1,9783,15337,6302,5554,PERF
42311345480000,PI,IP,001,1,12692,17321,5528,4629,PERF
42311345490000,PI,IP,001,1,10600,17996,8140,7396,PERF
42311345500000,PI,IP,001,1,12670,15246,5425,2576,PERF
42311345530000,PI,IP,001,1,11221,11512,5589,291,PERF
42311345530000,PI,IP,001,2,11571,11862,5589,291,PERF
42311345530000,PI,IP,001,3,11921,12212,5589,291,PERF
42311345530000,PI,IP,001,4,12271,12562,5589,291,PERF
42311345530000,PI,IP,001,5,12621,12912,5589,291,PERF
42311345530000,PI,IP,001,6,12971,13262,5589,291,PERF
42311345530000,PI,IP,001,7,13321,13612,5589,291,PERF
42311345530000,PI,IP,001,8,13671,13962,5589,291,PERF
42311345530000,PI,IP,001,9,14021,14312,5589,291,PERF
42311345530000,PI,IP,001,10,14371,14662,5589,291,PERF
42311345530000,PI,IP,001,11,14721,15012,5589,291,PERF
42311345530000,PI,IP,001,12,15071,15362,5589,291,PERF
42311345530000,PI,IP,001,13,15421,15712,5589,291,PERF
42311345530000,PI,IP,001,14,15771,16062,5589,291,PERF
42311345530000,PI,IP,001,15,16121,16355,5589,234,PERF
42311345540000,PI,IP,001,1,11452,11758,5691,306,PERF
42311345540000,PI,IP,001,2,11818,12124,5691,306,PERF
42311345540000,PI,IP,001,3,12184,12490,5691,306,PERF
42311345540000,PI,IP,001,4,12550,12856,5691,306,PERF
42311345540000,PI,IP,001,5,12916,13222,5691,306,PERF
42311345540000,PI,IP,001,6,13282,13588,5691,306,PERF
42311345540000,PI,IP,001,7,13648,13954,5691,306,PERF
42311345540000,PI,IP,001,8,14014,14320,5691,306,PERF
42311345540000,PI,IP,001,9,14380,14686,5691,306,PERF
42311345540000,PI,IP,001,10,14746,15052,5691,306,PERF
42311345540000,PI,IP,001,11,15112,15418,5691,306,PERF
42311345540000,PI,IP,001,12,15478,15784,5691,306,PERF
42311345540000,PI,IP,001,13,15844,16150,5691,306,PERF
42311345540000,PI,IP,001,14,16210,16516,5691,306,PERF
42311345540000,PI,IP,001,15,16576,16822,5691,246,PERF
42311345570000,PI,IP,001,1,11156,15460,5398,4304,PERF
42311345580000,PI,IP,001,1,11392,11593,5239,201,PERF
42311345580000,PI,IP,001,2,11652,11853,5239,201,PERF
42311345580000,PI,IP,001,3,11912,12113,5239,201,PERF
42311345580000,PI,IP,001,4,12172,12373,5239,201,PERF
42311345580000,PI,IP,001,5,12432,12633,5239,201,PERF
42311345580000,PI,IP,001,6,12692,12893,5239,201,PERF
42311345580000,PI,IP,001,7,12952,13153,5239,201,PERF
42311345580000,PI,IP,001,8,13212,13413,5239,201,PERF
42311345580000,PI,IP,001,9,13472,13673,5239,201,PERF
42311345580000,PI,IP,001,10,13732,13933,5239,201,PERF
42311345580000,PI,IP,001,11,13992,14193,5239,201,PERF
42311345580000,PI,IP,001,12,14252,14453,5239,201,PERF
42311345580000,PI,IP,001,13,14512,14713,5239,201,PERF
42311345580000,PI,IP,001,14,14772,14973,5239,201,PERF
42311345580000,PI,IP,001,15,15032,15233,5239,201,PERF
42311345580000,PI,IP,001,16,15292,15493,5239,201,PERF
42311345580000,PI,IP,001,17,15552,15753,5239,201,PERF
42311345580000,PI,IP,001,18,15812,16013,5239,201,PERF
42311345580000,PI,IP,001,19,16072,16273,5239,201,PERF
42311345580000,PI,IP,001,20,16332,16494,5239,162,PERF
42311345590000,PI,IP,001,1,11267,11674,7740,407,PERF
42311345590000,PI,IP,001,2,11733,12140,7740,407,PERF
42311345590000,PI,IP,001,3,12199,12606,7740,407,PERF
42311345590000,PI,IP,001,4,12665,13072,7740,407,PERF
42311345590000,PI,IP,001,5,13131,13538,7740,407,PERF
42311345590000,PI,IP,001,6,13597,14004,7740,407,PERF
42311345590000,PI,IP,001,7,14063,14470,7740,407,PERF
42311345590000,PI,IP,001,8,14529,14936,7740,407,PERF
42311345590000,PI,IP,001,9,14995,15402,7740,407,PERF
42311345590000,PI,IP,001,10,15461,15868,7740,407,PERF
42311345590000,PI,IP,001,11,15927,16334,7740,407,PERF
42311345590000,PI,IP,001,12,16393,16800,7740,407,PERF
42311345590000,PI,IP,001,13,16859,17266,7740,407,PERF
42311345590000,PI,IP,001,14,17325,17732,7740,407,PERF
42311345590000,PI,IP,001,15,17791,18198,7740,407,PERF
42311345590000,PI,IP,001,16,18257,18553,7740,296,PERF
42311345600000,PI,IP,001,1,11214,11621,8507,407,PERF
42311345600000,PI,IP,001,2,11680,12088,8507,408,PERF
42311345600000,PI,IP,001,3,12146,12553,8507,407,PERF
42311345600000,PI,IP,001,4,12612,13019,8507,407,PERF
42311345600000,PI,IP,001,5,13078,13485,8507,407,PERF
42311345600000,PI,IP,001,6,13544,13951,8507,407,PERF
42311345600000,PI,IP,001,7,14010,14417,8507,407,PERF
42311345600000,PI,IP,001,8,14476,14883,8507,407,PERF
42311345600000,PI,IP,001,9,14942,15349,8507,407,PERF
42311345600000,PI,IP,001,10,15408,15815,8507,407,PERF
42311345600000,PI,IP,001,11,15874,16281,8507,407,PERF
42311345600000,PI,IP,001,12,16340,16747,8507,407,PERF
42311345600000,PI,IP,001,13,16806,17213,8507,407,PERF
42311345600000,PI,IP,001,14,17272,17679,8507,407,PERF
42311345600000,PI,IP,001,15,17738,18145,8507,407,PERF
42311345600000,PI,IP,001,16,18204,18611,8507,407,PERF
42311345600000,PI,IP,001,17,18670,19077,8507,407,PERF
42311345600000,PI,IP,001,18,19136,19427,8507,291,PERF
42311345640000,PI,IP,001,1,10924,15056,5052,4132,PERF
42311345660000,PI,IP,001,1,10779,16984,6004,6205,PERF
42311345680000,PI,IP,001,1,12400,12650,4836,250,PERF
42311345680000,PI,IP,001,2,12700,12950,4836,250,PERF
42311345680000,PI,IP,001,3,13000,13250,4836,250,PERF
42311345680000,PI,IP,001,4,13300,13550,4836,250,PERF
42311345680000,PI,IP,001,5,13600,13850,4836,250,PERF
42311345680000,PI,IP,001,6,13900,14150,4836,250,PERF
42311345680000,PI,IP,001,7,14200,14450,4836,250,PERF
42311345680000,PI,IP,001,8,14500,14750,4836,250,PERF
42311345680000,PI,IP,001,9,14800,15050,4836,250,PERF
42311345680000,PI,IP,001,10,15100,15350,4836,250,PERF
42311345680000,PI,IP,001,11,15400,15650,4836,250,PERF
42311345680000,PI,IP,001,12,15700,15950,4836,250,PERF
42311345680000,PI,IP,001,13,16000,16250,4836,250,PERF
42311345680000,PI,IP,001,14,16300,16547,4836,247,PERF
42311345690000,PI,IP,001,1,11133,15540,5405,4407,PERF
42311345700000,PI,IP,001,1,10380,13928,5080,3548,PERF
42311345710000,PI,IP,001,1,10598,14767,5819,4169,PERF
42311345720000,PI,IP,001,1,10029,15630,5973,5601,PERF
42311345730000,PI,IP,001,1,10121,10412,5986,291,PERF
42311345730000,PI,IP,001,2,10471,10762,5986,291,PERF
42311345730000,PI,IP,001,3,10821,11112,5986,291,PERF
42311345730000,PI,IP,001,4,11171,11462,5986,291,PERF
42311345730000,PI,IP,001,5,11521,11812,5986,291,PERF
42311345730000,PI,IP,001,6,11871,12162,5986,291,PERF
42311345730000,PI,IP,001,7,12221,12512,5986,291,PERF
42311345730000,PI,IP,001,8,12571,12862,5986,291,PERF
42311345730000,PI,IP,001,9,12921,13212,5986,291,PERF
42311345730000,PI,IP,001,10,13271,13562,5986,291,PERF
42311345730000,PI,IP,001,11,13621,13912,5986,291,PERF
42311345730000,PI,IP,001,12,13971,14262,5986,291,PERF
42311345730000,PI,IP,001,13,14321,14612,5986,291,PERF
42311345730000,PI,IP,001,14,14671,14962,5986,291,PERF
42311345730000,PI,IP,001,15,15021,15312,5986,291,PERF
42311345730000,PI,IP,001,16,15371,15662,5986,291,PERF
42311345740000,PI,IP,001,1,9578,14700,,5122,PERF
42311345750000,PI,IP,001,1,11510,16502,5511,4992,PERF
42311345760000,PI,IP,001,1,10500,15462,5205,4962,PERF
42311345770000,PI,IP,001,1,10530,15390,5167,4860,PERF
42311345780000,PI,IP,001,1,11170,11486,7083,316,PERF
42311345780000,PI,IP,001,2,11547,11863,7083,316,PERF
42311345780000,PI,IP,001,3,11924,12240,7083,316,PERF
42311345780000,PI,IP,001,4,12301,12617,7083,316,PERF
42311345780000,PI,IP,001,5,12678,12994,7083,316,PERF
42311345780000,PI,IP,001,6,13055,13371,7083,316,PERF
42311345780000,PI,IP,001,7,13432,13748,7083,316,PERF
42311345780000,PI,IP,001,8,13809,14125,7083,316,PERF
42311345780000,PI,IP,001,9,14186,14502,7083,316,PERF
42311345780000,PI,IP,001,10,14563,14879,7083,316,PERF
42311345780000,PI,IP,001,11,14940,15256,7083,316,PERF
42311345780000,PI,IP,001,12,15317,15633,7083,316,PERF
42311345780000,PI,IP,001,13,15694,16010,7083,316,PERF
42311345780000,PI,IP,001,14,16071,16387,7083,316,PERF
42311345780000,PI,IP,001,15,16448,16764,7083,316,PERF
42311345780000,PI,IP,001,16,16825,17141,7083,316,PERF
42311345780000,PI,IP,001,17,17202,17518,7083,316,PERF
42311345780000,PI,IP,001,18,17579,17895,7083,316,PERF
42311345790000,PI,IP,001,1,11340,11672,5743,332,PERF
42311345790000,PI,IP,001,2,11723,12052,5743,329,PERF
42311345790000,PI,IP,001,3,12103,12432,5743,329,PERF
42311345790000,PI,IP,001,4,12483,12812,5743,329,PERF
42311345790000,PI,IP,001,5,12863,13192,5743,329,PERF
42311345790000,PI,IP,001,6,13243,13572,5743,329,PERF
42311345790000,PI,IP,001,7,13623,13952,5743,329,PERF
42311345790000,PI,IP,001,8,14003,14332,5743,329,PERF
42311345790000,PI,IP,001,9,14383,14712,5743,329,PERF
42311345790000,PI,IP,001,10,14763,15092,5743,329,PERF
42311345790000,PI,IP,001,11,15143,15472,5743,329,PERF
42311345790000,PI,IP,001,12,15523,15852,5743,329,PERF
42311345790000,PI,IP,001,13,15903,16232,5743,329,PERF
42311345790000,PI,IP,001,14,16283,16612,5743,329,PERF
42311345790000,PI,IP,001,15,16663,16992,5743,329,PERF
42311345800000,PI,IP,001,1,11125,11416,5435,291,PERF
42311345800000,PI,IP,001,2,11474,11765,5435,291,PERF
42311345800000,PI,IP,001,3,11823,12114,5435,291,PERF
42311345800000,PI,IP,001,4,12172,12463,5435,291,PERF
42311345800000,PI,IP,001,5,12521,12812,5435,291,PERF
42311345800000,PI,IP,001,6,12870,13161,5435,291,PERF
42311345800000,PI,IP,001,7,13219,13510,5435,291,PERF
42311345800000,PI,IP,001,8,13568,13859,5435,291,PERF
42311345800000,PI,IP,001,9,13917,14208,5435,291,PERF
42311345800000,PI,IP,001,10,14266,14557,5435,291,PERF
42311345800000,PI,IP,001,11,14615,14906,5435,291,PERF
42311345800000,PI,IP,001,12,14964,15255,5435,291,PERF
42311345800000,PI,IP,001,13,15313,15604,5435,291,PERF
42311345800000,PI,IP,001,14,15662,15953,5435,291,PERF
42311345800000,PI,IP,001,15,16011,16302,5435,291,PERF
42311345810000,PI,IP,001,1,11010,11366,5025,356,PERF
42311345810000,PI,IP,001,2,11419,11764,5025,345,PERF
42311345810000,PI,IP,001,3,11817,12162,5025,345,PERF
42311345810000,PI,IP,001,4,12215,12560,5025,345,PERF
42311345810000,PI,IP,001,5,12613,12958,5025,345,PERF
42311345810000,PI,IP,001,6,13011,13356,5025,345,PERF
42311345810000,PI,IP,001,7,13409,13754,5025,345,PERF
42311345810000,PI,IP,001,8,13807,14152,5025,345,PERF
42311345810000,PI,IP,001,9,14205,14550,5025,345,PERF
42311345810000,PI,IP,001,10,14603,14948,5025,345,PERF
42311345810000,PI,IP,001,11,15001,15346,5025,345,PERF
42311345810000,PI,IP,001,12,15399,15744,5025,345,PERF
42311345830000,PI,IP,001,1,9363,9742,6811,379,PERF
42311345830000,PI,IP,001,2,9800,10179,6811,379,PERF
42311345830000,PI,IP,001,3,10237,10616,6811,379,PERF
42311345830000,PI,IP,001,4,10674,11053,6811,379,PERF
42311345830000,PI,IP,001,5,11111,11490,6811,379,PERF
42311345830000,PI,IP,001,6,11548,11927,6811,379,PERF
42311345830000,PI,IP,001,7,11985,12364,6811,379,PERF
42311345830000,PI,IP,001,8,12422,12801,6811,379,PERF
42311345830000,PI,IP,001,9,12859,13238,6811,379,PERF
42311345830000,PI,IP,001,10,13296,13675,6811,379,PERF
42311345830000,PI,IP,001,11,13733,14112,6811,379,PERF
42311345830000,PI,IP,001,12,14170,14549,6811,379,PERF
42311345830000,PI,IP,001,13,14607,14986,6811,379,PERF
42311345830000,PI,IP,001,14,15044,15423,6811,379,PERF
42311345830000,PI,IP,001,15,15481,15860,6811,379,PERF
42311345840000,PI,IP,001,1,9300,9667,6205,367,PERF
42311345840000,PI,IP,001,2,9728,10095,6205,367,PERF
42311345840000,PI,IP,001,3,10156,10523,6205,367,PERF
42311345840000,PI,IP,001,4,10584,10951,6205,367,PERF
42311345840000,PI,IP,001,5,11012,11379,6205,367,PERF
42311345840000,PI,IP,001,6,11440,11807,6205,367,PERF
42311345840000,PI,IP,001,7,11868,12235,6205,367,PERF
42311345840000,PI,IP,001,8,12296,12663,6205,367,PERF
42311345840000,PI,IP,001,9,12724,13091,6205,367,PERF
42311345840000,PI,IP,001,10,13152,13519,6205,367,PERF
42311345840000,PI,IP,001,11,13580,13947,6205,367,PERF
42311345840000,PI,IP,001,12,14008,14375,6205,367,PERF
42311345840000,PI,IP,001,13,14436,14803,6205,367,PERF
42311345840000,PI,IP,001,14,14864,15231,6205,367,PERF
42311345850000,PI,IP,001,1,11431,15165,4081,3734,PERF
42311345860100,PI,IP,001,1,9841,14816,5583,4975,PERF
42311345870000,PI,IP,001,1,11456,11648,5229,192,PERF
42311345870000,PI,IP,001,2,11744,11936,5229,192,PERF
42311345870000,PI,IP,001,3,12032,12224,5229,192,PERF
42311345870000,PI,IP,001,4,12320,12512,5229,192,PERF
42311345870000,PI,IP,001,5,12608,12800,5229,192,PERF
42311345870000,PI,IP,001,6,12896,13088,5229,192,PERF
42311345870000,PI,IP,001,7,13184,13384,5229,200,PERF
42311345870000,PI,IP,001,8,13472,13664,5229,192,PERF
42311345870000,PI,IP,001,9,13760,13952,5229,192,PERF
42311345870000,PI,IP,001,10,14096,14288,5229,192,PERF
42311345870000,PI,IP,001,11,14336,14576,5229,240,PERF
42311345870000,PI,IP,001,12,14624,14816,5229,192,PERF
42311345870000,PI,IP,001,13,14912,15104,5229,192,PERF
42311345870000,PI,IP,001,14,15200,15392,5229,192,PERF
42311345870000,PI,IP,001,15,15488,15680,5229,192,PERF
42311345870000,PI,IP,001,16,15776,15968,5229,192,PERF
42311345870000,PI,IP,001,17,16064,16256,5229,192,PERF
42311345890000,PI,IP,001,1,12341,18314,7130,5973,PERF
42311345920000,PI,IP,001,1,12042,18147,6909,6105,PERF
42311345930000,PI,IP,001,1,10110,14307,4784,4197,PERF
42311345940000,PI,IP,001,1,10330,14974,5336,4644,PERF
42311345950000,PI,IP,001,1,10603,17313,6994,6710,PERF
42311345960000,PI,IP,001,1,10938,17876,7036,6938,PERF
42311345990000,PI,IP,001,1,10743,16912,6405,6169,PERF
42311346000000,PI,IP,001,1,11946,15951,4881,4005,PERF
42311346010000,PI,IP,001,1,10640,10847,5103,207,PERF
42311346010000,PI,IP,001,2,10927,11117,5103,190,PERF
42311346010000,PI,IP,001,3,11195,11402,5103,207,PERF
42311346010000,PI,IP,001,4,11480,11682,5103,202,PERF
42311346010000,PI,IP,001,5,11760,11962,5103,202,PERF
42311346010000,PI,IP,001,6,12040,12242,5103,202,PERF
42311346010000,PI,IP,001,7,12320,12522,5103,202,PERF
42311346010000,PI,IP,001,8,12600,12802,5103,202,PERF
42311346010000,PI,IP,001,9,12885,13080,5103,195,PERF
42311346010000,PI,IP,001,10,13160,13364,5103,204,PERF
42311346010000,PI,IP,001,11,13440,13644,5103,204,PERF
42311346010000,PI,IP,001,12,13725,13917,5103,192,PERF
42311346010000,PI,IP,001,13,13995,14202,5103,207,PERF
42311346010000,PI,IP,001,14,14280,14482,5103,202,PERF
42311346010000,PI,IP,001,15,14560,14762,5103,202,PERF
42311346010000,PI,IP,001,16,14840,15042,5103,202,PERF
42311346010000,PI,IP,001,17,15170,15322,5103,152,PERF
42311346030000,PI,IP,001,1,10079,16644,7041,6565,PERF
42311346040000,PI,IP,001,1,9963,16660,7009,6697,PERF
42311346060000,PI,IP,001,1,12115,17717,6465,5602,PERF
42311346070000,PI,IP,001,1,11930,16418,4931,4488,PERF
42311346110000,PI,IP,001,1,9663,15590,6392,5927,PERF
42311346120000,PI,IP,001,1,10555,16639,6694,6084,PERF
42311346140000,PI,IP,001,1,11433,15481,4519,4048,PERF
42311346160000,PI,IP,001,1,11271,15680,5467,4409,PERF
42311346170000,PI,IP,001,1,11420,16584,6631,5164,PERF
42311346180000,PI,IP,001,1,10909,15534,5418,4625,PERF
42311346190000,PI,IP,001,1,11478,16170,5750,4692,PERF
42311346200000,PI,IP,001,1,10660,16659,6693,5999,PERF
42311346210001,PI,IP,001,1,12250,12450,,200,PERF
42311346210001,PI,IP,001,2,12500,12750,,250,PERF
42311346210001,PI,IP,001,3,12800,13050,,250,PERF
42311346210001,PI,IP,001,4,13100,13350,,250,PERF
42311346210001,PI,IP,001,5,13400,13650,,250,PERF
42311346210001,PI,IP,001,6,13700,13950,,250,PERF
42311346210001,PI,IP,001,7,14000,14250,,250,PERF
42311346210001,PI,IP,001,8,14300,14550,,250,PERF
42311346210001,PI,IP,001,9,14600,16560,,1960,PERF
42311346230000,PI,IP,001,1,10011,15118,5621,5107,PERF
42311346250000,PI,IP,001,1,11286,15480,4443,4194,PERF
42311346260000,PI,IP,001,1,10806,16985,,6179,PERF
42311346270000,PI,IP,001,1,10570,16170,6073,5600,PERF
42311346280000,PI,IP,001,1,13744,13944,4978,200,PERF
42311346280000,PI,IP,001,2,14008,14208,4978,200,PERF
42311346280000,PI,IP,001,3,14272,14472,4978,200,PERF
42311346280000,PI,IP,001,4,14536,14736,4978,200,PERF
42311346280000,PI,IP,001,5,14800,15000,4978,200,PERF
42311346280000,PI,IP,001,6,15064,15264,4978,200,PERF
42311346280000,PI,IP,001,7,15328,15528,4978,200,PERF
42311346280000,PI,IP,001,8,15592,15792,4978,200,PERF
42311346280000,PI,IP,001,9,15856,16056,4978,200,PERF
42311346280000,PI,IP,001,10,16120,16320,4978,200,PERF
42311346280000,PI,IP,001,11,16384,16582,4978,198,PERF
42311346280000,PI,IP,001,12,16648,16848,4978,200,PERF
42311346280000,PI,IP,001,13,16912,17112,4978,200,PERF
42311346280000,PI,IP,001,14,17176,17376,4978,200,PERF
42311346280000,PI,IP,001,15,17440,17640,4978,200,PERF
42311346280000,PI,IP,001,16,17704,17904,4978,200,PERF
42311346290000,PI,IP,001,1,11487,17636,7162,6149,PERF
42311346300000,PI,IP,001,1,11067,16294,6007,5227,PERF
42311346310000,PI,IP,001,1,11409,15401,4419,3992,PERF
42311346320000,PI,IP,001,1,9751,14916,5441,5165,PERF
42311346340000,PI,IP,001,1,10492,16283,6678,5791,PERF
42311346360000,PI,IP,001,1,10117,14860,5137,4743,PERF
42311346380001,PI,IP,001,1,12450,12700,,250,PERF
42311346380001,PI,IP,001,2,12750,13000,,250,PERF
42311346380001,PI,IP,001,3,13050,13300,,250,PERF
42311346380001,PI,IP,001,4,13350,13600,,250,PERF
42311346380001,PI,IP,001,5,13650,13900,,250,PERF
42311346380001,PI,IP,001,6,13950,14200,,250,PERF
42311346380001,PI,IP,001,7,14250,14500,,250,PERF
42311346380001,PI,IP,001,8,14550,16600,,2050,PERF
42311346390000,PI,IP,001,1,12700,12950,4969,250,PERF
42311346390000,PI,IP,001,2,13000,13250,4969,250,PERF
42311346390000,PI,IP,001,3,13300,13550,4969,250,PERF
42311346390000,PI,IP,001,4,13600,13850,4969,250,PERF
42311346390000,PI,IP,001,5,13900,14150,4969,250,PERF
42311346390000,PI,IP,001,6,14200,14450,4969,250,PERF
42311346390000,PI,IP,001,7,14500,14750,4969,250,PERF
42311346390000,PI,IP,001,8,14800,15050,4969,250,PERF
42311346390000,PI,IP,001,9,15100,15350,4969,250,PERF
42311346390000,PI,IP,001,10,15400,15650,4969,250,PERF
42311346390000,PI,IP,001,11,15700,15950,4969,250,PERF
42311346390000,PI,IP,001,12,16000,16250,4969,250,PERF
42311346390000,PI,IP,001,13,16300,16550,4969,250,PERF
42311346390000,PI,IP,001,14,16600,16850,4969,250,PERF
42311346400000,PI,IP,001,1,10660,16662,6698,6002,PERF
42311346410000,PI,IP,001,1,10555,16639,6808,6084,PERF
42311346420000,PI,IP,001,1,10649,16734,6705,6085,PERF
42311346430000,PI,IP,001,1,12435,17471,5333,5036,PERF
42311346480000,PI,IP,001,1,10890,17358,7154,6468,PERF
42311346490000,PI,IP,001,1,10917,17024,6811,6107,PERF
42311346500000,PI,IP,001,1,10915,11067,4038,152,PERF
42311346500000,PI,IP,001,2,11140,11342,4038,202,PERF
42311346500000,PI,IP,001,3,11420,11622,4038,202,PERF
42311346500000,PI,IP,001,4,11715,11917,4038,202,PERF
42311346500000,PI,IP,001,5,12073,12318,4038,245,PERF
42311346500000,PI,IP,001,6,12318,12777,4038,459,PERF
42311346500000,PI,IP,001,7,12777,13015,4038,238,PERF
42311346500000,PI,IP,001,8,13015,13290,4038,275,PERF
42311346500000,PI,IP,001,9,13290,13623,4038,333,PERF
42311346500000,PI,IP,001,10,13623,13902,4038,279,PERF
42311346500000,PI,IP,001,11,13902,14032,4038,130,PERF
42311346510000,PI,IP,001,1,11343,15990,5510,4647,PERF
42311346520000,PI,IP,001,1,10687,16882,6638,6195,PERF
42311346530000,PI,IP,001,1,11057,17130,6901,6073,PERF
42311346540000,PI,IP,001,1,10800,16960,6827,6160,PERF
42311346550000,PI,IP,001,1,10675,17644,7559,6969,PERF
42311346560000,PI,IP,001,1,10810,17053,7642,6243,PERF
42311346570000,PI,IP,001,1,10730,19726,9131,8996,PERF
42311346590000,PI,IP,001,1,12327,17378,5570,5051,PERF
42311346600000,PI,IP,001,1,11800,15714,5275,3914,PERF
42311346610000,PI,IP,001,1,9646,15714,6182,6068,PERF
42311346630000,PI,IP,001,1,10630,16674,6636,6044,PERF
42311346640000,PI,IP,001,1,12800,13050,4990,250,PERF
42311346640000,PI,IP,001,2,13100,13350,4990,250,PERF
42311346640000,PI,IP,001,3,13400,13650,4990,250,PERF
42311346640000,PI,IP,001,4,13700,13950,4990,250,PERF
42311346640000,PI,IP,001,5,14000,14250,4990,250,PERF
42311346640000,PI,IP,001,6,14300,14550,4990,250,PERF
42311346640000,PI,IP,001,7,14600,14850,4990,250,PERF
42311346640000,PI,IP,001,8,14900,15150,4990,250,PERF
42311346640000,PI,IP,001,9,15200,15450,4990,250,PERF
42311346640000,PI,IP,001,10,15500,15750,4990,250,PERF
42311346640000,PI,IP,001,11,15800,16050,4990,250,PERF
42311346640000,PI,IP,001,12,16100,16350,4990,250,PERF
42311346640000,PI,IP,001,13,16400,16650,4990,250,PERF
42311346640000,PI,IP,001,14,16700,16950,4990,250,PERF
42311346650100,PI,IP,001,1,12175,17251,5433,5076,PERF
42311346660000,PI,IP,001,1,12196,17170,5358,4974,PERF
42311346670000,PI,IP,001,1,12433,17484,6058,5051,PERF
42311346700000,PI,IP,001,1,10848,15002,4251,4154,PERF
42311346710000,PI,IP,001,1,11522,16148,4930,4626,PERF
42311346720000,PI,IP,001,1,10884,17822,,6938,PERF
42311346730000,PI,IP,001,1,11528,16085,4781,4557,PERF
42311346740000,PI,IP,001,1,13095,18446,5995,5351,PERF
42311346750000,PI,IP,001,1,12486,17623,5717,5137,PERF
42311346760000,PI,IP,001,1,10102,16201,6202,6099,PERF
42311346770000,PI,IP,001,1,11021,18051,,7030,PERF
42311346780000,PI,IP,001,1,11016,18548,8247,7532,PERF
42311346800000,PI,IP,001,1,11770,15909,4835,4139,PERF
42311346820000,PI,IP,001,1,11126,17478,6766,6352,PERF
42311346840000,PI,IP,001,1,10437,15370,5423,4933,PERF
42311346850000,PI,IP,001,1,11758,15886,5364,4128,PERF
42311346860000,PI,IP,001,1,11680,15694,5380,4014,PERF
42311346870000,PI,IP,001,1,11687,15453,4055,3766,PERF
42311346880000,PI,IP,001,1,10971,15970,5736,4999,PERF
42311346890000,PI,IP,001,1,12416,18843,6830,6427,PERF
42311346910000,PI,IP,001,1,12593,18663,6731,6070,PERF
42311346920000,PI,IP,001,1,10700,16959,6895,6259,PERF
42311346930000,PI,IP,001,1,12357,17708,6027,5351,PERF
42311346940000,PI,IP,001,1,11566,17217,6527,5651,PERF
42311346950000,PI,IP,001,1,10340,16653,7041,6313,PERF
42311346960000,PI,IP,001,1,12629,17475,5749,4846,PERF
42311346970100,PI,IP,001,1,11153,15761,5243,4608,PERF
42311346980000,PI,IP,001,1,12754,17891,5194,5137,PERF
42311347000000,PI,IP,001,1,10782,14950,4763,4168,PERF
42311347010000,PI,IP,001,1,9875,14450,4709,4575,PERF
42311347020000,PI,IP,001,1,9992,15985,,5993,PERF
42311347060000,PI,IP,001,1,11994,17045,5312,5051,PERF
42311347070000,PI,IP,001,1,12600,12850,5322,250,PERF
42311347070000,PI,IP,001,2,12900,13150,5322,250,PERF
42311347070000,PI,IP,001,3,13200,13450,5322,250,PERF
42311347070000,PI,IP,001,4,13500,13750,5322,250,PERF
42311347070000,PI,IP,001,5,13800,14050,5322,250,PERF
42311347070000,PI,IP,001,6,14100,14350,5322,250,PERF
42311347070000,PI,IP,001,7,14400,14650,5322,250,PERF
42311347070000,PI,IP,001,8,14700,14950,5322,250,PERF
42311347070000,PI,IP,001,9,15000,15250,5322,250,PERF
42311347070000,PI,IP,001,10,15300,15550,5322,250,PERF
42311347070000,PI,IP,001,11,15600,15850,5322,250,PERF
42311347070000,PI,IP,001,12,15900,16150,5322,250,PERF
42311347070000,PI,IP,001,13,16200,16450,5322,250,PERF
42311347070000,PI,IP,001,14,16500,16750,5322,250,PERF
42311347080000,PI,IP,001,1,12300,12550,5132,250,PERF
42311347080000,PI,IP,001,2,12600,12850,5132,250,PERF
42311347080000,PI,IP,001,3,12900,13150,5132,250,PERF
42311347080000,PI,IP,001,4,13200,13450,5132,250,PERF
42311347080000,PI,IP,001,5,13500,13750,5132,250,PERF
42311347080000,PI,IP,001,6,13800,14050,5132,250,PERF
42311347080000,PI,IP,001,7,14100,14350,5132,250,PERF
42311347080000,PI,IP,001,8,14400,14650,5132,250,PERF
42311347080000,PI,IP,001,9,14700,14950,5132,250,PERF
42311347080000,PI,IP,001,10,15000,15250,5132,250,PERF
42311347080000,PI,IP,001,11,15300,15550,5132,250,PERF
42311347080000,PI,IP,001,12,15600,15850,5132,250,PERF
42311347080000,PI,IP,001,13,15900,16150,5132,250,PERF
42311347080000,PI,IP,001,14,16200,16450,5132,250,PERF
42311347090000,PI,IP,001,1,11170,15024,4625,3854,PERF
42311347110000,PI,IP,001,1,9366,9735,6279,369,PERF
42311347110000,PI,IP,001,2,9784,10153,6279,369,PERF
42311347110000,PI,IP,001,3,10202,10571,6279,369,PERF
42311347110000,PI,IP,001,4,10620,10969,6279,349,PERF
42311347110000,PI,IP,001,5,11038,11407,6279,369,PERF
42311347110000,PI,IP,001,6,11456,11825,6279,369,PERF
42311347110000,PI,IP,001,7,11874,12243,6279,369,PERF
42311347110000,PI,IP,001,8,12292,12661,6279,369,PERF
42311347110000,PI,IP,001,9,12710,13079,6279,369,PERF
42311347110000,PI,IP,001,10,13128,13497,6279,369,PERF
42311347110000,PI,IP,001,11,13546,13915,6279,369,PERF
42311347110000,PI,IP,001,12,13964,14333,6279,369,PERF
42311347110000,PI,IP,001,13,14382,14751,6279,369,PERF
42311347110000,PI,IP,001,14,15113,15429,6279,316,PERF
42311347120000,PI,IP,001,1,9356,9725,7123,369,PERF
42311347120000,PI,IP,001,2,9774,10143,7123,369,PERF
42311347120000,PI,IP,001,3,10192,10551,7123,359,PERF
42311347120000,PI,IP,001,4,10610,10979,7123,369,PERF
42311347120000,PI,IP,001,5,11028,11397,7123,369,PERF
42311347120000,PI,IP,001,6,11446,11815,7123,369,PERF
42311347120000,PI,IP,001,7,11854,12233,7123,379,PERF
42311347120000,PI,IP,001,8,12282,12651,7123,369,PERF
42311347120000,PI,IP,001,9,13315,13692,7123,377,PERF
42311347120000,PI,IP,001,10,13741,14118,7123,377,PERF
42311347120000,PI,IP,001,11,14167,14544,7123,377,PERF
42311347120000,PI,IP,001,12,14593,14970,7123,377,PERF
42311347120000,PI,IP,001,13,15019,15396,7123,377,PERF
42311347120000,PI,IP,001,14,15445,15822,7123,377,PERF
42311347130000,PI,IP,001,1,10432,15269,5437,4837,PERF
42311347150000,PI,IP,001,1,11148,15406,5486,4258,PERF
42311347170000,PI,IP,001,1,11209,17749,7275,6540,PERF
42311347190000,PI,IP,001,1,12504,17621,6405,5117,PERF
42311347260000,PI,IP,001,1,10250,14701,4753,4451,PERF
42311347270100,PI,IP,001,1,12261,17567,5872,5306,PERF
42311347280000,PI,IP,001,1,11150,14819,3960,3669,PERF
42311347290000,PI,IP,001,1,11195,17950,7296,6755,PERF
42311347300000,PI,IP,001,1,9940,15045,5538,5105,PERF
42311347310000,PI,IP,001,1,11537,16651,6145,5114,PERF
42311347320000,PI,IP,001,1,9869,14602,4943,4733,PERF
42311347330000,PI,IP,001,1,11215,15463,5493,4248,PERF
42311347340000,PI,IP,001,1,9828,14415,4838,4587,PERF
42311347350000,PI,IP,001,1,12803,18047,5918,5244,PERF
42311347360000,PI,IP,001,1,11153,17506,6658,6353,PERF
42311347380000,PI,IP,001,1,9655,17920,8501,8265,PERF
42311347390000,PI,IP,001,1,10812,16675,6126,5863,PERF
42311347400000,PI,IP,001,1,9589,18056,8512,8467,PERF
42311347410000,PI,IP,001,1,12100,12350,4804,250,PERF
42311347410000,PI,IP,001,2,12400,12650,4804,250,PERF
42311347410000,PI,IP,001,3,12700,12950,4804,250,PERF
42311347410000,PI,IP,001,4,13000,13250,4804,250,PERF
42311347410000,PI,IP,001,5,13300,13550,4804,250,PERF
42311347410000,PI,IP,001,6,13600,13850,4804,250,PERF
42311347410000,PI,IP,001,7,13900,14150,4804,250,PERF
42311347410000,PI,IP,001,8,14200,14450,4804,250,PERF
42311347410000,PI,IP,001,9,14500,14750,4804,250,PERF
42311347410000,PI,IP,001,10,14800,15050,4804,250,PERF
42311347410000,PI,IP,001,11,15100,15350,4804,250,PERF
42311347410000,PI,IP,001,12,15400,15650,4804,250,PERF
42311347410000,PI,IP,001,13,15700,15950,4804,250,PERF
42311347410000,PI,IP,001,14,16000,16250,4804,250,PERF
42311347410000,PI,IP,001,15,16300,16550,4804,250,PERF
42311347410000,PI,IP,001,16,16600,16850,4804,250,PERF
42311347410000,PI,IP,001,17,16900,17150,4804,250,PERF
42311347430100,PI,IP,001,1,9779,16200,6856,6421,PERF
42311347450000,PI,IP,001,1,13151,17912,5576,4761,PERF
42311347460000,PI,IP,001,1,12195,16366,5000,4171,PERF
42311347470000,PI,IP,001,1,11998,17049,5540,5051,PERF
42311347480000,PI,IP,001,1,10003,10388,7318,385,PERF
42311347480000,PI,IP,001,2,10437,10822,7318,385,PERF
42311347480000,PI,IP,001,3,10871,11256,7318,385,PERF
42311347480000,PI,IP,001,4,11305,11690,7318,385,PERF
42311347480000,PI,IP,001,5,11739,12124,7318,385,PERF
42311347480000,PI,IP,001,6,12173,12558,7318,385,PERF
42311347480000,PI,IP,001,7,12607,12992,7318,385,PERF
42311347480000,PI,IP,001,8,13041,13426,7318,385,PERF
42311347480000,PI,IP,001,9,13475,13860,7318,385,PERF
42311347480000,PI,IP,001,10,13909,14294,7318,385,PERF
42311347480000,PI,IP,001,11,14343,14728,7318,385,PERF
42311347480000,PI,IP,001,12,14777,15162,7318,385,PERF
42311347480000,PI,IP,001,13,15211,15596,7318,385,PERF
42311347480000,PI,IP,001,14,15645,16030,7318,385,PERF
42311347480000,PI,IP,001,15,16079,16464,7318,385,PERF
42311347480000,PI,IP,001,16,16537,16898,7318,361,PERF
42311347490000,PI,IP,001,1,10939,16790,6019,5851,PERF
42311347500000,PI,IP,001,1,9923,14510,4871,4587,PERF
42311347510000,PI,IP,001,1,11400,16176,5026,4776,PERF
42311347520000,PI,IP,001,1,9816,14420,4914,4604,PERF
42311347540000,PI,IP,001,1,12222,17071,5011,4849,PERF
42311347560000,PI,IP,001,1,10003,14277,5133,4274,PERF
42311347570000,PI,IP,001,1,9693,14743,5399,5050,PERF
42311347590100,PI,IP,001,1,11328,16807,6644,5479,PERF
42311347600000,PI,IP,001,1,11750,16843,5516,5093,PERF
42311347610000,PI,IP,001,1,11734,17249,5831,5515,PERF
42311347620000,PI,IP,001,1,13210,18160,5066,4950,PERF
42311347630000,PI,IP,001,1,11504,15840,,4336,PERF
42311347640000,PI,IP,001,1,13153,16160,4843,3007,PERF
42311347680000,PI,IP,001,1,9974,15088,6417,5114,PERF
42311347690000,PI,IP,001,1,9917,15031,6153,5114,PERF
42311347700000,PI,IP,001,1,9838,15396,6316,5558,PERF
42311347710000,PI,IP,001,1,9938,15490,6346,5552,PERF
42311347750000,PI,IP,001,1,13191,19567,6819,6376,PERF
42311347790000,PI,IP,001,1,13228,19179,,5951,PERF
42311347800000,PI,IP,001,1,11068,16028,5771,4960,PERF
42311347820000,PI,IP,001,1,11680,17794,6401,6114,PERF
42311347830000,PI,IP,001,1,11780,16468,,4688,PERF
42311347840000,PI,IP,001,1,13257,18908,6329,5651,PERF
42311347850000,PI,IP,001,1,13233,17773,5066,4540,PERF
42311347860000,PI,IP,001,1,11493,15197,3883,3704,PERF
42311347870000,PI,IP,001,1,10049,15665,5981,5616,PERF
42311347890000,PI,IP,001,1,10114,16512,7035,6398,PERF
42311347900000,PI,IP,001,1,11362,15711,5091,4349,PERF
42311347910000,PI,IP,001,1,11335,16027,5431,4692,PERF
42311347920000,PI,IP,001,1,9330,9735,8035,405,PERF
42311347920000,PI,IP,001,2,9782,10175,8035,393,PERF
42311347920000,PI,IP,001,3,10222,10615,8035,393,PERF
42311347920000,PI,IP,001,4,10662,11055,8035,393,PERF
42311347920000,PI,IP,001,5,11102,11495,8035,393,PERF
42311347920000,PI,IP,001,6,11542,11935,8035,393,PERF
42311347920000,PI,IP,001,7,11982,12375,8035,393,PERF
42311347920000,PI,IP,001,8,12422,12815,8035,393,PERF
42311347920000,PI,IP,001,9,12862,13255,8035,393,PERF
42311347920000,PI,IP,001,10,13302,13695,8035,393,PERF
42311347920000,PI,IP,001,11,13742,14135,8035,393,PERF
42311347920000,PI,IP,001,12,14182,14575,8035,393,PERF
42311347920000,PI,IP,001,13,14622,15015,8035,393,PERF
42311347920000,PI,IP,001,14,15062,15455,8035,393,PERF
42311347920000,PI,IP,001,15,15502,15895,8035,393,PERF
42311347920000,PI,IP,001,16,15942,16335,8035,393,PERF
42311347920000,PI,IP,001,17,16382,16775,8035,393,PERF
42311347930000,PI,IP,001,1,9195,9436,8082,241,PERF
42311347930000,PI,IP,001,2,9480,9721,8082,241,PERF
42311347930000,PI,IP,001,3,9765,10006,8082,241,PERF
42311347930000,PI,IP,001,4,10050,10291,8082,241,PERF
42311347930000,PI,IP,001,5,10335,10576,8082,241,PERF
42311347930000,PI,IP,001,6,10620,10861,8082,241,PERF
42311347930000,PI,IP,001,7,10905,11146,8082,241,PERF
42311347930000,PI,IP,001,8,11190,11431,8082,241,PERF
42311347930000,PI,IP,001,9,11475,11716,8082,241,PERF
42311347930000,PI,IP,001,10,11760,12001,8082,241,PERF
42311347930000,PI,IP,001,11,12045,12286,8082,241,PERF
42311347930000,PI,IP,001,12,12330,12481,8082,151,PERF
42311347940000,PI,IP,001,1,9250,9641,8073,391,PERF
42311347940000,PI,IP,001,2,9688,10089,8073,401,PERF
42311347940000,PI,IP,001,3,10136,10537,8073,401,PERF
42311347940000,PI,IP,001,4,10584,10985,8073,401,PERF
42311347940000,PI,IP,001,5,11032,11433,8073,401,PERF
42311347940000,PI,IP,001,6,11480,11881,8073,401,PERF
42311347940000,PI,IP,001,7,11928,12329,8073,401,PERF
42311347940000,PI,IP,001,8,12376,12777,8073,401,PERF
42311347940000,PI,IP,001,9,12824,13225,8073,401,PERF
42311347940000,PI,IP,001,10,13272,13673,8073,401,PERF
42311347940000,PI,IP,001,11,13720,14121,8073,401,PERF
42311347940000,PI,IP,001,12,14168,14569,8073,401,PERF
42311347940000,PI,IP,001,13,14616,15017,8073,401,PERF
42311347940000,PI,IP,001,14,15064,15465,8073,401,PERF
42311347940000,PI,IP,001,15,15512,15913,8073,401,PERF
42311347940000,PI,IP,001,16,15960,16361,8073,401,PERF
42311347940000,PI,IP,001,17,16408,16811,8073,403,PERF
42311347950000,PI,IP,001,1,9190,9599,8035,409,PERF
42311347950000,PI,IP,001,2,9648,10057,8035,409,PERF
42311347950000,PI,IP,001,3,10106,10515,8035,409,PERF
42311347950000,PI,IP,001,4,10564,10973,8035,409,PERF
42311347950000,PI,IP,001,5,11022,11431,8035,409,PERF
42311347950000,PI,IP,001,6,11480,11889,8035,409,PERF
42311347950000,PI,IP,001,7,11938,12347,8035,409,PERF
42311347950000,PI,IP,001,8,12396,12805,8035,409,PERF
42311347950000,PI,IP,001,9,12854,13263,8035,409,PERF
42311347950000,PI,IP,001,10,13312,13721,8035,409,PERF
42311347950000,PI,IP,001,11,13770,14179,8035,409,PERF
42311347950000,PI,IP,001,12,14228,14637,8035,409,PERF
42311347950000,PI,IP,001,13,14686,15095,8035,409,PERF
42311347950000,PI,IP,001,14,15144,15553,8035,409,PERF
42311347950000,PI,IP,001,15,15602,16011,8035,409,PERF
42311347950000,PI,IP,001,16,16060,16469,8035,409,PERF
42311347950000,PI,IP,001,17,16518,16927,8035,409,PERF
42311347960000,PI,IP,001,1,11046,14898,4824,3852,PERF
42311347980000,PI,IP,001,1,10979,15085,4544,4106,PERF
42311347990000,PI,IP,001,1,11022,15095,4814,4073,PERF
42311348010000,PI,IP,001,1,11045,15670,5350,4625,PERF
42311348020000,PI,IP,001,1,12725,18559,6270,5834,PERF
42311348030000,PI,IP,001,1,13429,19379,6616,5950,PERF
42311348050000,PI,IP,001,1,10630,15335,5008,4705,PERF
42311348060000,PI,IP,001,1,11199,15007,,3808,PERF
42311348070000,PI,IP,001,1,11550,17735,,6185,PERF
42311348090000,PI,IP,001,1,10948,15668,5184,4720,PERF
42311348110000,PI,IP,001,1,11129,17478,,6349,PERF
42311348220000,PI,IP,001,1,13424,18475,5654,5051,PERF
42311348230000,PI,IP,001,1,11521,18065,6612,6544,PERF
42311348240000,PI,IP,001,1,11630,18476,7598,6846,PERF
42311348250000,PI,IP,001,1,10878,15438,5363,4560,PERF
42311348260000,PI,IP,001,1,11584,18296,7675,6712,PERF
42311348270000,PI,IP,001,1,10846,15475,5346,4629,PERF
42311348280000,PI,IP,001,1,10815,15858,5742,5043,PERF
42311348290000,PI,IP,001,1,10878,15774,5738,4896,PERF
42311348340000,PI,IP,001,1,12382,17534,5792,5152,PERF
42311348350000,PI,IP,001,1,16863,19261,7120,2398,PERF
42311348370000,PI,IP,001,1,11315,17661,7390,6346,PERF
42311348380000,PI,IP,001,1,11268,17596,7402,6328,PERF
42311348410000,PI,IP,001,1,11274,11643,5675,369,PERF
42311348410000,PI,IP,001,2,11690,12059,5675,369,PERF
42311348410000,PI,IP,001,3,12106,12475,5675,369,PERF
42311348410000,PI,IP,001,4,12522,12891,5675,369,PERF
42311348410000,PI,IP,001,5,12938,13307,5675,369,PERF
42311348410000,PI,IP,001,6,13354,13723,5675,369,PERF
42311348410000,PI,IP,001,7,13770,14139,5675,369,PERF
42311348410000,PI,IP,001,8,14186,14555,5675,369,PERF
42311348410000,PI,IP,001,9,14602,14971,5675,369,PERF
42311348410000,PI,IP,001,10,15018,15387,5675,369,PERF
42311348410000,PI,IP,001,11,15434,15803,5675,369,PERF
42311348410000,PI,IP,001,12,15850,16219,5675,369,PERF
42311348410000,PI,IP,001,13,16266,16635,5675,369,PERF
42311348420000,PI,IP,001,1,11282,11651,5039,369,PERF
42311348420000,PI,IP,001,2,11695,12064,5039,369,PERF
42311348420000,PI,IP,001,3,12108,12477,5039,369,PERF
42311348420000,PI,IP,001,4,12521,12890,5039,369,PERF
42311348420000,PI,IP,001,5,12934,13303,5039,369,PERF
42311348420000,PI,IP,001,6,13347,13716,5039,369,PERF
42311348420000,PI,IP,001,7,13760,14129,5039,369,PERF
42311348420000,PI,IP,001,8,14173,14542,5039,369,PERF
42311348420000,PI,IP,001,9,14586,14955,5039,369,PERF
42311348420000,PI,IP,001,10,14999,15368,5039,369,PERF
42311348420000,PI,IP,001,11,15412,15781,5039,369,PERF
42311348420000,PI,IP,001,12,15825,16194,5039,369,PERF
42311348440000,PI,IP,001,1,9955,16674,6884,6719,PERF
42311348450000,PI,IP,001,1,9969,16721,,6752,PERF
42311348490000,PI,IP,001,1,10899,11171,8094,272,PERF
42311348490000,PI,IP,001,2,11249,11521,8094,272,PERF
42311348490000,PI,IP,001,3,11599,11871,8094,272,PERF
42311348490000,PI,IP,001,4,11955,12216,8094,261,PERF
42311348490000,PI,IP,001,5,12301,12570,8094,269,PERF
42311348490000,PI,IP,001,6,12648,12920,8094,272,PERF
42311348490000,PI,IP,001,7,13000,13270,8094,270,PERF
42311348490000,PI,IP,001,8,13348,13618,8094,270,PERF
42311348490000,PI,IP,001,9,13700,13968,8094,268,PERF
42311348490000,PI,IP,001,10,14052,14312,8094,260,PERF
42311348490000,PI,IP,001,11,14396,14668,8094,272,PERF
42311348490000,PI,IP,001,12,14746,15018,8094,272,PERF
42311348490000,PI,IP,001,13,15096,15368,8094,272,PERF
42311348490000,PI,IP,001,14,15446,15718,8094,272,PERF
42311348490000,PI,IP,001,15,15796,16068,8094,272,PERF
42311348490000,PI,IP,001,16,16146,16418,8094,272,PERF
42311348490000,PI,IP,001,17,16496,16768,8094,272,PERF
42311348490000,PI,IP,001,18,16846,17118,8094,272,PERF
42311348490000,PI,IP,001,19,17196,17467,8094,271,PERF
42311348490000,PI,IP,001,20,17546,17818,8094,272,PERF
42311348490000,PI,IP,001,21,17896,18153,8094,257,PERF
42311348510000,PI,IP,001,1,10550,16979,6901,6429,PERF
42311348520000,PI,IP,001,1,11400,15828,5331,4428,PERF
42311348530000,PI,IP,001,1,11960,18281,7368,6321,PERF
42311348540000,PI,IP,001,1,11060,11417,6637,357,PERF
42311348540000,PI,IP,001,2,11460,11821,6637,361,PERF
42311348540000,PI,IP,001,3,11864,12225,6637,361,PERF
42311348540000,PI,IP,001,4,12268,12629,6637,361,PERF
42311348540000,PI,IP,001,5,12672,13033,6637,361,PERF
42311348540000,PI,IP,001,6,13076,13437,6637,361,PERF
42311348540000,PI,IP,001,7,13480,13841,6637,361,PERF
42311348540000,PI,IP,001,8,13884,14245,6637,361,PERF
42311348540000,PI,IP,001,9,14288,14649,6637,361,PERF
42311348540000,PI,IP,001,10,14692,15053,6637,361,PERF
42311348540000,PI,IP,001,11,15096,15457,6637,361,PERF
42311348540000,PI,IP,001,12,15500,15861,6637,361,PERF
42311348540000,PI,IP,001,13,15904,16265,6637,361,PERF
42311348540000,PI,IP,001,14,16308,16669,6637,361,PERF
42311348540000,PI,IP,001,15,16712,17073,6637,361,PERF
42311348540000,PI,IP,001,16,17116,17477,6637,361,PERF
42311348550000,PI,IP,001,1,11014,11359,5486,345,PERF
42311348550000,PI,IP,001,2,11406,11751,5486,345,PERF
42311348550000,PI,IP,001,3,11798,12143,5486,345,PERF
42311348550000,PI,IP,001,4,12190,12535,5486,345,PERF
42311348550000,PI,IP,001,5,12582,12927,5486,345,PERF
42311348550000,PI,IP,001,6,12974,13319,5486,345,PERF
42311348550000,PI,IP,001,7,13366,13711,5486,345,PERF
42311348550000,PI,IP,001,8,13758,14093,5486,335,PERF
42311348550000,PI,IP,001,9,14150,14495,5486,345,PERF
42311348550000,PI,IP,001,10,14542,14887,5486,345,PERF
42311348550000,PI,IP,001,11,14934,15279,5486,345,PERF
42311348550000,PI,IP,001,12,15326,15671,5486,345,PERF
42311348550000,PI,IP,001,13,15718,16063,5486,345,PERF
42311348550000,PI,IP,001,14,16110,16455,5486,345,PERF
42311348660000,PI,IP,001,1,11140,15835,5231,4695,PERF
42311348670000,PI,IP,001,1,10580,15279,4942,4699,PERF
42311348690000,PI,IP,001,1,13146,17944,4962,4798,PERF
42311348700000,PI,IP,001,1,12068,16408,5056,4340,PERF
42311348710000,PI,IP,001,1,11533,16324,5553,4791,PERF
42311348730000,PI,IP,001,1,10726,15201,5194,4475,PERF
42311348740000,PI,IP,001,1,10662,15421,5442,4759,PERF
42311348750000,PI,IP,001,1,11486,16087,5530,4601,PERF
42311348780000,PI,IP,001,1,13176,18769,5864,5593,PERF
42311348790000,PI,IP,001,1,12036,16374,4865,4338,PERF
42311348820000,PI,IP,001,1,10745,15596,5593,4851,PERF
42311348840000,PI,IP,001,1,11305,16969,5884,5664,PERF
42311348890000,PI,IP,001,1,11381,16875,6054,5494,PERF
42311348910000,PI,IP,001,1,13379,18531,5574,5152,PERF
42311348920000,PI,IP,001,1,13231,18124,5455,4893,PERF
42311348930000,PI,IP,001,1,11463,16001,5536,4538,PERF
42311348940000,PI,IP,001,1,11565,18351,8040,6786,PERF
42311348950000,PI,IP,001,1,12749,18411,6529,5662,PERF
42311348960000,PI,IP,001,1,13593,18654,,5061,PERF
42311348970000,PI,IP,001,1,13531,19631,6561,6100,PERF
42311348980000,PI,IP,001,1,13546,18597,5984,5051,PERF
42311348990000,PI,IP,001,1,11752,16170,5165,4418,PERF
42311349000000,PI,IP,001,1,10714,10954,,240,PERF
42311349000000,PI,IP,001,2,11034,11274,,240,PERF
42311349000000,PI,IP,001,3,11354,11516,,162,PERF
42311349000000,PI,IP,001,4,11624,11786,,162,PERF
42311349000000,PI,IP,001,5,11894,12056,,162,PERF
42311349000000,PI,IP,001,6,12164,12326,,162,PERF
42311349000000,PI,IP,001,7,12434,12596,,162,PERF
42311349000000,PI,IP,001,8,12704,12866,,162,PERF
42311349000000,PI,IP,001,9,12974,13136,,162,PERF
42311349000000,PI,IP,001,10,13244,13406,,162,PERF
42311349000000,PI,IP,001,11,13514,13676,,162,PERF
42311349000000,PI,IP,001,12,13784,13946,,162,PERF
42311349000000,PI,IP,001,13,14054,14216,,162,PERF
42311349000000,PI,IP,001,14,14324,14486,,162,PERF
42311349000000,PI,IP,001,15,14591,14745,,154,PERF
42311349010000,PI,IP,001,1,13070,18020,5526,4950,PERF
42311349020000,PI,IP,001,1,10066,10419,6582,353,PERF
42311349020000,PI,IP,001,2,10463,10816,6582,353,PERF
42311349020000,PI,IP,001,3,10860,11213,6582,353,PERF
42311349020000,PI,IP,001,4,11257,11610,6582,353,PERF
42311349020000,PI,IP,001,5,11654,12007,6582,353,PERF
42311349020000,PI,IP,001,6,12051,12404,6582,353,PERF
42311349020000,PI,IP,001,7,12448,12801,6582,353,PERF
42311349020000,PI,IP,001,8,12845,13198,6582,353,PERF
42311349020000,PI,IP,001,9,13242,13595,6582,353,PERF
42311349020000,PI,IP,001,10,13639,13992,6582,353,PERF
42311349020000,PI,IP,001,11,14036,14389,6582,353,PERF
42311349020000,PI,IP,001,12,14433,14786,6582,353,PERF
42311349020000,PI,IP,001,13,14830,15183,6582,353,PERF
42311349020000,PI,IP,001,14,15227,15580,6582,353,PERF
42311349020000,PI,IP,001,15,15624,15933,6582,309,PERF
42311349020000,PI,IP,001,16,16021,16374,6582,353,PERF
42311349030000,PI,IP,001,1,10040,10401,6727,361,PERF
42311349030000,PI,IP,001,2,10451,10812,6727,361,PERF
42311349030000,PI,IP,001,3,10862,11223,6727,361,PERF
42311349030000,PI,IP,001,4,11273,11634,6727,361,PERF
42311349030000,PI,IP,001,5,11684,12045,6727,361,PERF
42311349030000,PI,IP,001,6,12095,12456,6727,361,PERF
42311349030000,PI,IP,001,7,12506,12867,6727,361,PERF
42311349030000,PI,IP,001,8,12917,13278,6727,361,PERF
42311349030000,PI,IP,001,9,13328,13689,6727,361,PERF
42311349030000,PI,IP,001,10,13739,14100,6727,361,PERF
42311349030000,PI,IP,001,11,14150,14511,6727,361,PERF
42311349030000,PI,IP,001,12,14561,14922,6727,361,PERF
42311349030000,PI,IP,001,13,14972,15333,6727,361,PERF
42311349030000,PI,IP,001,14,15383,15744,6727,361,PERF
42311349030000,PI,IP,001,15,15794,16155,6727,361,PERF
42311349030000,PI,IP,001,16,16205,16566,6727,361,PERF
42311349040000,PI,IP,001,1,11549,18700,7745,7151,PERF
42311349050000,PI,IP,001,1,10000,14398,5131,4398,PERF
42311349070000,PI,IP,001,1,13510,18138,5705,4628,PERF
42311349080000,PI,IP,001,1,10612,15888,5823,5276,PERF
42311349090000,PI,IP,001,1,12832,17178,5051,4346,PERF
42311349110000,PI,IP,001,1,11307,18227,7807,6920,PERF
42311349120000,PI,IP,001,1,11282,17032,6492,5750,PERF
42311349130000,PI,IP,001,1,10718,16923,,6205,PERF
42311349140000,PI,IP,001,1,10678,16916,6503,6238,PERF
42311349150000,PI,IP,001,1,13551,19287,6334,5736,PERF
42311349170000,PI,IP,001,1,13552,18003,5109,4451,PERF
42311349260000,PI,IP,001,1,12307,17411,5990,5104,PERF
42311349270000,PI,IP,001,1,13173,17829,5408,4656,PERF
42311349290000,PI,IP,001,1,10675,16892,6523,6217,PERF
42311349300000,PI,IP,001,1,10605,10974,6761,369,PERF
42311349300000,PI,IP,001,2,11025,11394,6761,369,PERF
42311349300000,PI,IP,001,3,11445,11814,6761,369,PERF
42311349300000,PI,IP,001,4,11865,12234,6761,369,PERF
42311349300000,PI,IP,001,5,12285,12654,6761,369,PERF
42311349300000,PI,IP,001,6,12705,13074,6761,369,PERF
42311349300000,PI,IP,001,7,13125,13494,6761,369,PERF
42311349300000,PI,IP,001,8,13545,13914,6761,369,PERF
42311349300000,PI,IP,001,9,13965,14334,6761,369,PERF
42311349300000,PI,IP,001,10,14385,14754,6761,369,PERF
42311349300000,PI,IP,001,11,14805,15174,6761,369,PERF
42311349300000,PI,IP,001,12,15225,15594,6761,369,PERF
42311349300000,PI,IP,001,13,15645,16014,6761,369,PERF
42311349300000,PI,IP,001,14,16065,16434,6761,369,PERF
42311349300000,PI,IP,001,15,16485,16854,6761,369,PERF
42311349320000,PI,IP,001,1,10820,17180,6694,6360,PERF
42311349330000,PI,IP,001,1,9720,15819,6671,6099,PERF
42311349350000,PI,IP,001,1,11470,18201,7509,6731,PERF
42311349360000,PI,IP,001,1,11507,18241,7475,6734,PERF
42311349370000,PI,IP,001,1,9980,14716,5173,4736,PERF
42311349400100,PI,IP,001,1,17300,17581,6739,281,PERF
42311349410000,PI,IP,001,1,10990,11167,6635,177,PERF
42311349410000,PI,IP,001,2,11395,11748,6635,353,PERF
42311349410000,PI,IP,001,3,11795,12148,6635,353,PERF
42311349410000,PI,IP,001,4,12195,12196,6635,1,PERF
42311349410000,PI,IP,001,5,12595,12948,6635,353,PERF
42311349410000,PI,IP,001,6,12995,13348,6635,353,PERF
42311349410000,PI,IP,001,7,13395,13748,6635,353,PERF
42311349410000,PI,IP,001,8,13795,14148,6635,353,PERF
42311349410000,PI,IP,001,9,14195,14548,6635,353,PERF
42311349410000,PI,IP,001,10,14595,14948,6635,353,PERF
42311349410000,PI,IP,001,11,14995,15348,6635,353,PERF
42311349410000,PI,IP,001,12,15395,15748,6635,353,PERF
42311349410000,PI,IP,001,13,15795,16148,6635,353,PERF
42311349410000,PI,IP,001,14,16195,16548,6635,353,PERF
42311349410000,PI,IP,001,15,16595,16948,6635,353,PERF
42311349410000,PI,IP,001,16,16995,17348,6635,353,PERF
42311349420000,PI,IP,001,1,10100,16104,6214,6004,PERF
42311349430000,PI,IP,001,1,10844,18138,,7294,PERF
42311349440000,PI,IP,001,1,9903,14574,4948,4671,PERF
42311349450000,PI,IP,001,1,9892,14503,4933,4611,PERF
42311349510000,PI,IP,001,1,10451,16824,6943,6373,PERF
42311349520000,PI,IP,001,1,10577,16878,6906,6301,PERF
42311349540000,PI,IP,001,1,10977,17027,6974,6050,PERF
42311349550000,PI,IP,001,1,10543,16772,6880,6229,PERF
42311349560000,PI,IP,001,1,10567,17078,6938,6511,PERF
42311349590000,PI,IP,001,1,12105,18751,7613,6646,PERF
42311349600000,PI,IP,001,1,11300,15932,5342,4632,PERF
42311349610000,PI,IP,001,1,11199,16601,6131,5402,PERF
42311349620000,PI,IP,001,1,11253,16583,6141,5330,PERF
42311349640000,PI,IP,001,1,10950,11286,5471,336,PERF
42311349640000,PI,IP,001,2,11333,11678,5471,345,PERF
42311349640000,PI,IP,001,3,11725,12070,5471,345,PERF
42311349640000,PI,IP,001,4,12117,12462,5471,345,PERF
42311349640000,PI,IP,001,5,12509,12854,5471,345,PERF
42311349640000,PI,IP,001,6,12901,13246,5471,345,PERF
42311349640000,PI,IP,001,7,13293,13638,5471,345,PERF
42311349640000,PI,IP,001,8,13685,14030,5471,345,PERF
42311349640000,PI,IP,001,9,14077,14422,5471,345,PERF
42311349640000,PI,IP,001,10,14469,14814,5471,345,PERF
42311349640000,PI,IP,001,11,14861,15206,5471,345,PERF
42311349640000,PI,IP,001,12,15253,15598,5471,345,PERF
42311349640000,PI,IP,001,13,15645,15990,5471,345,PERF
42311349640000,PI,IP,001,14,16037,16382,5471,345,PERF
42311349670000,PI,IP,001,1,10390,16681,6953,6291,PERF
42311349680000,PI,IP,001,1,10460,16087,6617,5627,PERF
42311349690000,PI,PT,001,1,14402,14547,,145,PERF
42311349720000,PI,IP,001,1,10572,16859,6881,6287,PERF
42311349780000,PI,IP,001,1,12059,18238,6279,6179,PERF
42311349790000,PI,IP,001,1,10841,16749,6721,5908,PERF
42311349800000,PI,IP,001,1,11890,17701,7613,5811,PERF
42311349810000,PI,IP,001,1,12141,16788,5287,4647,PERF
42311349850000,PI,IP,001,1,11725,16774,5582,5049,PERF
42311349860000,PI,IP,001,1,11569,16800,,5231,PERF
42311349870000,PI,IP,001,1,11737,16499,,4762,PERF
42311349940000,PI,IP,001,1,10990,11375,7124,385,PERF
42311349940000,PI,IP,001,2,11419,11804,7124,385,PERF
42311349940000,PI,IP,001,3,11848,12233,7124,385,PERF
42311349940000,PI,IP,001,4,12277,12662,7124,385,PERF
42311349940000,PI,IP,001,5,12706,13091,7124,385,PERF
42311349940000,PI,IP,001,6,13135,13520,7124,385,PERF
42311349940000,PI,IP,001,7,13564,13949,7124,385,PERF
42311349940000,PI,IP,001,8,13993,14378,7124,385,PERF
42311349940000,PI,IP,001,9,14422,14807,7124,385,PERF
42311349940000,PI,IP,001,10,14851,15236,7124,385,PERF
42311349940000,PI,IP,001,11,15280,15665,7124,385,PERF
42311349940000,PI,IP,001,12,15709,16094,7124,385,PERF
42311349940000,PI,IP,001,13,16138,16523,7124,385,PERF
42311349940000,PI,IP,001,14,16567,16952,7124,385,PERF
42311349940000,PI,IP,001,15,16996,17381,7124,385,PERF
42311349940000,PI,IP,001,16,17425,17810,7124,385,PERF
42311349960000,PI,IP,001,1,11260,11592,5254,332,PERF
42311349960000,PI,IP,001,2,11636,11965,5254,329,PERF
42311349960000,PI,IP,001,3,12009,12338,5254,329,PERF
42311349960000,PI,IP,001,4,12382,12711,5254,329,PERF
42311349960000,PI,IP,001,5,12755,13084,5254,329,PERF
42311349960000,PI,IP,001,6,13128,13457,5254,329,PERF
42311349960000,PI,IP,001,7,13501,13830,5254,329,PERF
42311349960000,PI,IP,001,8,13874,14203,5254,329,PERF
42311349960000,PI,IP,001,9,14247,14576,5254,329,PERF
42311349960000,PI,IP,001,10,14620,14949,5254,329,PERF
42311349960000,PI,IP,001,11,14993,15322,5254,329,PERF
42311349960000,PI,IP,001,12,15366,15695,5254,329,PERF
42311349960000,PI,IP,001,13,15739,16078,5254,339,PERF
42311349970000,PI,IP,001,1,11031,11392,5394,361,PERF
42311349970000,PI,IP,001,2,11438,11799,5394,361,PERF
42311349970000,PI,IP,001,3,11845,12206,5394,361,PERF
42311349970000,PI,IP,001,4,12252,12613,5394,361,PERF
42311349970000,PI,IP,001,5,12659,13020,5394,361,PERF
42311349970000,PI,IP,001,6,13066,13427,5394,361,PERF
42311349970000,PI,IP,001,7,13473,13834,5394,361,PERF
42311349970000,PI,IP,001,8,13880,14241,5394,361,PERF
42311349970000,PI,IP,001,9,14287,14648,5394,361,PERF
42311349970000,PI,IP,001,10,14694,15055,5394,361,PERF
42311349970000,PI,IP,001,11,15101,15462,5394,361,PERF
42311349970000,PI,IP,001,12,15508,15869,5394,361,PERF
42311349970000,PI,IP,001,13,15915,16276,5394,361,PERF
42311350050000,PI,IP,001,1,9614,15120,6204,5506,PERF
42311350060000,PI,IP,001,1,11550,16861,,5311,PERF
42311350070000,PI,IP,001,1,10240,15250,5894,5010,PERF
42311350080000,PI,IP,001,1,10490,14460,5293,3970,PERF
42311350150000,PI,IP,001,1,13575,18432,5303,4857,PERF
42311350170000,PI,IP,001,1,12000,15962,5557,3962,PERF
42311350190000,PI,IP,001,1,11202,17247,6711,6045,PERF
42311350230000,PI,IP,001,1,10559,16977,6880,6418,PERF
42311350300100,PI,IP,001,1,11052,15752,5385,4700,PERF
42311350360000,PI,IP,001,1,10535,16567,6521,6032,PERF
42311350390000,PI,IP,001,1,11743,17801,6889,6058,PERF
42311350450000,PI,IP,001,1,10123,14491,4976,4368,PERF
42311350490000,PI,IP,001,1,10929,16815,6852,5886,PERF
42311350500000,PI,IP,001,1,11430,16414,5247,4984,PERF
42311350610000,PI,IP,001,1,10635,16404,6691,5769,PERF
42311350660000,PI,IP,001,1,10664,16714,7296,6050,PERF
42311350680000,PI,IP,001,1,10612,16381,7242,5769,PERF
42311350690000,PI,IP,001,1,10612,16578,7242,5966,PERF
42311350770000,PI,IP,001,1,10296,16781,6907,6485,PERF
42311350790000,PI,IP,001,1,10366,16659,6732,6293,PERF
42311350940000,PI,IP,001,1,11563,16433,5133,4870,PERF
42311350960000,PI,PT,001,1,12360,18560,,6200,PERF
42311350990000,PI,IP,001,1,10077,14615,5332,4538,PERF
42311351000000,PI,IP,001,1,11582,16452,5271,4870,PERF
42311351010000,PI,IP,001,1,11743,16613,5407,4870,PERF
42311351030000,PI,IP,001,1,10298,15790,6179,5492,PERF
42311351070000,PI,IP,001,1,11317,18236,7247,6919,PERF
42311351110000,PI,IP,001,1,10523,14868,5480,4345,PERF
42311351200000,PI,IP,001,1,11186,18909,7967,7723,PERF
42311351210000,PI,IP,001,1,11065,18397,7959,7332,PERF
42311351220000,PI,IP,001,1,11044,18319,7937,7275,PERF
42311351230000,PI,IP,001,1,11128,18404,7914,7276,PERF
42311351270000,PI,IP,001,1,10122,16493,7025,6371,PERF
42311351280000,PI,IP,001,1,10513,15059,5092,4546,PERF
42311351290000,PI,IP,001,1,10979,15252,5942,4273,PERF
42311351380000,PI,IP,001,1,11055,15589,5923,4534,PERF
42311351400000,PI,IP,001,1,10500,14784,4914,4284,PERF
42311351430000,PI,IP,001,1,10146,16635,7149,6489,PERF
42311351470000,PI,IP,001,1,11568,16400,5947,4832,PERF
42311351480000,PI,IP,001,1,10151,15404,5993,5253,PERF
42311351500000,PI,IP,002,1,11348,17028,6391,5680,PERF
42311351500000,PI,PT,001,1,11348,17028,6391,5680,PERF
42311351570000,PI,IP,001,1,11230,15855,5342,4625,PERF
42311351590000,PI,IP,001,1,11540,16345,5925,4805,PERF
42313309370000,PI,IP,001,1,8663,13336,6761,4673,PERF
42313309580000,PI,IP,001,1,8364,8515,5921,151,PERF
42313309580000,PI,IP,001,2,8570,8723,5921,153,PERF
42313309580000,PI,IP,001,3,8780,8928,5921,148,PERF
42313309580000,PI,IP,001,4,8988,9138,5921,150,PERF
42313309580000,PI,IP,001,5,9196,9347,5921,151,PERF
42313309580000,PI,IP,001,6,9404,9555,5921,151,PERF
42313309580000,PI,IP,001,7,9621,9763,5921,142,PERF
42313309580000,PI,IP,001,8,9824,9971,5921,147,PERF
42313309580000,PI,IP,001,9,10022,10179,5921,157,PERF
42313309580000,PI,IP,001,10,10236,10383,5921,147,PERF
42313309580000,PI,IP,001,11,10444,10595,5921,151,PERF
42313309580000,PI,IP,001,12,10652,10803,5921,151,PERF
42313309580000,PI,IP,001,13,10860,11011,5921,151,PERF
42313309580000,PI,IP,001,14,11072,11219,5921,147,PERF
42313309580000,PI,IP,001,15,11276,11429,5921,153,PERF
42313309580000,PI,IP,001,16,11484,11635,5921,151,PERF
42313309580000,PI,IP,001,17,11692,11843,5921,151,PERF
42313309580000,PI,IP,001,18,11901,12052,5921,151,PERF
42313309580000,PI,IP,001,19,12106,12260,5921,154,PERF
42313309580000,PI,IP,001,20,12320,12467,5921,147,PERF
42313309580000,PI,IP,001,21,12524,12675,5921,151,PERF
42313309580000,PI,IP,001,22,12732,12878,5921,146,PERF
42313309580000,PI,IP,001,23,12940,13082,5921,142,PERF
42313309580000,PI,IP,001,24,13148,13299,5921,151,PERF
42313309580000,PI,IP,001,25,13356,13507,5921,151,PERF
42313309580000,PI,IP,001,26,13564,13715,5921,151,PERF
42323311920100,PI,IP,001,1,3241,3441,2834,200,PERF
42323311920100,PI,IP,001,2,4220,4371,2834,151,PERF
42323311920100,PI,IP,001,3,4540,4741,2834,201,PERF
42323311920100,PI,IP,001,4,5000,5201,2834,201,PERF
42323312860001,PI,IP,001,1,2872,2976,,104,PERF
42323313030002,PI,IP,001,1,2660,2664,,4,PERF
42323313030002,PI,IP,001,2,2710,2714,,4,PERF
42323313030002,PI,IP,001,3,2760,2764,,4,PERF
42323328600300,PI,IP,001,1,5520,7155,,1635,OPENHOLE
42323329290000,PI,IP,001,1,6255,7329,820,1074,OPENHOLE
42323329290300,PI,IP,001,1,4274,6929,2541,2655,OPENHOLE
42323330850000,PI,IP,001,1,4635,4950,1908,315,PERF
42323330850000,PI,IP,001,2,5035,5350,1908,315,PERF
42323330850000,PI,IP,001,3,5425,5740,1908,315,PERF
42323330850000,PI,IP,001,4,5820,5994,1908,174,PERF
42323332970000,PI,IP,001,1,6423,8795,3682,2372,PERF
42323333470000,PI,IP,001,1,5290,8857,4313,3567,PERF
42323333480000,PI,IP,001,1,6080,9903,4564,3823,PERF
42323333490000,PI,IP,001,1,5200,5417,5776,217,PERF
42323333490000,PI,IP,001,2,5507,5724,5776,217,PERF
42323333490000,PI,IP,001,3,5814,6031,5776,217,PERF
42323333490000,PI,IP,001,4,6127,6338,5776,211,PERF
42323333490000,PI,IP,001,5,6428,6645,5776,217,PERF
42323333490000,PI,IP,001,6,6735,6944,5776,209,PERF
42323333490000,PI,IP,001,7,7042,7259,5776,217,PERF
42323333490000,PI,IP,001,8,7349,7566,5776,217,PERF
42323333490000,PI,IP,001,9,7653,7874,5776,221,PERF
42323333490000,PI,IP,001,10,8030,8261,5776,231,PERF
42323333490000,PI,IP,001,11,8374,8568,5776,194,PERF
42323333500000,PI,IP,001,1,4965,8596,4144,3631,PERF
42323333510000,PI,IP,001,1,6238,9568,4574,3330,PERF
42323333540000,PI,IP,001,1,5240,5463,6022,223,PERF
42323333540000,PI,IP,001,2,5549,5772,6022,223,PERF
42323333540000,PI,IP,001,3,5860,6081,6022,221,PERF
42323333540000,PI,IP,001,4,6197,6420,6022,223,PERF
42323333540000,PI,IP,001,5,6506,6723,6022,217,PERF
42323333540000,PI,IP,001,6,6820,7038,6022,218,PERF
42323333540000,PI,IP,001,7,7124,7347,6022,223,PERF
42323333540000,PI,IP,001,8,7440,7656,6022,216,PERF
42323333540000,PI,IP,001,9,7742,7965,6022,223,PERF
42323333540000,PI,IP,001,10,8040,8274,6022,234,PERF
42323333540000,PI,IP,001,11,8360,8589,6022,229,PERF
42323333540000,PI,IP,001,12,8672,8895,6022,223,PERF
42323333540000,PI,IP,001,13,8978,9191,6022,213,PERF
42323333540000,PI,IP,001,14,9287,9510,6022,223,PERF
42323333540000,PI,IP,001,15,9596,9823,6022,227,PERF
42323333550000,PI,IP,001,1,6090,9493,4561,3403,PERF
42323333590000,PI,IP,001,1,4979,5202,5901,223,PERF
42323333590000,PI,IP,001,2,5294,5517,5901,223,PERF
42323333590000,PI,IP,001,3,5609,5832,5901,223,PERF
42323333590000,PI,IP,001,4,5924,6147,5901,223,PERF
42323333590000,PI,IP,001,5,6239,6462,5901,223,PERF
42323333590000,PI,IP,001,6,6554,6777,5901,223,PERF
42323333590000,PI,IP,001,7,6869,7092,5901,223,PERF
42323333590000,PI,IP,001,8,7184,7407,5901,223,PERF
42323333590000,PI,IP,001,9,7499,7722,5901,223,PERF
42323333590000,PI,IP,001,10,7814,8037,5901,223,PERF
42323333590000,PI,IP,001,11,8129,8352,5901,223,PERF
42323333590000,PI,IP,001,12,8444,8667,5901,223,PERF
42323333590000,PI,IP,001,13,8759,8982,5901,223,PERF
42323333590000,PI,IP,001,14,9074,9297,5901,223,PERF
42323333590000,PI,IP,001,15,9389,9612,5901,223,PERF
42323333590000,PI,IP,001,16,9706,9927,5901,221,PERF
42323333600000,PI,IP,001,1,5725,9580,4534,3855,COMB
42323333620000,PI,IP,001,1,5100,9852,5755,4752,PERF
42323333630000,PI,IP,001,1,5786,6013,6101,227,PERF
42323333630000,PI,IP,001,2,6103,6330,6101,227,PERF
42323333630000,PI,IP,001,3,6414,6647,6101,233,PERF
42323333630000,PI,IP,001,4,6737,6964,6101,227,PERF
42323333630000,PI,IP,001,5,7054,7281,6101,227,PERF
42323333630000,PI,IP,001,6,7371,7598,6101,227,PERF
42323333630000,PI,IP,001,7,7698,7915,6101,217,PERF
42323333630000,PI,IP,001,8,8005,8232,6101,227,PERF
42323333630000,PI,IP,001,9,8322,8549,6101,227,PERF
42323333630000,PI,IP,001,10,8644,8866,6101,222,PERF
42323333630000,PI,IP,001,11,8956,9183,6101,227,PERF
42323333630000,PI,IP,001,12,9273,9500,6101,227,PERF
42323333630000,PI,IP,001,13,9590,9817,6101,227,PERF
42323333630000,PI,IP,001,14,9907,10134,6101,227,PERF
42323333630000,PI,IP,001,15,10224,10451,6101,227,PERF
42323333630000,PI,IP,001,16,10541,10768,6101,227,PERF
42323333640000,PI,IP,001,1,7105,7260,5874,155,PERF
42323333640000,PI,IP,001,2,7348,7503,5874,155,PERF
42323333640000,PI,IP,001,3,7591,7749,5874,158,PERF
42323333640000,PI,IP,001,4,7834,7989,5874,155,PERF
42323333640000,PI,IP,001,5,8077,8232,5874,155,PERF
42323333640000,PI,IP,001,6,8320,8475,5874,155,PERF
42323333640000,PI,IP,001,7,8563,8718,5874,155,PERF
42323333640000,PI,IP,001,8,8806,8953,5874,147,PERF
42323333640000,PI,IP,001,9,9049,9207,5874,158,PERF
42323333640000,PI,IP,001,10,9292,9445,5874,153,PERF
42323333640000,PI,IP,001,11,9535,9687,5874,152,PERF
42323333640000,PI,IP,001,12,9778,9933,5874,155,PERF
42323333640000,PI,IP,001,13,10021,10176,5874,155,PERF
42323333640000,PI,IP,001,14,10264,10419,5874,155,PERF
42323333640000,PI,IP,001,15,10507,10662,5874,155,PERF
42323333640000,PI,IP,001,16,10750,10959,5874,209,PERF
42323333740000,PI,IP,001,1,8010,8234,6052,224,PERF
42323333740000,PI,IP,001,2,8440,8652,6052,212,PERF
42323333740000,PI,IP,001,3,8850,9068,6052,218,PERF
42323333740000,PI,IP,001,4,9268,9486,6052,218,PERF
42323333740000,PI,IP,001,5,9688,9906,6052,218,PERF
42323333740000,PI,IP,001,6,10006,10224,6052,218,PERF
42323333740000,PI,IP,001,7,10324,10542,6052,218,PERF
42323333740000,PI,IP,001,8,10642,10860,6052,218,PERF
42323333750000,PI,IP,001,1,8137,8138,5895,1,PERF
42323333750000,PI,IP,001,2,8238,8239,5895,1,PERF
42323333750000,PI,IP,001,3,8339,8340,5895,1,PERF
42323333750000,PI,IP,001,4,8440,8441,5895,1,PERF
42323333750000,PI,IP,001,5,8541,8542,5895,1,PERF
42323333750000,PI,IP,001,6,8642,8643,5895,1,PERF
42323333750000,PI,IP,001,7,8743,8744,5895,1,PERF
42323333750000,PI,IP,001,8,8844,8845,5895,1,PERF
42323333750000,PI,IP,001,9,8945,8946,5895,1,PERF
42323333750000,PI,IP,001,10,9046,9047,5895,1,PERF
42323333750000,PI,IP,001,11,9147,9148,5895,1,PERF
42323333750000,PI,IP,001,12,9248,9249,5895,1,PERF
42323333750000,PI,IP,001,13,9349,9350,5895,1,PERF
42323333750000,PI,IP,001,14,9450,9451,5895,1,PERF
42323333750000,PI,IP,001,15,9551,9552,5895,1,PERF
42323333750000,PI,IP,001,16,9652,9653,5895,1,PERF
42323333750000,PI,IP,001,17,9753,9754,5895,1,PERF
42323333750000,PI,IP,001,18,9854,9855,5895,1,PERF
42323333750000,PI,IP,001,19,9955,9956,5895,1,PERF
42323333750000,PI,IP,001,20,10056,10057,5895,1,PERF
42323333750000,PI,IP,001,21,10157,10158,5895,1,PERF
42323333750000,PI,IP,001,22,10258,10259,5895,1,PERF
42323333750000,PI,IP,001,23,10359,10360,5895,1,PERF
42323333750000,PI,IP,001,24,10460,10461,5895,1,PERF
42323333750000,PI,IP,001,25,10561,10562,5895,1,PERF
42323333760000,PI,IP,001,1,6144,10335,5215,4191,PERF
42323333770000,PI,IP,001,1,5864,9779,4934,3915,PERF
42323333780000,PI,IP,001,1,5576,9665,4998,4089,PERF
42323333790000,PI,IP,001,1,5809,9811,4995,4002,PERF
42323333810000,PI,IP,001,1,6550,6801,5951,251,PERF
42323333810000,PI,IP,001,2,6882,7150,5951,268,PERF
42323333810000,PI,IP,001,3,7230,7472,5951,242,PERF
42323333810000,PI,IP,001,4,7551,7798,5951,247,PERF
42323333810000,PI,IP,001,5,7876,8123,5951,247,PERF
42323333810000,PI,IP,001,6,8202,8454,5951,252,PERF
42323333810000,PI,IP,001,7,8534,8787,5951,253,PERF
42323333810000,PI,IP,001,8,8867,9118,5951,251,PERF
42323333810000,PI,IP,001,9,9197,9449,5951,252,PERF
42323333810000,PI,IP,001,10,9530,9782,5951,252,PERF
42323333810000,PI,IP,001,11,9860,10110,5951,250,PERF
42323333810000,PI,IP,001,12,10190,10441,5951,251,PERF
42323333820000,PI,IP,001,1,8370,8694,5947,324,PERF
42323333820000,PI,IP,001,2,8896,9207,5947,311,PERF
42323333820000,PI,IP,001,3,9317,9628,5947,311,PERF
42323333820000,PI,IP,001,4,9738,10049,5947,311,PERF
42323333820000,PI,IP,001,5,10159,10470,5947,311,PERF
42323333820000,PI,IP,001,6,10580,10755,5947,175,PERF
42323333830000,PI,IP,001,1,6050,10684,5547,4634,PERF
42323333840000,PI,IP,001,1,6380,11231,6027,4851,PERF
42323333890000,PI,IP,002,1,6304,10521,5249,4217,OPENHOLE
42323333890000,PI,PT,001,1,6304,10521,5249,4217,OPENHOLE
42323333900000,PI,IP,002,1,6305,11274,5902,4969,OPENHOLE
42323333900000,PI,PT,001,1,6305,11274,5902,4969,OPENHOLE
42323334000000,PI,IP,001,1,6532,10654,5367,4122,PERF
42323334110000,PI,IP,001,1,5314,9568,5214,4254,PERF
42323334120100,PI,IP,001,1,5319,9573,5292,4254,PERF
42323334150000,PI,IP,001,1,6532,11015,6078,4483,PERF
42323334160000,PI,IP,001,1,6410,11074,6072,4664,PERF
42323334170000,PI,IP,001,1,6350,10944,6068,4594,PERF
42323334200000,PI,IP,001,1,6394,10652,5470,4258,PERF
42323334250000,PI,IP,001,1,3291,8125,4488,4834,OPENHOLE
42331313790001,PI,IP,001,1,5430,5490,,60,PERF
42331338650000,PI,IP,001,1,6410,6415,3142,5,PERF
42331338650000,PI,IP,001,2,6795,6800,3142,5,PERF
42331338650000,PI,IP,001,3,7240,7245,3142,5,PERF
42331338650000,PI,IP,001,4,7774,7780,3142,6,PERF
42331344640000,PI,PT,001,1,,,,,PERF
42395319180000,PI,IP,001,1,6289,11662,5766,5373,PERF
42479357130400,PI,IP,001,1,9712,9714,4506,2,PERF
42479357130400,PI,IP,001,2,9755,9757,4506,2,PERF
42479357130400,PI,IP,001,3,9798,9800,4506,2,PERF
42479357130400,PI,IP,001,4,9841,9843,4506,2,PERF
42479357130400,PI,IP,001,5,9884,9886,4506,2,PERF
42479357130400,PI,IP,001,6,9927,9929,4506,2,PERF
42479357130400,PI,IP,001,7,10012,10014,4506,2,PERF
42479357130400,PI,IP,001,8,10055,10057,4506,2,PERF
42479357130400,PI,IP,001,9,10098,10100,4506,2,PERF
42479357130400,PI,IP,001,10,10141,10143,4506,2,PERF
42479357130400,PI,IP,001,11,10184,10186,4506,2,PERF
42479357130400,PI,IP,001,12,10227,10229,4506,2,PERF
42479357130400,PI,IP,001,13,10312,10314,4506,2,PERF
42479357130400,PI,IP,001,14,10355,10357,4506,2,PERF
42479357130400,PI,IP,001,15,10398,10400,4506,2,PERF
42479357130400,PI,IP,001,16,10441,10443,4506,2,PERF
42479357130400,PI,IP,001,17,10484,10486,4506,2,PERF
42479357130400,PI,IP,001,18,10527,10529,4506,2,PERF
42479357130400,PI,IP,001,19,10612,10614,4506,2,PERF
42479357130400,PI,IP,001,20,10655,10657,4506,2,PERF
42479357130400,PI,IP,001,21,10698,10700,4506,2,PERF
42479357130400,PI,IP,001,22,10741,10743,4506,2,PERF
42479357130400,PI,IP,001,23,10784,10786,4506,2,PERF
42479357130400,PI,IP,001,24,10827,10829,4506,2,PERF
42479357130400,PI,IP,001,25,10912,10914,4506,2,PERF
42479357130400,PI,IP,001,26,10955,10957,4506,2,PERF
42479357130400,PI,IP,001,27,10998,11000,4506,2,PERF
42479357130400,PI,IP,001,28,11041,11043,4506,2,PERF
42479357130400,PI,IP,001,29,11084,11086,4506,2,PERF
42479357130400,PI,IP,001,30,11127,11129,4506,2,PERF
42479357130400,PI,IP,001,31,11212,11214,4506,2,PERF
42479357130400,PI,IP,001,32,11255,11257,4506,2,PERF
42479357130400,PI,IP,001,33,11298,11300,4506,2,PERF
42479357130400,PI,IP,001,34,11341,11343,4506,2,PERF
42479357130400,PI,IP,001,35,11384,11386,4506,2,PERF
42479357130400,PI,IP,001,36,11427,11429,4506,2,PERF
42479357130400,PI,IP,001,37,11512,11514,4506,2,PERF
42479357130400,PI,IP,001,38,11555,11557,4506,2,PERF
42479357130400,PI,IP,001,39,11598,11600,4506,2,PERF
42479357130400,PI,IP,001,40,11641,11643,4506,2,PERF
42479357130400,PI,IP,001,41,11684,11686,4506,2,PERF
42479357130400,PI,IP,001,42,11727,11729,4506,2,PERF
42479357130400,PI,IP,001,43,11812,11814,4506,2,PERF
42479357130400,PI,IP,001,44,11855,11857,4506,2,PERF
42479357130400,PI,IP,001,45,11898,11900,4506,2,PERF
42479357130400,PI,IP,001,46,11941,11943,4506,2,PERF
42479357130400,PI,IP,001,47,11984,11986,4506,2,PERF
42479357130400,PI,IP,001,48,12027,12029,4506,2,PERF
42479357130400,PI,IP,001,49,12112,12114,4506,2,PERF
42479357130400,PI,IP,001,50,12155,12157,4506,2,PERF
42479357130400,PI,IP,001,51,12198,12200,4506,2,PERF
42479357130400,PI,IP,001,52,12241,12243,4506,2,PERF
42479357130400,PI,IP,001,53,12284,12286,4506,2,PERF
42479357130400,PI,IP,001,54,12327,12329,4506,2,PERF
42479357130400,PI,IP,001,55,12412,12414,4506,2,PERF
42479357130400,PI,IP,001,56,12455,12457,4506,2,PERF
42479357130400,PI,IP,001,57,12498,12500,4506,2,PERF
42479357130400,PI,IP,001,58,12541,12543,4506,2,PERF
42479357130400,PI,IP,001,59,12584,12586,4506,2,PERF
42479357130400,PI,IP,001,60,12627,12629,4506,2,PERF
42479357130400,PI,IP,001,61,12712,12714,4506,2,PERF
42479357130400,PI,IP,001,62,12755,12757,4506,2,PERF
42479357130400,PI,IP,001,63,12798,12800,4506,2,PERF
42479357130400,PI,IP,001,64,12841,12843,4506,2,PERF
42479357130400,PI,IP,001,65,12884,12886,4506,2,PERF
42479357130400,PI,IP,001,66,12927,12929,4506,2,PERF
42479357130400,PI,IP,001,67,13012,13014,4506,2,PERF
42479357130400,PI,IP,001,68,13055,13057,4506,2,PERF
42479357130400,PI,IP,001,69,13098,13100,4506,2,PERF
42479357130400,PI,IP,001,70,13141,13143,4506,2,PERF
42479357130400,PI,IP,001,71,13184,13186,4506,2,PERF
42479357130400,PI,IP,001,72,13227,13229,4506,2,PERF
42479381340200,PI,IP,001,1,9501,11909,2275,2408,OPENHOLE
42479385810001,PI,IP,001,1,9150,9315,,165,PERF
42479401720000,PI,IP,001,1,11817,11987,3926,170,PERF
42479401720000,PI,IP,001,2,12010,12160,3926,150,PERF
42479401720000,PI,IP,001,3,12213,12380,3926,167,PERF
42479401720000,PI,IP,001,4,12412,12583,3926,171,PERF
42479401720000,PI,IP,001,5,12630,12777,3926,147,PERF
42479401720000,PI,IP,001,6,12819,12973,3926,154,PERF
42479401720000,PI,IP,001,7,13020,13182,3926,162,PERF
42479404930000,PI,IP,001,1,9749,11385,4364,1636,PERF
42479405610000,PI,IP,001,1,11808,12106,4555,298,PERF
42479405610000,PI,IP,001,2,12420,12672,4555,252,PERF
42479405610000,PI,IP,001,3,12746,12987,4555,241,PERF
42479405610000,PI,IP,001,4,13080,13337,4555,257,PERF
42479405610000,PI,IP,001,5,13410,13660,4555,250,PERF
42479405610000,PI,IP,001,6,13730,13987,4555,257,PERF
42479405610000,PI,IP,001,7,14065,14327,4555,262,PERF
42479405610000,PI,IP,001,8,14400,14542,4555,142,PERF
42479405610000,PI,IP,001,9,14542,15504,4555,962,PERF
42479405760000,PI,IP,001,1,8972,14129,6154,5157,PERF
42479406030000,PI,IP,001,1,8515,12643,5542,4128,PERF
42479406190000,PI,IP,001,1,8793,12302,4461,3509,PERF
42479406210000,PI,IP,001,1,9547,14566,5995,5019,PERF
42479406500000,PI,IP,001,1,8906,12787,4722,3881,PERF
42479406580100,PI,IP,001,1,13570,17802,5002,4232,PERF
42479406630000,PI,IP,001,1,8223,13124,6063,4901,PERF
42479406690000,PI,IP,001,1,10978,11228,4092,250,PERF
42479406690000,PI,IP,001,2,11330,11585,4092,255,PERF
42479406690000,PI,IP,001,3,11680,11935,4092,255,PERF
42479406690000,PI,IP,001,4,12032,12285,4092,253,PERF
42479406690000,PI,IP,001,5,12380,12637,4092,257,PERF
42479406690000,PI,IP,001,6,12726,12985,4092,259,PERF
42479406690000,PI,IP,001,7,13080,13335,4092,255,PERF
42479406690000,PI,IP,001,8,13430,13685,4092,255,PERF
42479406690000,PI,IP,001,9,13780,14035,4092,255,PERF
42479406690000,PI,IP,001,10,14130,14385,4092,255,PERF
42479406700000,PI,IP,001,1,7842,12861,5582,5019,PERF
42479406730000,PI,IP,001,1,12126,12352,5951,226,PERF
42479406730000,PI,IP,001,2,12421,12647,5951,226,PERF
42479406730000,PI,IP,001,3,12779,12943,5951,164,PERF
42479406730000,PI,IP,001,4,13013,13238,5951,225,PERF
42479406730000,PI,IP,001,5,13308,13534,5951,226,PERF
42479406730000,PI,IP,001,6,13604,13830,5951,226,PERF
42479406730000,PI,IP,001,7,13900,14125,5951,225,PERF
42479406730000,PI,IP,001,8,14195,14388,5951,193,PERF
42479406730000,PI,IP,001,9,14491,14717,5951,226,PERF
42479406730000,PI,IP,001,10,14787,15013,5951,226,PERF
42479406730000,PI,IP,001,11,15083,15308,5951,225,PERF
42479406730000,PI,IP,001,12,15378,15604,5951,226,PERF
42479406730000,PI,IP,001,13,15674,15873,5951,199,PERF
42479406730000,PI,IP,001,14,15944,16143,5951,199,PERF
42479406730000,PI,IP,001,15,16212,16411,5951,199,PERF
42479406730000,PI,IP,001,16,16481,16680,5951,199,PERF
42479406730000,PI,IP,001,17,16750,16950,5951,200,PERF
42479406730000,PI,IP,001,18,17019,17295,5951,276,PERF
42479406730000,PI,IP,001,19,17289,17295,5951,6,PERF
42479406820000,PI,IP,001,1,7697,12725,5948,5028,PERF
42479406900000,PI,IP,001,1,8069,12721,6087,4652,PERF
42479406920000,PI,IP,001,1,12260,12487,,227,PERF
42479406920000,PI,IP,001,2,12560,12787,,227,PERF
42479406920000,PI,IP,001,3,12860,13087,,227,PERF
42479406920000,PI,IP,001,4,13160,13387,,227,PERF
42479406920000,PI,IP,001,5,13640,13687,,47,PERF
42479406920000,PI,IP,001,6,13760,13987,,227,PERF
42479406920000,PI,IP,001,7,14060,14287,,227,PERF
42479406920000,PI,IP,001,8,14360,14587,,227,PERF
42479406920000,PI,IP,001,9,14660,14880,,220,PERF
42479406920000,PI,IP,001,10,14950,15132,,182,PERF
42479406950000,PI,IP,001,1,8971,13915,5597,4944,PERF
42479406970000,PI,IP,001,1,8997,14001,6156,5004,PERF
42479407010000,PI,IP,001,1,8119,13150,6119,5031,PERF
42479407030000,PI,IP,001,1,7877,12951,6189,5074,PERF
42479407050000,PI,IP,001,1,10535,10760,4912,225,PERF
42479407050000,PI,IP,001,2,10821,11046,4912,225,PERF
42479407050000,PI,IP,001,3,11107,11332,4912,225,PERF
42479407050000,PI,IP,001,4,11393,11618,4912,225,PERF
42479407050000,PI,IP,001,5,11679,11904,4912,225,PERF
42479407050000,PI,IP,001,6,11965,12190,4912,225,PERF
42479407050000,PI,IP,001,7,12251,12476,4912,225,PERF
42479407050000,PI,IP,001,8,12537,12762,4912,225,PERF
42479407050000,PI,IP,001,9,12823,13048,4912,225,PERF
42479407050000,PI,IP,001,10,13109,13334,4912,225,PERF
42479407050000,PI,IP,001,11,13395,13620,4912,225,PERF
42479407050000,PI,IP,001,12,13681,13906,4912,225,PERF
42479407170000,PI,IP,001,1,8246,8415,5203,169,PERF
42479407170000,PI,IP,001,2,8511,8679,5203,168,PERF
42479407170000,PI,IP,001,3,8776,8945,5203,169,PERF
42479407170000,PI,IP,001,4,9041,9210,5203,169,PERF
42479407170000,PI,IP,001,5,9306,9475,5203,169,PERF
42479407170000,PI,IP,001,6,9571,9740,5203,169,PERF
42479407170000,PI,IP,001,7,9836,10005,5203,169,PERF
42479407170000,PI,IP,001,8,10101,10270,5203,169,PERF
42479407170000,PI,IP,001,9,10366,10535,5203,169,PERF
42479407170000,PI,IP,001,10,10631,10800,5203,169,PERF
42479407170000,PI,IP,001,11,10896,11065,5203,169,PERF
42479407170000,PI,IP,001,12,11161,11330,5203,169,PERF
42479407170000,PI,IP,001,13,11416,11595,5203,179,PERF
42479407170000,PI,IP,001,14,11691,11860,5203,169,PERF
42479407170000,PI,IP,001,15,11956,12125,5203,169,PERF
42479407170000,PI,IP,001,16,12221,12390,5203,169,PERF
42479407170000,PI,IP,001,17,12486,12655,5203,169,PERF
42479407170000,PI,IP,001,18,12751,12921,5203,170,PERF
42479407180000,PI,IP,001,1,13210,13212,4984,2,PERF
42479407180000,PI,IP,001,2,13280,13282,4984,2,PERF
42479407180000,PI,IP,001,3,13350,13352,4984,2,PERF
42479407180000,PI,IP,001,4,13420,13422,4984,2,PERF
42479407180000,PI,IP,001,5,13527,13529,4984,2,PERF
42479407180000,PI,IP,001,6,13597,13599,4984,2,PERF
42479407180000,PI,IP,001,7,13667,13669,4984,2,PERF
42479407180000,PI,IP,001,8,13737,13739,4984,2,PERF
42479407180000,PI,IP,001,9,13844,13846,4984,2,PERF
42479407180000,PI,IP,001,10,13914,13916,4984,2,PERF
42479407180000,PI,IP,001,11,13984,13986,4984,2,PERF
42479407180000,PI,IP,001,12,14054,14056,4984,2,PERF
42479407180000,PI,IP,001,13,14161,14163,4984,2,PERF
42479407180000,PI,IP,001,14,14231,14233,4984,2,PERF
42479407180000,PI,IP,001,15,14301,14303,4984,2,PERF
42479407180000,PI,IP,001,16,14371,14373,4984,2,PERF
42479407180000,PI,IP,001,17,14478,14480,4984,2,PERF
42479407180000,PI,IP,001,18,14548,14550,4984,2,PERF
42479407180000,PI,IP,001,19,14618,14620,4984,2,PERF
42479407180000,PI,IP,001,20,14688,14690,4984,2,PERF
42479407180000,PI,IP,001,21,14795,14797,4984,2,PERF
42479407180000,PI,IP,001,22,14865,14867,4984,2,PERF
42479407180000,PI,IP,001,23,14935,14937,4984,2,PERF
42479407180000,PI,IP,001,24,15005,15007,4984,2,PERF
42479407180000,PI,IP,001,25,15112,15114,4984,2,PERF
42479407180000,PI,IP,001,26,15192,15194,4984,2,PERF
42479407180000,PI,IP,001,27,15272,15274,4984,2,PERF
42479407180000,PI,IP,001,28,15352,15354,4984,2,PERF
42479407360000,PI,IP,001,1,9153,14036,6394,4883,PERF
42479407380000,PI,IP,001,1,9221,12932,5046,3711,PERF
42479407400100,PI,IP,001,1,8614,8616,5981,2,PERF
42479407400100,PI,IP,001,2,8659,8661,5981,2,PERF
42479407400100,PI,IP,001,3,8704,8706,5981,2,PERF
42479407400100,PI,IP,001,4,8749,8751,5981,2,PERF
42479407400100,PI,IP,001,5,8794,8796,5981,2,PERF
42479407400100,PI,IP,001,6,8839,8841,5981,2,PERF
42479407400100,PI,IP,001,7,8922,8924,5981,2,PERF
42479407400100,PI,IP,001,8,8967,8969,5981,2,PERF
42479407400100,PI,IP,001,9,9012,9014,5981,2,PERF
42479407400100,PI,IP,001,10,9057,9059,5981,2,PERF
42479407400100,PI,IP,001,11,9102,9104,5981,2,PERF
42479407400100,PI,IP,001,12,9147,9149,5981,2,PERF
42479407400100,PI,IP,001,13,9230,9232,5981,2,PERF
42479407400100,PI,IP,001,14,9275,9277,5981,2,PERF
42479407400100,PI,IP,001,15,9320,9322,5981,2,PERF
42479407400100,PI,IP,001,16,9365,9367,5981,2,PERF
42479407400100,PI,IP,001,17,9410,9412,5981,2,PERF
42479407400100,PI,IP,001,18,9455,9457,5981,2,PERF
42479407400100,PI,IP,001,19,9538,9540,5981,2,PERF
42479407400100,PI,IP,001,20,9583,9585,5981,2,PERF
42479407400100,PI,IP,001,21,9628,9630,5981,2,PERF
42479407400100,PI,IP,001,22,9673,9675,5981,2,PERF
42479407400100,PI,IP,001,23,9718,9720,5981,2,PERF
42479407400100,PI,IP,001,24,9763,9765,5981,2,PERF
42479407400100,PI,IP,001,25,9846,9848,5981,2,PERF
42479407400100,PI,IP,001,26,9891,9893,5981,2,PERF
42479407400100,PI,IP,001,27,9936,9938,5981,2,PERF
42479407400100,PI,IP,001,28,9981,9983,5981,2,PERF
42479407400100,PI,IP,001,29,10026,10028,5981,2,PERF
42479407400100,PI,IP,001,30,10071,10073,5981,2,PERF
42479407400100,PI,IP,001,31,10154,10156,5981,2,PERF
42479407400100,PI,IP,001,32,10199,10201,5981,2,PERF
42479407400100,PI,IP,001,33,10244,10246,5981,2,PERF
42479407400100,PI,IP,001,34,10289,10291,5981,2,PERF
42479407400100,PI,IP,001,35,10334,10336,5981,2,PERF
42479407400100,PI,IP,001,36,10379,10381,5981,2,PERF
42479407400100,PI,IP,001,37,10462,10464,5981,2,PERF
42479407400100,PI,IP,001,38,10507,10509,5981,2,PERF
42479407400100,PI,IP,001,39,10552,10554,5981,2,PERF
42479407400100,PI,IP,001,40,10597,10599,5981,2,PERF
42479407400100,PI,IP,001,41,10642,10644,5981,2,PERF
42479407400100,PI,IP,001,42,10687,10689,5981,2,PERF
42479407400100,PI,IP,001,43,10770,10772,5981,2,PERF
42479407400100,PI,IP,001,44,10815,10817,5981,2,PERF
42479407400100,PI,IP,001,45,10860,10862,5981,2,PERF
42479407400100,PI,IP,001,46,10905,10907,5981,2,PERF
42479407400100,PI,IP,001,47,10950,10952,5981,2,PERF
42479407400100,PI,IP,001,48,10995,10997,5981,2,PERF
42479407400100,PI,IP,001,49,11078,11080,5981,2,PERF
42479407400100,PI,IP,001,50,11123,11125,5981,2,PERF
42479407400100,PI,IP,001,51,11168,11170,5981,2,PERF
42479407400100,PI,IP,001,52,11213,11215,5981,2,PERF
42479407400100,PI,IP,001,53,11258,11260,5981,2,PERF
42479407400100,PI,IP,001,54,11303,11305,5981,2,PERF
42479407400100,PI,IP,001,55,11386,11388,5981,2,PERF
42479407400100,PI,IP,001,56,11431,11433,5981,2,PERF
42479407400100,PI,IP,001,57,11476,11478,5981,2,PERF
42479407400100,PI,IP,001,58,11521,11523,5981,2,PERF
42479407400100,PI,IP,001,59,11566,11568,5981,2,PERF
42479407400100,PI,IP,001,60,11611,11613,5981,2,PERF
42479407400100,PI,IP,001,61,11694,11696,5981,2,PERF
42479407400100,PI,IP,001,62,11739,11741,5981,2,PERF
42479407400100,PI,IP,001,63,11784,11786,5981,2,PERF
42479407400100,PI,IP,001,64,11829,11831,5981,2,PERF
42479407400100,PI,IP,001,65,11874,11876,5981,2,PERF
42479407400100,PI,IP,001,66,11919,11921,5981,2,PERF
42479407400100,PI,IP,001,67,12002,12004,5981,2,PERF
42479407400100,PI,IP,001,68,12047,12049,5981,2,PERF
42479407400100,PI,IP,001,69,12092,12094,5981,2,PERF
42479407400100,PI,IP,001,70,12137,12139,5981,2,PERF
42479407400100,PI,IP,001,71,12182,12184,5981,2,PERF
42479407400100,PI,IP,001,72,12227,12229,5981,2,PERF
42479407400100,PI,IP,001,73,12310,12312,5981,2,PERF
42479407400100,PI,IP,001,74,12355,12357,5981,2,PERF
42479407400100,PI,IP,001,75,12400,12402,5981,2,PERF
42479407400100,PI,IP,001,76,12445,12447,5981,2,PERF
42479407400100,PI,IP,001,77,12490,12492,5981,2,PERF
42479407400100,PI,IP,001,78,12535,12537,5981,2,PERF
42479407400100,PI,IP,001,79,12618,12620,5981,2,PERF
42479407400100,PI,IP,001,80,12663,12665,5981,2,PERF
42479407400100,PI,IP,001,81,12708,12710,5981,2,PERF
42479407400100,PI,IP,001,82,12753,12755,5981,2,PERF
42479407400100,PI,IP,001,83,12798,12800,5981,2,PERF
42479407400100,PI,IP,001,84,12843,12845,5981,2,PERF
42479407400100,PI,IP,001,85,12926,12928,5981,2,PERF
42479407400100,PI,IP,001,86,12971,12973,5981,2,PERF
42479407400100,PI,IP,001,87,13016,13018,5981,2,PERF
42479407400100,PI,IP,001,88,13061,13063,5981,2,PERF
42479407400100,PI,IP,001,89,13106,13108,5981,2,PERF
42479407400100,PI,IP,001,90,13151,13153,5981,2,PERF
42479407400100,PI,IP,001,91,13234,13236,5981,2,PERF
42479407400100,PI,IP,001,92,13279,13281,5981,2,PERF
42479407400100,PI,IP,001,93,13324,13326,5981,2,PERF
42479407400100,PI,IP,001,94,13369,13371,5981,2,PERF
42479407400100,PI,IP,001,95,13414,13416,5981,2,PERF
42479407400100,PI,IP,001,96,13459,13461,5981,2,PERF
42479407400100,PI,IP,001,97,13542,13544,5981,2,PERF
42479407400100,PI,IP,001,98,13587,13589,5981,2,PERF
42479407400100,PI,IP,001,99,13632,13634,5981,2,PERF
42479407400100,PI,IP,001,100,13677,13679,5981,2,PERF
42479407400100,PI,IP,001,101,13722,13724,5981,2,PERF
42479407400100,PI,IP,001,102,13767,13769,5981,2,PERF
42479407410000,PI,IP,001,1,9388,14450,6173,5062,PERF
42479407420000,PI,IP,001,1,9920,13574,5483,3654,PERF
42479407430000,PI,IP,001,1,8981,8983,5537,2,PERF
42479407430000,PI,IP,001,2,9051,9053,5537,2,PERF
42479407430000,PI,IP,001,3,9121,9123,5537,2,PERF
42479407430000,PI,IP,001,4,9191,9193,5537,2,PERF
42479407430000,PI,IP,001,5,9308,9310,5537,2,PERF
42479407430000,PI,IP,001,6,9378,9380,5537,2,PERF
42479407430000,PI,IP,001,7,9448,9450,5537,2,PERF
42479407430000,PI,IP,001,8,9518,9520,5537,2,PERF
42479407430000,PI,IP,001,9,9635,9637,5537,2,PERF
42479407430000,PI,IP,001,10,9705,9707,5537,2,PERF
42479407430000,PI,IP,001,11,9775,9777,5537,2,PERF
42479407430000,PI,IP,001,12,9845,9847,5537,2,PERF
42479407430000,PI,IP,001,13,9962,9964,5537,2,PERF
42479407430000,PI,IP,001,14,10032,10034,5537,2,PERF
42479407430000,PI,IP,001,15,10102,10104,5537,2,PERF
42479407430000,PI,IP,001,16,10172,10174,5537,2,PERF
42479407430000,PI,IP,001,17,10289,10291,5537,2,PERF
42479407430000,PI,IP,001,18,10359,10361,5537,2,PERF
42479407430000,PI,IP,001,19,10429,10431,5537,2,PERF
42479407430000,PI,IP,001,20,10499,10501,5537,2,PERF
42479407430000,PI,IP,001,21,10616,10618,5537,2,PERF
42479407430000,PI,IP,001,22,10686,10688,5537,2,PERF
42479407430000,PI,IP,001,23,10756,10758,5537,2,PERF
42479407430000,PI,IP,001,24,10826,10828,5537,2,PERF
42479407430000,PI,IP,001,25,10943,10945,5537,2,PERF
42479407430000,PI,IP,001,26,11013,11015,5537,2,PERF
42479407430000,PI,IP,001,27,11083,11085,5537,2,PERF
42479407430000,PI,IP,001,28,11153,11155,5537,2,PERF
42479407430000,PI,IP,001,29,11270,11272,5537,2,PERF
42479407430000,PI,IP,001,30,11340,11342,5537,2,PERF
42479407430000,PI,IP,001,31,11410,11412,5537,2,PERF
42479407430000,PI,IP,001,32,11480,11482,5537,2,PERF
42479407430000,PI,IP,001,33,11597,11599,5537,2,PERF
42479407430000,PI,IP,001,34,11667,11669,5537,2,PERF
42479407430000,PI,IP,001,35,11737,11739,5537,2,PERF
42479407430000,PI,IP,001,36,11807,11809,5537,2,PERF
42479407430000,PI,IP,001,37,11924,11926,5537,2,PERF
42479407430000,PI,IP,001,38,11994,11996,5537,2,PERF
42479407430000,PI,IP,001,39,12064,12066,5537,2,PERF
42479407430000,PI,IP,001,40,12134,12136,5537,2,PERF
42479407430000,PI,IP,001,41,12251,12253,5537,2,PERF
42479407430000,PI,IP,001,42,12321,12323,5537,2,PERF
42479407430000,PI,IP,001,43,12391,12393,5537,2,PERF
42479407430000,PI,IP,001,44,12461,12463,5537,2,PERF
42479407430000,PI,IP,001,45,12578,12580,5537,2,PERF
42479407430000,PI,IP,001,46,12648,12650,5537,2,PERF
42479407430000,PI,IP,001,47,12718,12720,5537,2,PERF
42479407430000,PI,IP,001,48,12788,12790,5537,2,PERF
42479407430000,PI,IP,001,49,12905,12907,5537,2,PERF
42479407430000,PI,IP,001,50,12975,12977,5537,2,PERF
42479407430000,PI,IP,001,51,13045,13047,5537,2,PERF
42479407430000,PI,IP,001,52,13115,13117,5537,2,PERF
42479407430000,PI,IP,001,53,13232,13234,5537,2,PERF
42479407430000,PI,IP,001,54,13302,13304,5537,2,PERF
42479407430000,PI,IP,001,55,13372,13374,5537,2,PERF
42479407430000,PI,IP,001,56,13442,13444,5537,2,PERF
42479407440000,PI,IP,001,1,8726,13050,5264,4324,PERF
42479407460100,PI,IP,001,1,8491,8493,,2,PERF
42479407460100,PI,IP,001,2,8533,8535,,2,PERF
42479407460100,PI,IP,001,3,8575,8577,,2,PERF
42479407460100,PI,IP,001,4,8617,8619,,2,PERF
42479407460100,PI,IP,001,5,8659,8661,,2,PERF
42479407460100,PI,IP,001,6,8701,8703,,2,PERF
42479407460100,PI,IP,001,7,8788,8790,,2,PERF
42479407460100,PI,IP,001,8,8830,8832,,2,PERF
42479407460100,PI,IP,001,9,8872,8874,,2,PERF
42479407460100,PI,IP,001,10,8914,8916,,2,PERF
42479407460100,PI,IP,001,11,8956,8958,,2,PERF
42479407460100,PI,IP,001,12,8998,9000,,2,PERF
42479407460100,PI,IP,001,13,9085,9086,,1,PERF
42479407460100,PI,IP,001,14,9126,9127,,1,PERF
42479407460100,PI,IP,001,15,9167,9168,,1,PERF
42479407460100,PI,IP,001,16,9208,9209,,1,PERF
42479407460100,PI,IP,001,17,9249,9250,,1,PERF
42479407460100,PI,IP,001,18,9290,9291,,1,PERF
42479407460100,PI,IP,001,19,9376,9378,,2,PERF
42479407460100,PI,IP,001,20,9418,9420,,2,PERF
42479407460100,PI,IP,001,21,9460,9462,,2,PERF
42479407460100,PI,IP,001,22,9502,9504,,2,PERF
42479407460100,PI,IP,001,23,9544,9546,,2,PERF
42479407460100,PI,IP,001,24,9586,9588,,2,PERF
42479407460100,PI,IP,001,25,9673,9675,,2,PERF
42479407460100,PI,IP,001,26,9715,9717,,2,PERF
42479407460100,PI,IP,001,27,9757,9759,,2,PERF
42479407460100,PI,IP,001,28,9799,9801,,2,PERF
42479407460100,PI,IP,001,29,9841,9843,,2,PERF
42479407460100,PI,IP,001,30,9883,9885,,2,PERF
42479407460100,PI,IP,001,31,9970,9972,,2,PERF
42479407460100,PI,IP,001,32,10012,10014,,2,PERF
42479407460100,PI,IP,001,33,10054,10056,,2,PERF
42479407460100,PI,IP,001,34,10096,10098,,2,PERF
42479407460100,PI,IP,001,35,10138,10140,,2,PERF
42479407460100,PI,IP,001,36,10180,10182,,2,PERF
42479407460100,PI,IP,001,37,10236,10237,,1,PERF
42479407460100,PI,IP,001,38,10267,10268,,1,PERF
42479407460100,PI,IP,001,39,10308,10309,,1,PERF
42479407460100,PI,IP,001,40,10349,10350,,1,PERF
42479407460100,PI,IP,001,41,10431,10432,,1,PERF
42479407460100,PI,IP,001,42,10472,10473,,1,PERF
42479407460100,PI,IP,001,43,10558,10560,,2,PERF
42479407460100,PI,IP,001,44,10600,10602,,2,PERF
42479407460100,PI,IP,001,45,10642,10644,,2,PERF
42479407460100,PI,IP,001,46,10684,10686,,2,PERF
42479407460100,PI,IP,001,47,10726,10728,,2,PERF
42479407460100,PI,IP,001,48,10768,10770,,2,PERF
42479407460100,PI,IP,001,49,10855,10857,,2,PERF
42479407460100,PI,IP,001,50,10897,10899,,2,PERF
42479407460100,PI,IP,001,51,10939,10941,,2,PERF
42479407460100,PI,IP,001,52,10981,10983,,2,PERF
42479407460100,PI,IP,001,53,11023,11025,,2,PERF
42479407460100,PI,IP,001,54,11065,11067,,2,PERF
42479407460100,PI,IP,001,55,11236,11238,,2,PERF
42479407460100,PI,IP,001,56,11278,11280,,2,PERF
42479407460100,PI,IP,001,57,11320,11322,,2,PERF
42479407460100,PI,IP,001,58,11362,11364,,2,PERF
42479407460100,PI,IP,001,59,11449,11450,,1,PERF
42479407460100,PI,IP,001,60,11490,11491,,1,PERF
42479407460100,PI,IP,001,61,11531,11532,,1,PERF
42479407460100,PI,IP,001,62,11572,11573,,1,PERF
42479407460100,PI,IP,001,63,11613,11614,,1,PERF
42479407460100,PI,IP,001,64,11654,11655,,1,PERF
42479407460100,PI,IP,001,65,11740,11742,,2,PERF
42479407460100,PI,IP,001,66,11782,11784,,2,PERF
42479407460100,PI,IP,001,67,11824,11826,,2,PERF
42479407460100,PI,IP,001,68,11866,11868,,2,PERF
42479407460100,PI,IP,001,69,11908,11910,,2,PERF
42479407460100,PI,IP,001,70,11950,11952,,2,PERF
42479407460100,PI,IP,001,71,12037,12039,,2,PERF
42479407460100,PI,IP,001,72,12079,12081,,2,PERF
42479407460100,PI,IP,001,73,12121,12123,,2,PERF
42479407460100,PI,IP,001,74,12163,12165,,2,PERF
42479407460100,PI,IP,001,75,12205,12207,,2,PERF
42479407460100,PI,IP,001,76,12247,12249,,2,PERF
42479407460100,PI,IP,001,77,12334,12336,,2,PERF
42479407460100,PI,IP,001,78,12376,12378,,2,PERF
42479407460100,PI,IP,001,79,12418,12420,,2,PERF
42479407460100,PI,IP,001,80,12460,12462,,2,PERF
42479407460100,PI,IP,001,81,12502,12504,,2,PERF
42479407460100,PI,IP,001,82,12544,12546,,2,PERF
42479407460100,PI,IP,001,83,12631,12633,,2,PERF
42479407460100,PI,IP,001,84,12673,12675,,2,PERF
42479407460100,PI,IP,001,85,12715,12717,,2,PERF
42479407460100,PI,IP,001,86,12757,12759,,2,PERF
42479407460100,PI,IP,001,87,12799,12801,,2,PERF
42479407460100,PI,IP,001,88,12841,12843,,2,PERF
42479407460100,PI,IP,001,89,12928,12930,,2,PERF
42479407460100,PI,IP,001,90,12970,12972,,2,PERF
42479407460100,PI,IP,001,91,13012,13014,,2,PERF
42479407460100,PI,IP,001,92,13054,13056,,2,PERF
42479407460100,PI,IP,001,93,13096,13098,,2,PERF
42479407460100,PI,IP,001,94,13138,13140,,2,PERF
42479407460100,PI,IP,001,95,13225,13227,,2,PERF
42479407460100,PI,IP,001,96,13267,13269,,2,PERF
42479407460100,PI,IP,001,97,13309,13311,,2,PERF
42479407460100,PI,IP,001,98,13351,13353,,2,PERF
42479407460100,PI,IP,001,99,13393,13395,,2,PERF
42479407460100,PI,IP,001,100,13435,13437,,2,PERF
42479407470000,PI,IP,001,1,7321,12380,6118,5059,PERF
42479407550000,PI,IP,001,1,9560,13962,5620,4402,PERF
42479407560000,PI,IP,001,1,7355,12400,5912,5045,PERF
42479407570000,PI,IP,001,1,8668,8670,1298,2,PERF
42479407570000,PI,IP,001,2,8708,8710,1298,2,PERF
42479407570000,PI,IP,001,3,8748,8750,1298,2,PERF
42479407570000,PI,IP,001,4,8788,8790,1298,2,PERF
42479407570000,PI,IP,001,5,8834,8836,1298,2,PERF
42479407570000,PI,IP,001,6,8868,8870,1298,2,PERF
42479407570000,PI,IP,001,7,8948,8950,1298,2,PERF
42479407570000,PI,IP,001,8,8988,8990,1298,2,PERF
42479407570000,PI,IP,001,9,9028,9030,1298,2,PERF
42479407570000,PI,IP,001,10,9068,9070,1298,2,PERF
42479407570000,PI,IP,001,11,9108,9110,1298,2,PERF
42479407570000,PI,IP,001,12,9148,9150,1298,2,PERF
42479407570000,PI,IP,001,13,9228,9230,1298,2,PERF
42479407570000,PI,IP,001,14,9268,9270,1298,2,PERF
42479407570000,PI,IP,001,15,9308,9310,1298,2,PERF
42479407570000,PI,IP,001,16,9348,9350,1298,2,PERF
42479407570000,PI,IP,001,17,9388,9390,1298,2,PERF
42479407570000,PI,IP,001,18,9428,9430,1298,2,PERF
42479407570000,PI,IP,001,19,9508,9510,1298,2,PERF
42479407570000,PI,IP,001,20,9548,9550,1298,2,PERF
42479407570000,PI,IP,001,21,9588,9590,1298,2,PERF
42479407570000,PI,IP,001,22,9628,9630,1298,2,PERF
42479407570000,PI,IP,001,23,9668,9670,1298,2,PERF
42479407570000,PI,IP,001,24,9708,9710,1298,2,PERF
42479407710000,PI,IP,001,1,9057,13110,5192,4053,PERF
42479407760000,PI,IP,001,1,9146,14190,5537,5044,PERF
42479407800000,PI,IP,001,1,9115,9117,6064,2,PERF
42479407800000,PI,IP,001,2,9180,9182,6064,2,PERF
42479407800000,PI,IP,001,3,9245,9247,6064,2,PERF
42479407800000,PI,IP,001,4,9310,9312,6064,2,PERF
42479407800000,PI,IP,001,5,9412,9414,6064,2,PERF
42479407800000,PI,IP,001,6,9492,9494,6064,2,PERF
42479407800000,PI,IP,001,7,9572,9574,6064,2,PERF
42479407800000,PI,IP,001,8,9652,9654,6064,2,PERF
42479407800000,PI,IP,001,9,9769,9771,6064,2,PERF
42479407800000,PI,IP,001,10,9849,9851,6064,2,PERF
42479407800000,PI,IP,001,11,9929,9931,6064,2,PERF
42479407800000,PI,IP,001,12,10009,10011,6064,2,PERF
42479407800000,PI,IP,001,13,10126,10128,6064,2,PERF
42479407800000,PI,IP,001,14,10206,10208,6064,2,PERF
42479407800000,PI,IP,001,15,10286,10288,6064,2,PERF
42479407800000,PI,IP,001,16,10366,10368,6064,2,PERF
42479407800000,PI,IP,001,17,10483,10485,6064,2,PERF
42479407800000,PI,IP,001,18,10563,10565,6064,2,PERF
42479407800000,PI,IP,001,19,10643,10645,6064,2,PERF
42479407800000,PI,IP,001,20,10723,10725,6064,2,PERF
42479407800000,PI,IP,001,21,10840,10842,6064,2,PERF
42479407800000,PI,IP,001,22,10920,10922,6064,2,PERF
42479407800000,PI,IP,001,23,11000,11002,6064,2,PERF
42479407800000,PI,IP,001,24,11080,11082,6064,2,PERF
42479407800000,PI,IP,001,25,11197,11199,6064,2,PERF
42479407800000,PI,IP,001,26,11277,11279,6064,2,PERF
42479407800000,PI,IP,001,27,11357,11359,6064,2,PERF
42479407800000,PI,IP,001,28,11437,11439,6064,2,PERF
42479407800000,PI,IP,001,29,11554,11556,6064,2,PERF
42479407800000,PI,IP,001,30,11634,11636,6064,2,PERF
42479407800000,PI,IP,001,31,11714,11716,6064,2,PERF
42479407800000,PI,IP,001,32,11749,11751,6064,2,PERF
42479407800000,PI,IP,001,33,11911,11913,6064,2,PERF
42479407800000,PI,IP,001,34,11991,11993,6064,2,PERF
42479407800000,PI,IP,001,35,12071,12073,6064,2,PERF
42479407800000,PI,IP,001,36,12151,12153,6064,2,PERF
42479407800000,PI,IP,001,37,12268,12270,6064,2,PERF
42479407800000,PI,IP,001,38,12348,12350,6064,2,PERF
42479407800000,PI,IP,001,39,12428,12430,6064,2,PERF
42479407800000,PI,IP,001,40,12508,12510,6064,2,PERF
42479407800000,PI,IP,001,41,12625,12627,6064,2,PERF
42479407800000,PI,IP,001,42,12705,12707,6064,2,PERF
42479407800000,PI,IP,001,43,12785,12787,6064,2,PERF
42479407800000,PI,IP,001,44,12865,12867,6064,2,PERF
42479407800000,PI,IP,001,45,12982,12984,6064,2,PERF
42479407800000,PI,IP,001,46,13062,13064,6064,2,PERF
42479407800000,PI,IP,001,47,13142,13144,6064,2,PERF
42479407800000,PI,IP,001,48,13222,13224,6064,2,PERF
42479407800000,PI,IP,001,49,13339,13341,6064,2,PERF
42479407800000,PI,IP,001,50,13419,13421,6064,2,PERF
42479407800000,PI,IP,001,51,13499,13501,6064,2,PERF
42479407800000,PI,IP,001,52,13579,13581,6064,2,PERF
42479407800000,PI,IP,001,53,13696,13698,6064,2,PERF
42479407800000,PI,IP,001,54,13776,13778,6064,2,PERF
42479407800000,PI,IP,001,55,13856,13858,6064,2,PERF
42479407800000,PI,IP,001,56,13936,13938,6064,2,PERF
42479407800000,PI,IP,001,57,14053,14055,6064,2,PERF
42479407800000,PI,IP,001,58,14193,14195,6064,2,PERF
42479407800000,PI,IP,001,59,14263,14265,6064,2,PERF
42479407810000,PI,IP,001,1,9355,9357,5772,2,PERF
42479407810000,PI,IP,001,2,9425,9427,5772,2,PERF
42479407810000,PI,IP,001,3,9495,9497,5772,2,PERF
42479407810000,PI,IP,001,4,9565,9567,5772,2,PERF
42479407810000,PI,IP,001,5,9672,9674,5772,2,PERF
42479407810000,PI,IP,001,6,9742,9744,5772,2,PERF
42479407810000,PI,IP,001,7,9812,9814,5772,2,PERF
42479407810000,PI,IP,001,8,9882,9884,5772,2,PERF
42479407810000,PI,IP,001,9,9989,9991,5772,2,PERF
42479407810000,PI,IP,001,10,10059,10061,5772,2,PERF
42479407810000,PI,IP,001,11,10129,10131,5772,2,PERF
42479407810000,PI,IP,001,12,10199,10201,5772,2,PERF
42479407810000,PI,IP,001,13,10306,10308,5772,2,PERF
42479407810000,PI,IP,001,14,10376,10378,5772,2,PERF
42479407810000,PI,IP,001,15,10446,10448,5772,2,PERF
42479407810000,PI,IP,001,16,10516,10518,5772,2,PERF
42479407810000,PI,IP,001,17,10623,10625,5772,2,PERF
42479407810000,PI,IP,001,18,10693,10695,5772,2,PERF
42479407810000,PI,IP,001,19,10763,10765,5772,2,PERF
42479407810000,PI,IP,001,20,10833,10835,5772,2,PERF
42479407810000,PI,IP,001,21,10940,10942,5772,2,PERF
42479407810000,PI,IP,001,22,11010,11012,5772,2,PERF
42479407810000,PI,IP,001,23,11080,11082,5772,2,PERF
42479407810000,PI,IP,001,24,11150,11152,5772,2,PERF
42479407810000,PI,IP,001,25,11257,11259,5772,2,PERF
42479407810000,PI,IP,001,26,11327,11329,5772,2,PERF
42479407810000,PI,IP,001,27,11397,11399,5772,2,PERF
42479407810000,PI,IP,001,28,11467,11469,5772,2,PERF
42479407810000,PI,IP,001,29,11574,11576,5772,2,PERF
42479407810000,PI,IP,001,30,11644,11646,5772,2,PERF
42479407810000,PI,IP,001,31,11714,11716,5772,2,PERF
42479407810000,PI,IP,001,32,11784,11786,5772,2,PERF
42479407810000,PI,IP,001,33,11891,11893,5772,2,PERF
42479407810000,PI,IP,001,34,11961,11963,5772,2,PERF
42479407810000,PI,IP,001,35,12031,12033,5772,2,PERF
42479407810000,PI,IP,001,36,12101,12103,5772,2,PERF
42479407810000,PI,IP,001,37,12202,12204,5772,2,PERF
42479407810000,PI,IP,001,38,12278,12280,5772,2,PERF
42479407810000,PI,IP,001,39,12348,12350,5772,2,PERF
42479407810000,PI,IP,001,40,12418,12420,5772,2,PERF
42479407810000,PI,IP,001,41,12525,12527,5772,2,PERF
42479407810000,PI,IP,001,42,12595,12597,5772,2,PERF
42479407810000,PI,IP,001,43,12665,12667,5772,2,PERF
42479407810000,PI,IP,001,44,12735,12737,5772,2,PERF
42479407810000,PI,IP,001,45,12842,12844,5772,2,PERF
42479407810000,PI,IP,001,46,12912,12914,5772,2,PERF
42479407810000,PI,IP,001,47,12982,12984,5772,2,PERF
42479407810000,PI,IP,001,48,13052,13054,5772,2,PERF
42479407810000,PI,IP,001,49,13159,13161,5772,2,PERF
42479407810000,PI,IP,001,50,13229,13231,5772,2,PERF
42479407810000,PI,IP,001,51,13299,13301,5772,2,PERF
42479407810000,PI,IP,001,52,13369,13371,5772,2,PERF
42479407810000,PI,IP,001,53,13476,13478,5772,2,PERF
42479407810000,PI,IP,001,54,13546,13548,5772,2,PERF
42479407810000,PI,IP,001,55,13616,13618,5772,2,PERF
42479407810000,PI,IP,001,56,13686,13688,5772,2,PERF
42479407810000,PI,IP,001,57,13793,13795,5772,2,PERF
42479407810000,PI,IP,001,58,13863,13865,5772,2,PERF
42479407810000,PI,IP,001,59,13933,13935,5772,2,PERF
42479407810000,PI,IP,001,60,14013,14015,5772,2,PERF
42479407860000,PI,IP,001,1,10000,10000,6023,0,PERF
42479407860000,PI,IP,001,2,10050,10050,6023,0,PERF
42479407860000,PI,IP,001,3,10100,10100,6023,0,PERF
42479407860000,PI,IP,001,4,10150,10150,6023,0,PERF
42479407860000,PI,IP,001,5,10200,10200,6023,0,PERF
42479407860000,PI,IP,001,6,10250,10250,6023,0,PERF
42479407860000,PI,IP,001,7,10300,10300,6023,0,PERF
42479407860000,PI,IP,001,8,10350,10350,6023,0,PERF
42479407860000,PI,IP,001,9,10400,10400,6023,0,PERF
42479407860000,PI,IP,001,10,10450,10450,6023,0,PERF
42479407860000,PI,IP,001,11,10500,10500,6023,0,PERF
42479407860000,PI,IP,001,12,10550,10550,6023,0,PERF
42479407860000,PI,IP,001,13,10600,10600,6023,0,PERF
42479407860000,PI,IP,001,14,10650,10650,6023,0,PERF
42479407860000,PI,IP,001,15,10700,10700,6023,0,PERF
42479407860000,PI,IP,001,16,10750,10750,6023,0,PERF
42479407860000,PI,IP,001,17,10800,10800,6023,0,PERF
42479407860000,PI,IP,001,18,10850,10850,6023,0,PERF
42479407860000,PI,IP,001,19,10900,10900,6023,0,PERF
42479407860000,PI,IP,001,20,10950,10950,6023,0,PERF
42479407860000,PI,IP,001,21,11000,11000,6023,0,PERF
42479407860000,PI,IP,001,22,11050,11050,6023,0,PERF
42479407860000,PI,IP,001,23,11100,11100,6023,0,PERF
42479407860000,PI,IP,001,24,11150,11150,6023,0,PERF
42479407860000,PI,IP,001,25,11200,11200,6023,0,PERF
42479407860000,PI,IP,001,26,11250,11250,6023,0,PERF
42479407860000,PI,IP,001,27,11300,11300,6023,0,PERF
42479407860000,PI,IP,001,28,11350,11350,6023,0,PERF
42479407860000,PI,IP,001,29,11400,11400,6023,0,PERF
42479407860000,PI,IP,001,30,11450,11450,6023,0,PERF
42479407860000,PI,IP,001,31,11500,11500,6023,0,PERF
42479407860000,PI,IP,001,32,11550,11550,6023,0,PERF
42479407860000,PI,IP,001,33,11600,11600,6023,0,PERF
42479407860000,PI,IP,001,34,11650,11650,6023,0,PERF
42479407860000,PI,IP,001,35,11700,11700,6023,0,PERF
42479407860000,PI,IP,001,36,11750,11750,6023,0,PERF
42479407860000,PI,IP,001,37,11800,11800,6023,0,PERF
42479407860000,PI,IP,001,38,11850,11850,6023,0,PERF
42479407860000,PI,IP,001,39,11900,11900,6023,0,PERF
42479407860000,PI,IP,001,40,11950,11950,6023,0,PERF
42479407860000,PI,IP,001,41,12000,12000,6023,0,PERF
42479407860000,PI,IP,001,42,12050,12050,6023,0,PERF
42479407860000,PI,IP,001,43,12100,12100,6023,0,PERF
42479407860000,PI,IP,001,44,12150,12150,6023,0,PERF
42479407860000,PI,IP,001,45,12200,12200,6023,0,PERF
42479407860000,PI,IP,001,46,12250,12250,6023,0,PERF
42479407860000,PI,IP,001,47,12300,12300,6023,0,PERF
42479407860000,PI,IP,001,48,12350,12350,6023,0,PERF
42479407860000,PI,IP,001,49,12400,12400,6023,0,PERF
42479407860000,PI,IP,001,50,12450,12450,6023,0,PERF
42479407860000,PI,IP,001,51,12500,12500,6023,0,PERF
42479407860000,PI,IP,001,52,12550,12550,6023,0,PERF
42479407860000,PI,IP,001,53,12600,12600,6023,0,PERF
42479407860000,PI,IP,001,54,12650,12650,6023,0,PERF
42479407860000,PI,IP,001,55,12700,12700,6023,0,PERF
42479407860000,PI,IP,001,56,12750,12750,6023,0,PERF
42479407860000,PI,IP,001,57,12800,12800,6023,0,PERF
42479407860000,PI,IP,001,58,12850,12850,6023,0,PERF
42479407860000,PI,IP,001,59,12900,12900,6023,0,PERF
42479407860000,PI,IP,001,60,12950,12950,6023,0,PERF
42479407860000,PI,IP,001,61,13000,13000,6023,0,PERF
42479407860000,PI,IP,001,62,13050,13050,6023,0,PERF
42479407860000,PI,IP,001,63,13100,13100,6023,0,PERF
42479407860000,PI,IP,001,64,13150,13150,6023,0,PERF
42479407860000,PI,IP,001,65,13200,13200,6023,0,PERF
42479407860000,PI,IP,001,66,13250,13250,6023,0,PERF
42479407860000,PI,IP,001,67,13300,13300,6023,0,PERF
42479407860000,PI,IP,001,68,13350,13350,6023,0,PERF
42479407860000,PI,IP,001,69,13400,13400,6023,0,PERF
42479407860000,PI,IP,001,70,13450,13450,6023,0,PERF
42479407860000,PI,IP,001,71,13500,13500,6023,0,PERF
42479407860000,PI,IP,001,72,13550,13550,6023,0,PERF
42479407860000,PI,IP,001,73,13600,13600,6023,0,PERF
42479407860000,PI,IP,001,74,13650,13650,6023,0,PERF
42479407860000,PI,IP,001,75,13700,13700,6023,0,PERF
42479407860000,PI,IP,001,76,13750,13750,6023,0,PERF
42479407860000,PI,IP,001,77,13800,13800,6023,0,PERF
42479407860000,PI,IP,001,78,13850,13850,6023,0,PERF
42479407860000,PI,IP,001,79,13900,13900,6023,0,PERF
42479407860000,PI,IP,001,80,13950,13950,6023,0,PERF
42479407860000,PI,IP,001,81,14000,14000,6023,0,PERF
42479407860000,PI,IP,001,82,14050,14050,6023,0,PERF
42479407860000,PI,IP,001,83,14100,14100,6023,0,PERF
42479407860000,PI,IP,001,84,14150,14150,6023,0,PERF
42479407860000,PI,IP,001,85,14200,14200,6023,0,PERF
42479407860000,PI,IP,001,86,14250,14250,6023,0,PERF
42479407860000,PI,IP,001,87,14300,14300,6023,0,PERF
42479407860000,PI,IP,001,88,14350,14350,6023,0,PERF
42479407860000,PI,IP,001,89,14400,14400,6023,0,PERF
42479407860000,PI,IP,001,90,14450,14450,6023,0,PERF
42479407860000,PI,IP,001,91,14500,14500,6023,0,PERF
42479407860000,PI,IP,001,92,14550,14550,6023,0,PERF
42479407860000,PI,IP,001,93,14600,14600,6023,0,PERF
42479407860000,PI,IP,001,94,14650,14650,6023,0,PERF
42479407860000,PI,IP,001,95,14700,14700,6023,0,PERF
42479407860000,PI,IP,001,96,14750,14750,6023,0,PERF
42479407860000,PI,IP,001,97,14800,14800,6023,0,PERF
42479407860000,PI,IP,001,98,14850,14850,6023,0,PERF
42479407860000,PI,IP,001,99,14900,14900,6023,0,PERF
42479407860000,PI,IP,001,100,14950,14950,6023,0,PERF
42479407860000,PI,IP,001,101,15000,15000,6023,0,PERF
42479407860000,PI,IP,001,102,15050,15050,6023,0,PERF
42479407860000,PI,IP,001,103,15118,15118,6023,0,PERF
42479407860000,PI,IP,001,104,15168,15168,6023,0,PERF
42479407860000,PI,IP,001,105,15218,15218,6023,0,PERF
42479407860000,PI,IP,001,106,15288,15288,6023,0,PERF
42479407860000,PI,IP,001,107,15328,15328,6023,0,PERF
42479407860000,PI,IP,001,108,15376,15376,6023,0,PERF
42479407870000,PI,IP,001,1,10250,15670,6307,5420,PERF
42479407890000,PI,IP,001,1,11116,16074,5443,4958,PERF
42479407910100,PI,IP,001,1,10624,14695,4782,4071,PERF
42479407930000,PI,IP,001,1,9316,14927,6503,5611,PERF
42479407940000,PI,IP,001,1,9341,14952,6487,5611,PERF
42479407970000,PI,IP,002,1,8470,15593,5288,7123,PERF
42479407970000,PI,PT,001,1,8470,8707,5288,237,PERF
42479407970000,PI,PT,001,2,8783,9020,5288,237,PERF
42479407970000,PI,PT,001,3,9096,9333,5288,237,PERF
42479407970000,PI,PT,001,4,9409,9646,5288,237,PERF
42479407970000,PI,PT,001,5,9722,9959,5288,237,PERF
42479407970000,PI,PT,001,6,10035,10272,5288,237,PERF
42479407970000,PI,PT,001,7,10348,10585,5288,237,PERF
42479407970000,PI,PT,001,8,10661,10898,5288,237,PERF
42479407970000,PI,PT,001,9,10974,11211,5288,237,PERF
42479407970000,PI,PT,001,10,11287,11524,5288,237,PERF
42479407970000,PI,PT,001,11,11600,11837,5288,237,PERF
42479407970000,PI,PT,001,12,11913,12150,5288,237,PERF
42479407970000,PI,PT,001,13,12226,12463,5288,237,PERF
42479407970000,PI,PT,001,14,12539,12776,5288,237,PERF
42479407970000,PI,PT,001,15,12852,13089,5288,237,PERF
42479407970000,PI,PT,001,16,13165,13402,5288,237,PERF
42479407970000,PI,PT,001,17,13478,13715,5288,237,PERF
42479407970000,PI,PT,001,18,13791,14028,5288,237,PERF
42479407970000,PI,PT,001,19,14104,14341,5288,237,PERF
42479407970000,PI,PT,001,20,14417,14654,5288,237,PERF
42479407970000,PI,PT,001,21,14730,14967,5288,237,PERF
42479407970000,PI,PT,001,22,15043,15280,5288,237,PERF
42479407970000,PI,PT,001,23,15356,15593,5288,237,PERF
42479407990100,PI,IP,001,1,10100,15850,6805,5750,PERF
42479408010000,PI,IP,001,1,9960,14652,5602,4692,PERF
42479408030000,PI,IP,001,1,9067,9069,6017,2,PERF
42479408030000,PI,IP,001,2,9142,9144,6017,2,PERF
42479408030000,PI,IP,001,3,9220,9222,6017,2,PERF
42479408030000,PI,IP,001,4,9292,9294,6017,2,PERF
42479408030000,PI,IP,001,5,9404,9406,6017,2,PERF
42479408030000,PI,IP,001,6,9479,9481,6017,2,PERF
42479408030000,PI,IP,001,7,9554,9556,6017,2,PERF
42479408030000,PI,IP,001,8,9629,9631,6017,2,PERF
42479408030000,PI,IP,001,9,9741,9743,6017,2,PERF
42479408030000,PI,IP,001,10,9816,9818,6017,2,PERF
42479408030000,PI,IP,001,11,9891,9893,6017,2,PERF
42479408030000,PI,IP,001,12,9966,9968,6017,2,PERF
42479408030000,PI,IP,001,13,10073,10075,6017,2,PERF
42479408030000,PI,IP,001,14,10153,10155,6017,2,PERF
42479408030000,PI,IP,001,15,10228,10230,6017,2,PERF
42479408030000,PI,IP,001,16,10303,10305,6017,2,PERF
42479408030000,PI,IP,001,17,10415,10417,6017,2,PERF
42479408030000,PI,IP,001,18,10490,10492,6017,2,PERF
42479408030000,PI,IP,001,19,10565,10567,6017,2,PERF
42479408030000,PI,IP,001,20,10638,10640,6017,2,PERF
42479408030000,PI,IP,001,21,10752,10754,6017,2,PERF
42479408030000,PI,IP,001,22,10827,10829,6017,2,PERF
42479408030000,PI,IP,001,23,10902,10904,6017,2,PERF
42479408030000,PI,IP,001,24,10977,10979,6017,2,PERF
42479408030000,PI,IP,001,25,11089,11091,6017,2,PERF
42479408030000,PI,IP,001,26,11164,11166,6017,2,PERF
42479408030000,PI,IP,001,27,11239,11241,6017,2,PERF
42479408030000,PI,IP,001,28,11314,11316,6017,2,PERF
42479408030000,PI,IP,001,29,11426,11428,6017,2,PERF
42479408030000,PI,IP,001,30,11498,11500,6017,2,PERF
42479408030000,PI,IP,001,31,11576,11578,6017,2,PERF
42479408030000,PI,IP,001,32,11651,11653,6017,2,PERF
42479408030000,PI,IP,001,33,11763,11765,6017,2,PERF
42479408030000,PI,IP,001,34,11838,11840,6017,2,PERF
42479408030000,PI,IP,001,35,11913,11915,6017,2,PERF
42479408030000,PI,IP,001,36,11988,11990,6017,2,PERF
42479408030000,PI,IP,001,37,12098,12100,6017,2,PERF
42479408030000,PI,IP,001,38,12175,12177,6017,2,PERF
42479408030000,PI,IP,001,39,12250,12252,6017,2,PERF
42479408030000,PI,IP,001,40,12326,12328,6017,2,PERF
42479408030000,PI,IP,001,41,12437,12439,6017,2,PERF
42479408030000,PI,IP,001,42,12512,12514,6017,2,PERF
42479408030000,PI,IP,001,43,12587,12589,6017,2,PERF
42479408030000,PI,IP,001,44,12662,12664,6017,2,PERF
42479408030000,PI,IP,001,45,12774,12776,6017,2,PERF
42479408030000,PI,IP,001,46,12849,12851,6017,2,PERF
42479408030000,PI,IP,001,47,12924,12926,6017,2,PERF
42479408030000,PI,IP,001,48,12999,13001,6017,2,PERF
42479408030000,PI,IP,001,49,13111,13113,6017,2,PERF
42479408030000,PI,IP,001,50,13178,13180,6017,2,PERF
42479408030000,PI,IP,001,51,13248,13250,6017,2,PERF
42479408030000,PI,IP,001,52,13318,13320,6017,2,PERF
42479408030000,PI,IP,001,53,13448,13450,6017,2,PERF
42479408030000,PI,IP,001,54,13523,13525,6017,2,PERF
42479408030000,PI,IP,001,55,13598,13600,6017,2,PERF
42479408030000,PI,IP,001,56,13673,13675,6017,2,PERF
42479408030000,PI,IP,001,57,13785,13787,6017,2,PERF
42479408030000,PI,IP,001,58,13860,13862,6017,2,PERF
42479408030000,PI,IP,001,59,13935,13937,6017,2,PERF
42479408030000,PI,IP,001,60,14010,14012,6017,2,PERF
42479408060000,PI,IP,001,1,7356,12370,5946,5014,PERF
42479408070000,PI,IP,001,1,9309,14955,6600,5646,PERF
42479408080000,PI,IP,001,1,9391,9393,6072,2,PERF
42479408080000,PI,IP,001,2,9462,9464,6072,2,PERF
42479408080000,PI,IP,001,3,9537,9539,6072,2,PERF
42479408080000,PI,IP,001,4,9612,9614,6072,2,PERF
42479408080000,PI,IP,001,5,9724,9726,6072,2,PERF
42479408080000,PI,IP,001,6,9799,9801,6072,2,PERF
42479408080000,PI,IP,001,7,9874,9876,6072,2,PERF
42479408080000,PI,IP,001,8,9949,9951,6072,2,PERF
42479408080000,PI,IP,001,9,10068,10070,6072,2,PERF
42479408080000,PI,IP,001,10,10136,10138,6072,2,PERF
42479408080000,PI,IP,001,11,10211,10213,6072,2,PERF
42479408080000,PI,IP,001,12,10286,10288,6072,2,PERF
42479408080000,PI,IP,001,13,10398,10400,6072,2,PERF
42479408080000,PI,IP,001,14,10473,10475,6072,2,PERF
42479408080000,PI,IP,001,15,10548,10550,6072,2,PERF
42479408080000,PI,IP,001,16,10623,10625,6072,2,PERF
42479408080000,PI,IP,001,17,10735,10737,6072,2,PERF
42479408080000,PI,IP,001,18,10810,10812,6072,2,PERF
42479408080000,PI,IP,001,19,10885,10887,6072,2,PERF
42479408080000,PI,IP,001,20,10966,10968,6072,2,PERF
42479408080000,PI,IP,001,21,11072,11074,6072,2,PERF
42479408080000,PI,IP,001,22,11147,11149,6072,2,PERF
42479408080000,PI,IP,001,23,11222,11224,6072,2,PERF
42479408080000,PI,IP,001,24,11292,11294,6072,2,PERF
42479408080000,PI,IP,001,25,11409,11411,6072,2,PERF
42479408080000,PI,IP,001,26,11484,11486,6072,2,PERF
42479408080000,PI,IP,001,27,11556,11558,6072,2,PERF
42479408080000,PI,IP,001,28,11636,11638,6072,2,PERF
42479408080000,PI,IP,001,29,11746,11748,6072,2,PERF
42479408080000,PI,IP,001,30,11824,11826,6072,2,PERF
42479408080000,PI,IP,001,31,11892,11894,6072,2,PERF
42479408080000,PI,IP,001,32,11971,11973,6072,2,PERF
42479408080000,PI,IP,001,33,12083,12085,6072,2,PERF
42479408080000,PI,IP,001,34,12156,12158,6072,2,PERF
42479408080000,PI,IP,001,35,12233,12235,6072,2,PERF
42479408080000,PI,IP,001,36,12308,12310,6072,2,PERF
42479408080000,PI,IP,001,37,12422,12424,6072,2,PERF
42479408080000,PI,IP,001,38,12495,12497,6072,2,PERF
42479408080000,PI,IP,001,39,12570,12572,6072,2,PERF
42479408080000,PI,IP,001,40,12645,12647,6072,2,PERF
42479408080000,PI,IP,001,41,12752,12754,6072,2,PERF
42479408080000,PI,IP,001,42,12832,12834,6072,2,PERF
42479408080000,PI,IP,001,43,12907,12909,6072,2,PERF
42479408080000,PI,IP,001,44,12982,12984,6072,2,PERF
42479408080000,PI,IP,001,45,13094,13096,6072,2,PERF
42479408080000,PI,IP,001,46,13169,13171,6072,2,PERF
42479408080000,PI,IP,001,47,13244,13246,6072,2,PERF
42479408080000,PI,IP,001,48,13319,13321,6072,2,PERF
42479408080000,PI,IP,001,49,13431,13433,6072,2,PERF
42479408080000,PI,IP,001,50,13506,13508,6072,2,PERF
42479408080000,PI,IP,001,51,13581,13583,6072,2,PERF
42479408080000,PI,IP,001,52,13652,13654,6072,2,PERF
42479408080000,PI,IP,001,53,13768,13770,6072,2,PERF
42479408080000,PI,IP,001,54,13843,13845,6072,2,PERF
42479408080000,PI,IP,001,55,13918,13920,6072,2,PERF
42479408080000,PI,IP,001,56,13993,13995,6072,2,PERF
42479408080000,PI,IP,001,57,14105,14107,6072,2,PERF
42479408080000,PI,IP,001,58,14180,14182,6072,2,PERF
42479408080000,PI,IP,001,59,14255,14257,6072,2,PERF
42479408080000,PI,IP,001,60,14330,14332,6072,2,PERF
42479408090000,PI,IP,001,1,7452,12480,5864,5028,PERF
42479408100000,PI,IP,001,1,8967,8969,6001,2,PERF
42479408100000,PI,IP,001,2,9037,9039,6001,2,PERF
42479408100000,PI,IP,001,3,9107,9109,6001,2,PERF
42479408100000,PI,IP,001,4,9177,9179,6001,2,PERF
42479408100000,PI,IP,001,5,9264,9266,6001,2,PERF
42479408100000,PI,IP,001,6,9344,9346,6001,2,PERF
42479408100000,PI,IP,001,7,9424,9426,6001,2,PERF
42479408100000,PI,IP,001,8,9494,9496,6001,2,PERF
42479408100000,PI,IP,001,9,9581,9583,6001,2,PERF
42479408100000,PI,IP,001,10,9651,9653,6001,2,PERF
42479408100000,PI,IP,001,11,9721,9723,6001,2,PERF
42479408100000,PI,IP,001,12,9791,9793,6001,2,PERF
42479408100000,PI,IP,001,13,9878,9880,6001,2,PERF
42479408100000,PI,IP,001,14,9948,9950,6001,2,PERF
42479408100000,PI,IP,001,15,10018,10020,6001,2,PERF
42479408100000,PI,IP,001,16,10088,10090,6001,2,PERF
42479408100000,PI,IP,001,17,10175,10177,6001,2,PERF
42479408100000,PI,IP,001,18,10245,10247,6001,2,PERF
42479408100000,PI,IP,001,19,10315,10317,6001,2,PERF
42479408100000,PI,IP,001,20,10395,10397,6001,2,PERF
42479408100000,PI,IP,001,21,10667,10669,6001,2,PERF
42479408100000,PI,IP,001,22,10747,10749,6001,2,PERF
42479408100000,PI,IP,001,23,10827,10829,6001,2,PERF
42479408100000,PI,IP,001,24,10907,10909,6001,2,PERF
42479408100000,PI,IP,001,25,11024,11026,6001,2,PERF
42479408100000,PI,IP,001,26,11104,11106,6001,2,PERF
42479408100000,PI,IP,001,27,11184,11186,6001,2,PERF
42479408100000,PI,IP,001,28,11264,11266,6001,2,PERF
42479408100000,PI,IP,001,29,11381,11383,6001,2,PERF
42479408100000,PI,IP,001,30,11461,11463,6001,2,PERF
42479408100000,PI,IP,001,31,11541,11543,6001,2,PERF
42479408100000,PI,IP,001,32,11621,11623,6001,2,PERF
42479408100000,PI,IP,001,33,11738,11740,6001,2,PERF
42479408100000,PI,IP,001,34,11818,11820,6001,2,PERF
42479408100000,PI,IP,001,35,11898,11900,6001,2,PERF
42479408100000,PI,IP,001,36,11978,11980,6001,2,PERF
42479408100000,PI,IP,001,37,12095,12097,6001,2,PERF
42479408100000,PI,IP,001,38,12175,12177,6001,2,PERF
42479408100000,PI,IP,001,39,12255,12257,6001,2,PERF
42479408100000,PI,IP,001,40,12335,12337,6001,2,PERF
42479408100000,PI,IP,001,41,12452,12454,6001,2,PERF
42479408100000,PI,IP,001,42,12532,12534,6001,2,PERF
42479408100000,PI,IP,001,43,12612,12614,6001,2,PERF
42479408100000,PI,IP,001,44,12692,12694,6001,2,PERF
42479408100000,PI,IP,001,45,12809,12811,6001,2,PERF
42479408100000,PI,IP,001,46,12889,12891,6001,2,PERF
42479408100000,PI,IP,001,47,12969,12971,6001,2,PERF
42479408100000,PI,IP,001,48,13049,13051,6001,2,PERF
42479408100000,PI,IP,001,49,13166,13168,6001,2,PERF
42479408100000,PI,IP,001,50,13246,13248,6001,2,PERF
42479408100000,PI,IP,001,51,13326,13328,6001,2,PERF
42479408100000,PI,IP,001,52,13406,13408,6001,2,PERF
42479408100000,PI,IP,001,53,13523,13525,6001,2,PERF
42479408100000,PI,IP,001,54,13603,13605,6001,2,PERF
42479408100000,PI,IP,001,55,13683,13685,6001,2,PERF
42479408100000,PI,IP,001,56,13763,13765,6001,2,PERF
42479408100000,PI,IP,001,57,13880,13882,6001,2,PERF
42479408100000,PI,IP,001,58,13960,13962,6001,2,PERF
42479408100000,PI,IP,001,59,14040,14042,6001,2,PERF
42479408100000,PI,IP,001,60,14120,14122,6001,2,PERF
42479408110000,PI,IP,001,1,8905,13420,5606,4515,PERF
42479408120000,PI,IP,001,1,8862,8864,5413,2,PERF
42479408120000,PI,IP,001,2,8932,8934,5413,2,PERF
42479408120000,PI,IP,001,3,9002,9004,5413,2,PERF
42479408120000,PI,IP,001,4,9072,9074,5413,2,PERF
42479408120000,PI,IP,001,5,9189,9191,5413,2,PERF
42479408120000,PI,IP,001,6,9259,9261,5413,2,PERF
42479408120000,PI,IP,001,7,9329,9331,5413,2,PERF
42479408120000,PI,IP,001,8,9399,9401,5413,2,PERF
42479408120000,PI,IP,001,9,9516,9518,5413,2,PERF
42479408120000,PI,IP,001,10,9586,9588,5413,2,PERF
42479408120000,PI,IP,001,11,9656,9658,5413,2,PERF
42479408120000,PI,IP,001,12,9726,9728,5413,2,PERF
42479408120000,PI,IP,001,13,9843,9845,5413,2,PERF
42479408120000,PI,IP,001,14,9913,9915,5413,2,PERF
42479408120000,PI,IP,001,15,9983,9985,5413,2,PERF
42479408120000,PI,IP,001,16,10053,10055,5413,2,PERF
42479408120000,PI,IP,001,17,10170,10172,5413,2,PERF
42479408120000,PI,IP,001,18,10240,10242,5413,2,PERF
42479408120000,PI,IP,001,19,10310,10312,5413,2,PERF
42479408120000,PI,IP,001,20,10380,10382,5413,2,PERF
42479408120000,PI,IP,001,21,10497,10499,5413,2,PERF
42479408120000,PI,IP,001,22,10567,10569,5413,2,PERF
42479408120000,PI,IP,001,23,10637,10639,5413,2,PERF
42479408120000,PI,IP,001,24,10707,10709,5413,2,PERF
42479408120000,PI,IP,001,25,10824,10826,5413,2,PERF
42479408120000,PI,IP,001,26,10894,10896,5413,2,PERF
42479408120000,PI,IP,001,27,10964,10966,5413,2,PERF
42479408120000,PI,IP,001,28,11034,11036,5413,2,PERF
42479408120000,PI,IP,001,29,11151,11153,5413,2,PERF
42479408120000,PI,IP,001,30,11221,11223,5413,2,PERF
42479408120000,PI,IP,001,31,11291,11293,5413,2,PERF
42479408120000,PI,IP,001,32,11361,11363,5413,2,PERF
42479408120000,PI,IP,001,33,11478,11480,5413,2,PERF
42479408120000,PI,IP,001,34,11558,11560,5413,2,PERF
42479408120000,PI,IP,001,35,11618,11620,5413,2,PERF
42479408120000,PI,IP,001,36,11688,11690,5413,2,PERF
42479408120000,PI,IP,001,37,11805,11807,5413,2,PERF
42479408120000,PI,IP,001,38,11875,11877,5413,2,PERF
42479408120000,PI,IP,001,39,11945,11947,5413,2,PERF
42479408120000,PI,IP,001,40,12015,12017,5413,2,PERF
42479408120000,PI,IP,001,41,12132,12134,5413,2,PERF
42479408120000,PI,IP,001,42,12202,12204,5413,2,PERF
42479408120000,PI,IP,001,43,12272,12274,5413,2,PERF
42479408120000,PI,IP,001,44,12342,12344,5413,2,PERF
42479408120000,PI,IP,001,45,12459,12461,5413,2,PERF
42479408120000,PI,IP,001,46,12529,12531,5413,2,PERF
42479408120000,PI,IP,001,47,12559,12601,5413,42,PERF
42479408120000,PI,IP,001,48,12669,12671,5413,2,PERF
42479408120000,PI,IP,001,49,12786,12788,5413,2,PERF
42479408120000,PI,IP,001,50,12856,12858,5413,2,PERF
42479408120000,PI,IP,001,51,12926,12928,5413,2,PERF
42479408120000,PI,IP,001,52,12996,12998,5413,2,PERF
42479408120000,PI,IP,001,53,13113,13115,5413,2,PERF
42479408120000,PI,IP,001,54,13183,13185,5413,2,PERF
42479408120000,PI,IP,001,55,13253,13255,5413,2,PERF
42479408120000,PI,IP,001,56,13323,13325,5413,2,PERF
42479408130000,PI,IP,001,1,7129,12115,5817,4986,PERF
42479408150100,PI,IP,001,1,9975,14939,5521,4964,PERF
42479408160100,PI,IP,001,1,11297,11298,5779,1,PERF
42479408160100,PI,IP,001,2,11373,11374,5779,1,PERF
42479408160100,PI,IP,001,3,11449,11450,5779,1,PERF
42479408160100,PI,IP,001,4,11525,11526,5779,1,PERF
42479408160100,PI,IP,001,5,11602,11603,5779,1,PERF
42479408160100,PI,IP,001,6,11678,11679,5779,1,PERF
42479408160100,PI,IP,001,7,11754,11755,5779,1,PERF
42479408160100,PI,IP,001,8,11830,11831,5779,1,PERF
42479408160100,PI,IP,001,9,12211,12212,5779,1,PERF
42479408160100,PI,IP,001,10,12287,12288,5779,1,PERF
42479408160100,PI,IP,001,11,12363,12364,5779,1,PERF
42479408160100,PI,IP,001,12,12439,12440,5779,1,PERF
42479408160100,PI,IP,001,13,12515,12516,5779,1,PERF
42479408160100,PI,IP,001,14,12591,12592,5779,1,PERF
42479408160100,PI,IP,001,15,12667,12668,5779,1,PERF
42479408160100,PI,IP,001,16,12743,12744,5779,1,PERF
42479408160100,PI,IP,001,17,12820,12821,5779,1,PERF
42479408160100,PI,IP,001,18,12896,12897,5779,1,PERF
42479408160100,PI,IP,001,19,12972,12973,5779,1,PERF
42479408160100,PI,IP,001,20,13048,13049,5779,1,PERF
42479408160100,PI,IP,001,21,13124,13125,5779,1,PERF
42479408160100,PI,IP,001,22,13200,13201,5779,1,PERF
42479408160100,PI,IP,001,23,13276,13277,5779,1,PERF
42479408160100,PI,IP,001,24,13352,13353,5779,1,PERF
42479408160100,PI,IP,001,25,13429,13430,5779,1,PERF
42479408160100,PI,IP,001,26,13505,13506,5779,1,PERF
42479408160100,PI,IP,001,27,13581,13582,5779,1,PERF
42479408160100,PI,IP,001,28,13657,13658,5779,1,PERF
42479408160100,PI,IP,001,29,13733,13734,5779,1,PERF
42479408160100,PI,IP,001,30,13809,13810,5779,1,PERF
42479408160100,PI,IP,001,31,13885,13886,5779,1,PERF
42479408160100,PI,IP,001,32,13961,13962,5779,1,PERF
42479408160100,PI,IP,001,33,14038,14039,5779,1,PERF
42479408160100,PI,IP,001,34,14114,14115,5779,1,PERF
42479408160100,PI,IP,001,35,14190,14191,5779,1,PERF
42479408160100,PI,IP,001,36,14266,14267,5779,1,PERF
42479408160100,PI,IP,001,37,14342,14343,5779,1,PERF
42479408160100,PI,IP,001,38,14418,14419,5779,1,PERF
42479408160100,PI,IP,001,39,14494,14495,5779,1,PERF
42479408160100,PI,IP,001,40,14570,14571,5779,1,PERF
42479408160100,PI,IP,001,41,14647,14648,5779,1,PERF
42479408160100,PI,IP,001,42,14723,14724,5779,1,PERF
42479408160100,PI,IP,001,43,14799,14800,5779,1,PERF
42479408160100,PI,IP,001,44,14875,14876,5779,1,PERF
42479408160100,PI,IP,001,45,14951,14952,5779,1,PERF
42479408160100,PI,IP,001,46,15027,15028,5779,1,PERF
42479408160100,PI,IP,001,47,15103,15104,5779,1,PERF
42479408160100,PI,IP,001,48,15179,15180,5779,1,PERF
42479408160100,PI,IP,001,49,15256,15257,5779,1,PERF
42479408160100,PI,IP,001,50,15332,15333,5779,1,PERF
42479408160100,PI,IP,001,51,15408,15409,5779,1,PERF
42479408160100,PI,IP,001,52,15484,15485,5779,1,PERF
42479408160100,PI,IP,001,53,15551,15553,5779,2,PERF
42479408160100,PI,IP,001,54,15612,15614,5779,2,PERF
42479408160100,PI,IP,001,55,15673,15675,5779,2,PERF
42479408160100,PI,IP,001,56,15734,15736,5779,2,PERF
42479408160100,PI,IP,001,57,15795,15797,5779,2,PERF
42479408160100,PI,IP,001,58,15864,15865,5779,1,PERF
42479408160100,PI,IP,001,59,15940,15941,5779,1,PERF
42479408160100,PI,IP,001,60,16016,16017,5779,1,PERF
42479408160100,PI,IP,001,61,16092,16093,5779,1,PERF
42479408170000,PI,IP,001,1,8866,8868,5744,2,PERF
42479408170000,PI,IP,001,2,8936,8938,5744,2,PERF
42479408170000,PI,IP,001,3,9016,9018,5744,2,PERF
42479408170000,PI,IP,001,4,9091,9093,5744,2,PERF
42479408170000,PI,IP,001,5,9210,9212,5744,2,PERF
42479408170000,PI,IP,001,6,9280,9282,5744,2,PERF
42479408170000,PI,IP,001,7,9358,9360,5744,2,PERF
42479408170000,PI,IP,001,8,9433,9435,5744,2,PERF
42479408170000,PI,IP,001,9,9556,9558,5744,2,PERF
42479408170000,PI,IP,001,10,9625,9627,5744,2,PERF
42479408170000,PI,IP,001,11,9700,9702,5744,2,PERF
42479408170000,PI,IP,001,12,9775,9777,5744,2,PERF
42479408170000,PI,IP,001,13,9886,9888,5744,2,PERF
42479408170000,PI,IP,001,14,9967,9969,5744,2,PERF
42479408170000,PI,IP,001,15,10042,10044,5744,2,PERF
42479408170000,PI,IP,001,16,10117,10119,5744,2,PERF
42479408170000,PI,IP,001,17,10234,10236,5744,2,PERF
42479408170000,PI,IP,001,18,10309,10311,5744,2,PERF
42479408170000,PI,IP,001,19,10384,10386,5744,2,PERF
42479408170000,PI,IP,001,20,10454,10456,5744,2,PERF
42479408170000,PI,IP,001,21,10576,10578,5744,2,PERF
42479408170000,PI,IP,001,22,10651,10653,5744,2,PERF
42479408170000,PI,IP,001,23,10720,10722,5744,2,PERF
42479408170000,PI,IP,001,24,10801,10803,5744,2,PERF
42479408170000,PI,IP,001,25,10918,10920,5744,2,PERF
42479408170000,PI,IP,001,26,10996,10998,5744,2,PERF
42479408170000,PI,IP,001,27,11068,11070,5744,2,PERF
42479408170000,PI,IP,001,28,11143,11145,5744,2,PERF
42479408170000,PI,IP,001,29,11260,11262,5744,2,PERF
42479408170000,PI,IP,001,30,11335,11337,5744,2,PERF
42479408170000,PI,IP,001,31,11410,11412,5744,2,PERF
42479408170000,PI,IP,001,32,11485,11487,5744,2,PERF
42479408170000,PI,IP,001,33,11608,11610,5744,2,PERF
42479408170000,PI,IP,001,34,11677,11679,5744,2,PERF
42479408170000,PI,IP,001,35,11752,11754,5744,2,PERF
42479408170000,PI,IP,001,36,11830,11832,5744,2,PERF
42479408170000,PI,IP,001,37,11994,11996,5744,2,PERF
42479408170000,PI,IP,001,38,12019,12021,5744,2,PERF
42479408170000,PI,IP,001,39,12094,12096,5744,2,PERF
42479408170000,PI,IP,001,40,12165,12167,5744,2,PERF
42479408170000,PI,IP,001,41,12286,12288,5744,2,PERF
42479408170000,PI,IP,001,42,12361,12363,5744,2,PERF
42479408170000,PI,IP,001,43,12436,12438,5744,2,PERF
42479408170000,PI,IP,001,44,12511,12513,5744,2,PERF
42479408170000,PI,IP,001,45,12628,12630,5744,2,PERF
42479408170000,PI,IP,001,46,12700,12702,5744,2,PERF
42479408170000,PI,IP,001,47,12782,12785,5744,3,PERF
42479408170000,PI,IP,001,48,12853,12855,5744,2,PERF
42479408170000,PI,IP,001,49,12970,12972,5744,2,PERF
42479408170000,PI,IP,001,50,13045,13047,5744,2,PERF
42479408170000,PI,IP,001,51,13123,13125,5744,2,PERF
42479408170000,PI,IP,001,52,13195,13197,5744,2,PERF
42479408170000,PI,IP,001,53,13312,13314,5744,2,PERF
42479408170000,PI,IP,001,54,13387,13389,5744,2,PERF
42479408170000,PI,IP,001,55,13462,13464,5744,2,PERF
42479408170000,PI,IP,001,56,13537,13539,5744,2,PERF
42479408170000,PI,IP,001,57,13645,13647,5744,2,PERF
42479408170000,PI,IP,001,58,13715,13717,5744,2,PERF
42479408170000,PI,IP,001,59,13785,13787,5744,2,PERF
42479408170000,PI,IP,001,60,13825,13827,5744,2,PERF
42479408210001,PI,IP,001,1,10108,15149,,5041,PERF
42479408220000,PI,IP,001,1,10592,15751,5461,5159,PERF
42479408270000,PI,IP,001,1,13430,13662,4545,232,PERF
42479408270000,PI,IP,001,2,13740,13992,4545,252,PERF
42479408270000,PI,IP,001,3,14070,14317,4545,247,PERF
42479408270000,PI,IP,001,4,14400,14642,4545,242,PERF
42479408270000,PI,IP,001,5,14725,14967,4545,242,PERF
42479408270000,PI,IP,001,6,15050,15292,4545,242,PERF
42479408270000,PI,IP,001,7,15375,15617,4545,242,PERF
42479408270000,PI,IP,001,8,15700,15942,4545,242,PERF
42479408270000,PI,IP,001,9,16025,16267,4545,242,PERF
42479408270000,PI,IP,001,10,16350,16592,4545,242,PERF
42479408270000,PI,IP,001,11,16675,16871,4545,196,PERF
42479408270000,PI,IP,001,12,16964,17166,4545,202,PERF
42479408300000,PI,IP,001,1,9122,9124,6579,2,PERF
42479408300000,PI,IP,001,2,9210,9212,6579,2,PERF
42479408300000,PI,IP,001,3,9298,9300,6579,2,PERF
42479408300000,PI,IP,001,4,9386,9388,6579,2,PERF
42479408300000,PI,IP,001,5,9478,9480,6579,2,PERF
42479408300000,PI,IP,001,6,9566,9568,6579,2,PERF
42479408300000,PI,IP,001,7,9654,9656,6579,2,PERF
42479408300000,PI,IP,001,8,9742,9744,6579,2,PERF
42479408300000,PI,IP,001,9,9834,9836,6579,2,PERF
42479408300000,PI,IP,001,10,9922,9924,6579,2,PERF
42479408300000,PI,IP,001,11,10010,10012,6579,2,PERF
42479408300000,PI,IP,001,12,10098,10100,6579,2,PERF
42479408300000,PI,IP,001,13,10198,10200,6579,2,PERF
42479408300000,PI,IP,001,14,10282,10284,6579,2,PERF
42479408300000,PI,IP,001,15,10366,10368,6579,2,PERF
42479408300000,PI,IP,001,16,10454,10456,6579,2,PERF
42479408300000,PI,IP,001,17,10546,10548,6579,2,PERF
42479408300000,PI,IP,001,18,10634,10636,6579,2,PERF
42479408300000,PI,IP,001,19,10722,10724,6579,2,PERF
42479408300000,PI,IP,001,20,10810,10812,6579,2,PERF
42479408300000,PI,IP,001,21,10902,10904,6579,2,PERF
42479408300000,PI,IP,001,22,10990,10992,6579,2,PERF
42479408300000,PI,IP,001,23,11078,11080,6579,2,PERF
42479408300000,PI,IP,001,24,11166,11168,6579,2,PERF
42479408300000,PI,IP,001,25,11260,11262,6579,2,PERF
42479408300000,PI,IP,001,26,11346,11348,6579,2,PERF
42479408300000,PI,IP,001,27,11434,11436,6579,2,PERF
42479408300000,PI,IP,001,28,11522,11524,6579,2,PERF
42479408300000,PI,IP,001,29,11614,11616,6579,2,PERF
42479408300000,PI,IP,001,30,11702,11704,6579,2,PERF
42479408300000,PI,IP,001,31,11790,11792,6579,2,PERF
42479408300000,PI,IP,001,32,11878,11880,6579,2,PERF
42479408300000,PI,IP,001,33,11968,11970,6579,2,PERF
42479408300000,PI,IP,001,34,12054,12056,6579,2,PERF
42479408300000,PI,IP,001,35,12154,12156,6579,2,PERF
42479408300000,PI,IP,001,36,12238,12240,6579,2,PERF
42479408300000,PI,IP,001,37,12326,12328,6579,2,PERF
42479408300000,PI,IP,001,38,12414,12416,6579,2,PERF
42479408300000,PI,IP,001,39,12502,12504,6579,2,PERF
42479408300000,PI,IP,001,40,12590,12592,6579,2,PERF
42479408300000,PI,IP,001,41,12682,12684,6579,2,PERF
42479408300000,PI,IP,001,42,12770,12772,6579,2,PERF
42479408300000,PI,IP,001,43,12858,12860,6579,2,PERF
42479408300000,PI,IP,001,44,12946,12948,6579,2,PERF
42479408300000,PI,IP,001,45,13038,13040,6579,2,PERF
42479408300000,PI,IP,001,46,13122,13124,6579,2,PERF
42479408300000,PI,IP,001,47,13208,13210,6579,2,PERF
42479408300000,PI,IP,001,48,13310,13312,6579,2,PERF
42479408300000,PI,IP,001,49,13394,13396,6579,2,PERF
42479408300000,PI,IP,001,50,13482,13484,6579,2,PERF
42479408300000,PI,IP,001,51,13570,13572,6579,2,PERF
42479408300000,PI,IP,001,52,13658,13660,6579,2,PERF
42479408300000,PI,IP,001,53,13750,13752,6579,2,PERF
42479408300000,PI,IP,001,54,13838,13840,6579,2,PERF
42479408300000,PI,IP,001,55,13926,13928,6579,2,PERF
42479408300000,PI,IP,001,56,14014,14016,6579,2,PERF
42479408300000,PI,IP,001,57,14106,14108,6579,2,PERF
42479408300000,PI,IP,001,58,14194,14196,6579,2,PERF
42479408300000,PI,IP,001,59,14282,14284,6579,2,PERF
42479408300000,PI,IP,001,60,14370,14372,6579,2,PERF
42479408300000,PI,IP,001,61,14462,14464,6579,2,PERF
42479408300000,PI,IP,001,62,14537,14539,6579,2,PERF
42479408300000,PI,IP,001,63,14612,14614,6579,2,PERF
42479408300000,PI,IP,001,64,14687,14689,6579,2,PERF
42479408310000,PI,IP,001,1,10450,10450,7045,0,PERF
42479408310000,PI,IP,001,2,10500,10500,7045,0,PERF
42479408310000,PI,IP,001,3,10550,10550,7045,0,PERF
42479408310000,PI,IP,001,4,10600,10600,7045,0,PERF
42479408310000,PI,IP,001,5,10650,10650,7045,0,PERF
42479408310000,PI,IP,001,6,10700,10700,7045,0,PERF
42479408310000,PI,IP,001,7,10750,10750,7045,0,PERF
42479408310000,PI,IP,001,8,10800,10800,7045,0,PERF
42479408310000,PI,IP,001,9,10850,10850,7045,0,PERF
42479408310000,PI,IP,001,10,10900,10900,7045,0,PERF
42479408310000,PI,IP,001,11,10950,10950,7045,0,PERF
42479408310000,PI,IP,001,12,11000,11000,7045,0,PERF
42479408310000,PI,IP,001,13,11050,11050,7045,0,PERF
42479408310000,PI,IP,001,14,11100,11100,7045,0,PERF
42479408310000,PI,IP,001,15,11150,11150,7045,0,PERF
42479408310000,PI,IP,001,16,11200,11200,7045,0,PERF
42479408310000,PI,IP,001,17,11250,11250,7045,0,PERF
42479408310000,PI,IP,001,18,11300,11300,7045,0,PERF
42479408310000,PI,IP,001,19,11350,11350,7045,0,PERF
42479408310000,PI,IP,001,20,11400,11400,7045,0,PERF
42479408310000,PI,IP,001,21,11450,11450,7045,0,PERF
42479408310000,PI,IP,001,22,11500,11500,7045,0,PERF
42479408310000,PI,IP,001,23,11550,11550,7045,0,PERF
42479408310000,PI,IP,001,24,11600,11600,7045,0,PERF
42479408310000,PI,IP,001,25,11650,11650,7045,0,PERF
42479408310000,PI,IP,001,26,11700,11700,7045,0,PERF
42479408310000,PI,IP,001,27,11750,11750,7045,0,PERF
42479408310000,PI,IP,001,28,11800,11800,7045,0,PERF
42479408310000,PI,IP,001,29,11850,11850,7045,0,PERF
42479408310000,PI,IP,001,30,11900,11900,7045,0,PERF
42479408310000,PI,IP,001,31,11950,11950,7045,0,PERF
42479408310000,PI,IP,001,32,12000,12000,7045,0,PERF
42479408310000,PI,IP,001,33,12050,12050,7045,0,PERF
42479408310000,PI,IP,001,34,12100,12100,7045,0,PERF
42479408310000,PI,IP,001,35,12150,12150,7045,0,PERF
42479408310000,PI,IP,001,36,12200,12200,7045,0,PERF
42479408310000,PI,IP,001,37,12250,12250,7045,0,PERF
42479408310000,PI,IP,001,38,12300,12300,7045,0,PERF
42479408310000,PI,IP,001,39,12350,12350,7045,0,PERF
42479408310000,PI,IP,001,40,12400,12400,7045,0,PERF
42479408310000,PI,IP,001,41,12450,12450,7045,0,PERF
42479408310000,PI,IP,001,42,12500,12500,7045,0,PERF
42479408310000,PI,IP,001,43,12550,12550,7045,0,PERF
42479408310000,PI,IP,001,44,12600,12600,7045,0,PERF
42479408310000,PI,IP,001,45,12650,12650,7045,0,PERF
42479408310000,PI,IP,001,46,12700,12700,7045,0,PERF
42479408310000,PI,IP,001,47,12750,12750,7045,0,PERF
42479408310000,PI,IP,001,48,12800,12800,7045,0,PERF
42479408310000,PI,IP,001,49,12850,12850,7045,0,PERF
42479408310000,PI,IP,001,50,12900,12900,7045,0,PERF
42479408310000,PI,IP,001,51,12950,12950,7045,0,PERF
42479408310000,PI,IP,001,52,13000,13000,7045,0,PERF
42479408310000,PI,IP,001,53,13050,13050,7045,0,PERF
42479408310000,PI,IP,001,54,13100,13100,7045,0,PERF
42479408310000,PI,IP,001,55,13150,13150,7045,0,PERF
42479408310000,PI,IP,001,56,13200,13200,7045,0,PERF
42479408310000,PI,IP,001,57,13250,13250,7045,0,PERF
42479408310000,PI,IP,001,58,13300,13300,7045,0,PERF
42479408310000,PI,IP,001,59,13350,13350,7045,0,PERF
42479408310000,PI,IP,001,60,13400,13400,7045,0,PERF
42479408310000,PI,IP,001,61,13450,13450,7045,0,PERF
42479408310000,PI,IP,001,62,13500,13500,7045,0,PERF
42479408310000,PI,IP,001,63,13550,13550,7045,0,PERF
42479408310000,PI,IP,001,64,13600,13600,7045,0,PERF
42479408310000,PI,IP,001,65,13650,13650,7045,0,PERF
42479408310000,PI,IP,001,66,13700,13700,7045,0,PERF
42479408310000,PI,IP,001,67,13750,13750,7045,0,PERF
42479408310000,PI,IP,001,68,13800,13800,7045,0,PERF
42479408310000,PI,IP,001,69,13850,13850,7045,0,PERF
42479408310000,PI,IP,001,70,13900,13900,7045,0,PERF
42479408310000,PI,IP,001,71,13950,13950,7045,0,PERF
42479408310000,PI,IP,001,72,14000,14000,7045,0,PERF
42479408310000,PI,IP,001,73,14050,14050,7045,0,PERF
42479408310000,PI,IP,001,74,14100,14100,7045,0,PERF
42479408310000,PI,IP,001,75,14150,14150,7045,0,PERF
42479408310000,PI,IP,001,76,14200,14200,7045,0,PERF
42479408310000,PI,IP,001,77,14250,14250,7045,0,PERF
42479408310000,PI,IP,001,78,14300,14300,7045,0,PERF
42479408310000,PI,IP,001,79,14350,14350,7045,0,PERF
42479408310000,PI,IP,001,80,14400,14400,7045,0,PERF
42479408310000,PI,IP,001,81,14450,14450,7045,0,PERF
42479408310000,PI,IP,001,82,14500,14500,7045,0,PERF
42479408310000,PI,IP,001,83,14550,14550,7045,0,PERF
42479408310000,PI,IP,001,84,14600,14600,7045,0,PERF
42479408310000,PI,IP,001,85,14650,14650,7045,0,PERF
42479408310000,PI,IP,001,86,14700,14700,7045,0,PERF
42479408310000,PI,IP,001,87,14750,14750,7045,0,PERF
42479408310000,PI,IP,001,88,14800,14800,7045,0,PERF
42479408310000,PI,IP,001,89,14850,14850,7045,0,PERF
42479408310000,PI,IP,001,90,14900,14900,7045,0,PERF
42479408310000,PI,IP,001,91,14950,14950,7045,0,PERF
42479408310000,PI,IP,001,92,15000,15000,7045,0,PERF
42479408310000,PI,IP,001,93,15050,15050,7045,0,PERF
42479408310000,PI,IP,001,94,15100,15100,7045,0,PERF
42479408310000,PI,IP,001,95,15150,15150,7045,0,PERF
42479408310000,PI,IP,001,96,15200,15200,7045,0,PERF
42479408310000,PI,IP,001,97,15250,15250,7045,0,PERF
42479408310000,PI,IP,001,98,15300,15300,7045,0,PERF
42479408310000,PI,IP,001,99,15350,15350,7045,0,PERF
42479408310000,PI,IP,001,100,15400,15400,7045,0,PERF
42479408310000,PI,IP,001,101,15450,15450,7045,0,PERF
42479408310000,PI,IP,001,102,15500,15500,7045,0,PERF
42479408310000,PI,IP,001,103,15550,15550,7045,0,PERF
42479408310000,PI,IP,001,104,15600,15600,7045,0,PERF
42479408310000,PI,IP,001,105,15650,15650,7045,0,PERF
42479408310000,PI,IP,001,106,15700,15700,7045,0,PERF
42479408310000,PI,IP,001,107,15750,15750,7045,0,PERF
42479408310000,PI,IP,001,108,15800,15800,7045,0,PERF
42479408310000,PI,IP,001,109,15850,15850,7045,0,PERF
42479408310000,PI,IP,001,110,15900,15900,7045,0,PERF
42479408310000,PI,IP,001,111,15950,15950,7045,0,PERF
42479408310000,PI,IP,001,112,16000,16000,7045,0,PERF
42479408310000,PI,IP,001,113,16050,16050,7045,0,PERF
42479408310000,PI,IP,001,114,16100,16100,7045,0,PERF
42479408310000,PI,IP,001,115,16150,16150,7045,0,PERF
42479408310000,PI,IP,001,116,16200,16200,7045,0,PERF
42479408310000,PI,IP,001,117,16250,16250,7045,0,PERF
42479408310000,PI,IP,001,118,16300,16300,7045,0,PERF
42479408310000,PI,IP,001,119,16350,16350,7045,0,PERF
42479408310000,PI,IP,001,120,16390,16390,7045,0,PERF
42479408320000,PI,IP,001,1,10150,10400,6951,250,PERF
42479408320000,PI,IP,001,2,10450,10700,6951,250,PERF
42479408320000,PI,IP,001,3,10750,11000,6951,250,PERF
42479408320000,PI,IP,001,4,11050,11300,6951,250,PERF
42479408320000,PI,IP,001,5,11350,11600,6951,250,PERF
42479408320000,PI,IP,001,6,11650,11900,6951,250,PERF
42479408320000,PI,IP,001,7,11950,12200,6951,250,PERF
42479408320000,PI,IP,001,8,12250,12500,6951,250,PERF
42479408320000,PI,IP,001,9,12550,12800,6951,250,PERF
42479408320000,PI,IP,001,10,12850,13100,6951,250,PERF
42479408320000,PI,IP,001,11,13150,13400,6951,250,PERF
42479408320000,PI,IP,001,12,13450,13700,6951,250,PERF
42479408320000,PI,IP,001,13,13750,14000,6951,250,PERF
42479408320000,PI,IP,001,14,14050,14300,6951,250,PERF
42479408320000,PI,IP,001,15,14350,14600,6951,250,PERF
42479408320000,PI,IP,001,16,14650,14900,6951,250,PERF
42479408320000,PI,IP,001,17,14950,15200,6951,250,PERF
42479408320000,PI,IP,001,18,15250,15500,6951,250,PERF
42479408320000,PI,IP,001,19,15550,15800,6951,250,PERF
42479408320000,PI,IP,001,20,15850,16100,6951,250,PERF
42479408320000,PI,IP,001,21,16150,16375,6951,225,PERF
42479408340000,PI,IP,001,1,7262,12276,5990,5014,PERF
42479408350100,PI,IP,001,1,10558,15525,5630,4967,PERF
42479408380100,PI,IP,001,1,11396,15778,4855,4382,PERF
42479408470000,PI,IP,002,1,8554,13544,7721,4990,PERF
42479408470000,PI,PT,001,1,8554,8715,7721,161,PERF
42479408470000,PI,PT,001,2,8815,8976,7721,161,PERF
42479408470000,PI,PT,001,3,9076,9237,7721,161,PERF
42479408470000,PI,PT,001,4,9337,9498,7721,161,PERF
42479408470000,PI,PT,001,5,9758,9759,7721,1,PERF
42479408470000,PI,PT,001,6,9859,10020,7721,161,PERF
42479408470000,PI,PT,001,7,10120,10281,7721,161,PERF
42479408470000,PI,PT,001,8,10381,10542,7721,161,PERF
42479408470000,PI,PT,001,9,10642,10803,7721,161,PERF
42479408470000,PI,PT,001,10,10924,11130,7721,206,PERF
42479408470000,PI,PT,001,11,11170,11510,7721,340,PERF
42479408470000,PI,PT,001,12,11602,11849,7721,247,PERF
42479408470000,PI,PT,001,13,11941,12188,7721,247,PERF
42479408470000,PI,PT,001,14,12280,12527,7721,247,PERF
42479408470000,PI,PT,001,15,12619,12866,7721,247,PERF
42479408470000,PI,PT,001,16,12958,13205,7721,247,PERF
42479408470000,PI,PT,001,17,13297,13544,7721,247,PERF
42479408470000,PI,PT,001,18,13636,13883,7721,247,PERF
42479408470000,PI,PT,001,19,13975,14222,7721,247,PERF
42479408470000,PI,PT,001,20,14314,14561,7721,247,PERF
42479408470000,PI,PT,001,21,14653,14900,7721,247,PERF
42479408470000,PI,PT,001,22,15127,15344,7721,217,PERF
42479408470000,PI,PT,001,23,15443,15660,7721,217,PERF
42479408580000,PI,IP,001,1,11912,12122,3758,210,PERF
42479408580000,PI,IP,001,2,12210,12422,3758,212,PERF
42479408580000,PI,IP,001,3,12510,12722,3758,212,PERF
42479408580000,PI,IP,001,4,12810,13024,3758,214,PERF
42479408580000,PI,IP,001,5,13110,13322,3758,212,PERF
42479408580000,PI,IP,001,6,13410,13622,3758,212,PERF
42479408580000,PI,IP,001,7,13710,13922,3758,212,PERF
42479408580000,PI,IP,001,8,14005,14222,3758,217,PERF
42479408580000,PI,IP,001,9,14317,14519,3758,202,PERF
42479408580000,PI,IP,001,10,14615,14817,3758,202,PERF
42479408650000,PI,IP,001,1,7549,12535,5998,4986,PERF
42479408660000,PI,IP,001,1,7718,12705,5961,4987,PERF
42479408690000,PI,IP,001,1,9758,15245,6283,5487,PERF
42479408780000,PI,IP,001,1,9675,14970,6482,5295,PERF
42479408810000,PI,IP,001,1,11446,11448,5462,2,PERF
42479408810000,PI,IP,001,2,11521,11523,5462,2,PERF
42479408810000,PI,IP,001,3,11596,11598,5462,2,PERF
42479408810000,PI,IP,001,4,11671,11673,5462,2,PERF
42479408810000,PI,IP,001,5,11778,11780,5462,2,PERF
42479408810000,PI,IP,001,6,11857,11859,5462,2,PERF
42479408810000,PI,IP,001,7,11928,11930,5462,2,PERF
42479408810000,PI,IP,001,8,12003,12005,5462,2,PERF
42479408810000,PI,IP,001,9,12106,12108,5462,2,PERF
42479408810000,PI,IP,001,10,12185,12187,5462,2,PERF
42479408810000,PI,IP,001,11,12260,12262,5462,2,PERF
42479408810000,PI,IP,001,12,12335,12337,5462,2,PERF
42479408810000,PI,IP,001,13,12442,12444,5462,2,PERF
42479408810000,PI,IP,001,14,12517,12519,5462,2,PERF
42479408810000,PI,IP,001,15,12592,12594,5462,2,PERF
42479408810000,PI,IP,001,16,12663,12665,5462,2,PERF
42479408810000,PI,IP,001,17,12774,12776,5462,2,PERF
42479408810000,PI,IP,001,18,12849,12851,5462,2,PERF
42479408810000,PI,IP,001,19,12924,12926,5462,2,PERF
42479408810000,PI,IP,001,20,12999,13001,5462,2,PERF
42479408810000,PI,IP,001,21,13110,13112,5462,2,PERF
42479408810000,PI,IP,001,22,13181,13183,5462,2,PERF
42479408810000,PI,IP,001,23,13256,13258,5462,2,PERF
42479408810000,PI,IP,001,24,13331,13333,5462,2,PERF
42479408810000,PI,IP,001,25,13438,13440,5462,2,PERF
42479408810000,PI,IP,001,26,13513,13515,5462,2,PERF
42479408810000,PI,IP,001,27,13588,13590,5462,2,PERF
42479408810000,PI,IP,001,28,13668,13670,5462,2,PERF
42479408810000,PI,IP,001,29,13770,13772,5462,2,PERF
42479408810000,PI,IP,001,30,13845,13847,5462,2,PERF
42479408810000,PI,IP,001,31,13918,13920,5462,2,PERF
42479408810000,PI,IP,001,32,13995,13997,5462,2,PERF
42479408810000,PI,IP,001,33,14102,14104,5462,2,PERF
42479408810000,PI,IP,001,34,14180,14182,5462,2,PERF
42479408810000,PI,IP,001,35,14252,14254,5462,2,PERF
42479408810000,PI,IP,001,36,14327,14329,5462,2,PERF
42479408810000,PI,IP,001,37,14438,14440,5462,2,PERF
42479408810000,PI,IP,001,38,14509,14511,5462,2,PERF
42479408810000,PI,IP,001,39,14584,14586,5462,2,PERF
42479408810000,PI,IP,001,40,14659,14661,5462,2,PERF
42479408810000,PI,IP,001,41,14766,14768,5462,2,PERF
42479408810000,PI,IP,001,42,14841,14843,5462,2,PERF
42479408810000,PI,IP,001,43,14916,14918,5462,2,PERF
42479408810000,PI,IP,001,44,14995,14997,5462,2,PERF
42479408810000,PI,IP,001,45,15098,15100,5462,2,PERF
42479408810000,PI,IP,001,46,15173,15175,5462,2,PERF
42479408810000,PI,IP,001,47,15248,15250,5462,2,PERF
42479408810000,PI,IP,001,48,15323,15325,5462,2,PERF
42479408810000,PI,IP,001,49,15430,15432,5462,2,PERF
42479408810000,PI,IP,001,50,15500,15502,5462,2,PERF
42479408810000,PI,IP,001,51,15570,15572,5462,2,PERF
42479408810000,PI,IP,001,52,15640,15642,5462,2,PERF
42479408820000,PI,IP,001,1,8339,8340,7899,1,PERF
42479408820000,PI,IP,001,2,8378,8379,7899,1,PERF
42479408820000,PI,IP,001,3,8417,8418,7899,1,PERF
42479408820000,PI,IP,001,4,8456,8457,7899,1,PERF
42479408820000,PI,IP,001,5,8495,8496,7899,1,PERF
42479408820000,PI,IP,001,6,8534,8535,7899,1,PERF
42479408820000,PI,IP,001,7,8573,8574,7899,1,PERF
42479408820000,PI,IP,001,8,8612,8613,7899,1,PERF
42479408820000,PI,IP,001,9,8712,8713,7899,1,PERF
42479408820000,PI,IP,001,10,8751,8752,7899,1,PERF
42479408820000,PI,IP,001,11,8790,8791,7899,1,PERF
42479408820000,PI,IP,001,12,8829,8830,7899,1,PERF
42479408820000,PI,IP,001,13,8868,8869,7899,1,PERF
42479408820000,PI,IP,001,14,8907,8908,7899,1,PERF
42479408820000,PI,IP,001,15,8946,8947,7899,1,PERF
42479408820000,PI,IP,001,16,8985,8986,7899,1,PERF
42479408820000,PI,IP,001,17,9085,9086,7899,1,PERF
42479408820000,PI,IP,001,18,9124,9125,7899,1,PERF
42479408820000,PI,IP,001,19,9163,9164,7899,1,PERF
42479408820000,PI,IP,001,20,9202,9203,7899,1,PERF
42479408820000,PI,IP,001,21,9241,9242,7899,1,PERF
42479408820000,PI,IP,001,22,9280,9281,7899,1,PERF
42479408820000,PI,IP,001,23,9319,9320,7899,1,PERF
42479408820000,PI,IP,001,24,9358,9359,7899,1,PERF
42479408820000,PI,IP,001,25,9458,9459,7899,1,PERF
42479408820000,PI,IP,001,26,9497,9498,7899,1,PERF
42479408820000,PI,IP,001,27,9536,9537,7899,1,PERF
42479408820000,PI,IP,001,28,9575,9576,7899,1,PERF
42479408820000,PI,IP,001,29,9614,9615,7899,1,PERF
42479408820000,PI,IP,001,30,9653,9654,7899,1,PERF
42479408820000,PI,IP,001,31,9692,9693,7899,1,PERF
42479408820000,PI,IP,001,32,9731,9732,7899,1,PERF
42479408820000,PI,IP,001,33,9831,9832,7899,1,PERF
42479408820000,PI,IP,001,34,9870,9871,7899,1,PERF
42479408820000,PI,IP,001,35,9909,9910,7899,1,PERF
42479408820000,PI,IP,001,36,9948,9949,7899,1,PERF
42479408820000,PI,IP,001,37,9987,9988,7899,1,PERF
42479408820000,PI,IP,001,38,10026,10027,7899,1,PERF
42479408820000,PI,IP,001,39,10065,10066,7899,1,PERF
42479408820000,PI,IP,001,40,10104,10105,7899,1,PERF
42479408820000,PI,IP,001,41,10204,10205,7899,1,PERF
42479408820000,PI,IP,001,42,10243,10244,7899,1,PERF
42479408820000,PI,IP,001,43,10282,10283,7899,1,PERF
42479408820000,PI,IP,001,44,10321,10322,7899,1,PERF
42479408820000,PI,IP,001,45,10360,10361,7899,1,PERF
42479408820000,PI,IP,001,46,10399,10400,7899,1,PERF
42479408820000,PI,IP,001,47,10438,10439,7899,1,PERF
42479408820000,PI,IP,001,48,10477,10478,7899,1,PERF
42479408820000,PI,IP,001,49,10577,10578,7899,1,PERF
42479408820000,PI,IP,001,50,10616,10617,7899,1,PERF
42479408820000,PI,IP,001,51,10655,10656,7899,1,PERF
42479408820000,PI,IP,001,52,10694,10695,7899,1,PERF
42479408820000,PI,IP,001,53,10733,10734,7899,1,PERF
42479408820000,PI,IP,001,54,10772,10773,7899,1,PERF
42479408820000,PI,IP,001,55,10811,10812,7899,1,PERF
42479408820000,PI,IP,001,56,10850,10851,7899,1,PERF
42479408820000,PI,IP,001,57,10950,10951,7899,1,PERF
42479408820000,PI,IP,001,58,10989,10990,7899,1,PERF
42479408820000,PI,IP,001,59,11028,11029,7899,1,PERF
42479408820000,PI,IP,001,60,11067,11068,7899,1,PERF
42479408820000,PI,IP,001,61,11106,11107,7899,1,PERF
42479408820000,PI,IP,001,62,11145,11146,7899,1,PERF
42479408820000,PI,IP,001,63,11184,11185,7899,1,PERF
42479408820000,PI,IP,001,64,11223,11224,7899,1,PERF
42479408820000,PI,IP,001,65,11323,11324,7899,1,PERF
42479408820000,PI,IP,001,66,11362,11363,7899,1,PERF
42479408820000,PI,IP,001,67,11401,11402,7899,1,PERF
42479408820000,PI,IP,001,68,11440,11441,7899,1,PERF
42479408820000,PI,IP,001,69,11479,11480,7899,1,PERF
42479408820000,PI,IP,001,70,11518,11519,7899,1,PERF
42479408820000,PI,IP,001,71,11557,11558,7899,1,PERF
42479408820000,PI,IP,001,72,11596,11597,7899,1,PERF
42479408820000,PI,IP,001,73,11696,11697,7899,1,PERF
42479408820000,PI,IP,001,74,11735,11736,7899,1,PERF
42479408820000,PI,IP,001,75,11774,11775,7899,1,PERF
42479408820000,PI,IP,001,76,11813,11814,7899,1,PERF
42479408820000,PI,IP,001,77,11852,11853,7899,1,PERF
42479408820000,PI,IP,001,78,11891,11892,7899,1,PERF
42479408820000,PI,IP,001,79,11930,11931,7899,1,PERF
42479408820000,PI,IP,001,80,11969,11970,7899,1,PERF
42479408820000,PI,IP,001,81,12069,12070,7899,1,PERF
42479408820000,PI,IP,001,82,12108,12109,7899,1,PERF
42479408820000,PI,IP,001,83,12147,12148,7899,1,PERF
42479408820000,PI,IP,001,84,12186,12187,7899,1,PERF
42479408820000,PI,IP,001,85,12225,12226,7899,1,PERF
42479408820000,PI,IP,001,86,12264,12265,7899,1,PERF
42479408820000,PI,IP,001,87,12303,12304,7899,1,PERF
42479408820000,PI,IP,001,88,12342,12343,7899,1,PERF
42479408820000,PI,IP,001,89,12442,12443,7899,1,PERF
42479408820000,PI,IP,001,90,12481,12482,7899,1,PERF
42479408820000,PI,IP,001,91,12520,12521,7899,1,PERF
42479408820000,PI,IP,001,92,12559,12560,7899,1,PERF
42479408820000,PI,IP,001,93,12598,12599,7899,1,PERF
42479408820000,PI,IP,001,94,12637,12638,7899,1,PERF
42479408820000,PI,IP,001,95,12676,12677,7899,1,PERF
42479408820000,PI,IP,001,96,12715,12716,7899,1,PERF
42479408820000,PI,IP,001,97,12815,12816,7899,1,PERF
42479408820000,PI,IP,001,98,12854,12855,7899,1,PERF
42479408820000,PI,IP,001,99,12893,12894,7899,1,PERF
42479408820000,PI,IP,001,100,12932,12933,7899,1,PERF
42479408820000,PI,IP,001,101,12971,12972,7899,1,PERF
42479408820000,PI,IP,001,102,13010,13011,7899,1,PERF
42479408820000,PI,IP,001,103,13049,13050,7899,1,PERF
42479408820000,PI,IP,001,104,13088,13089,7899,1,PERF
42479408820000,PI,IP,001,105,13188,13189,7899,1,PERF
42479408820000,PI,IP,001,106,13227,13228,7899,1,PERF
42479408820000,PI,IP,001,107,13266,13267,7899,1,PERF
42479408820000,PI,IP,001,108,13305,13306,7899,1,PERF
42479408820000,PI,IP,001,109,13344,13345,7899,1,PERF
42479408820000,PI,IP,001,110,13383,13384,7899,1,PERF
42479408820000,PI,IP,001,111,13422,13423,7899,1,PERF
42479408820000,PI,IP,001,112,13461,13462,7899,1,PERF
42479408820000,PI,IP,001,113,13561,13562,7899,1,PERF
42479408820000,PI,IP,001,114,13600,13601,7899,1,PERF
42479408820000,PI,IP,001,115,13639,13640,7899,1,PERF
42479408820000,PI,IP,001,116,13678,13679,7899,1,PERF
42479408820000,PI,IP,001,117,13717,13718,7899,1,PERF
42479408820000,PI,IP,001,118,13756,13757,7899,1,PERF
42479408820000,PI,IP,001,119,13795,13796,7899,1,PERF
42479408820000,PI,IP,001,120,13834,13835,7899,1,PERF
42479408820000,PI,IP,001,121,13934,13935,7899,1,PERF
42479408820000,PI,IP,001,122,13973,13974,7899,1,PERF
42479408820000,PI,IP,001,123,14012,14031,7899,19,PERF
42479408820000,PI,IP,001,124,14051,14052,7899,1,PERF
42479408820000,PI,IP,001,125,14090,14091,7899,1,PERF
42479408820000,PI,IP,001,126,14129,14130,7899,1,PERF
42479408820000,PI,IP,001,127,14168,14169,7899,1,PERF
42479408820000,PI,IP,001,128,14207,14208,7899,1,PERF
42479408820000,PI,IP,001,129,14307,14308,7899,1,PERF
42479408820000,PI,IP,001,130,14346,14347,7899,1,PERF
42479408820000,PI,IP,001,131,14385,14386,7899,1,PERF
42479408820000,PI,IP,001,132,14424,14425,7899,1,PERF
42479408820000,PI,IP,001,133,14463,14464,7899,1,PERF
42479408820000,PI,IP,001,134,14502,14503,7899,1,PERF
42479408820000,PI,IP,001,135,14541,14542,7899,1,PERF
42479408820000,PI,IP,001,136,14580,14581,7899,1,PERF
42479408820000,PI,IP,001,137,14680,14681,7899,1,PERF
42479408820000,PI,IP,001,138,14719,14720,7899,1,PERF
42479408820000,PI,IP,001,139,14758,14759,7899,1,PERF
42479408820000,PI,IP,001,140,14797,14798,7899,1,PERF
42479408820000,PI,IP,001,141,14836,14837,7899,1,PERF
42479408820000,PI,IP,001,142,14875,14876,7899,1,PERF
42479408820000,PI,IP,001,143,14914,14915,7899,1,PERF
42479408820000,PI,IP,001,144,14953,14954,7899,1,PERF
42479408820000,PI,IP,001,145,15000,15001,7899,1,PERF
42479408820000,PI,IP,001,146,15030,15031,7899,1,PERF
42479408820000,PI,IP,001,147,15060,15061,7899,1,PERF
42479408820000,PI,IP,001,148,15090,15091,7899,1,PERF
42479408820000,PI,IP,001,149,15120,15121,7899,1,PERF
42479408820000,PI,IP,001,150,15150,15151,7899,1,PERF
42479408820000,PI,IP,001,151,15180,15181,7899,1,PERF
42479408820000,PI,IP,001,152,15210,15211,7899,1,PERF
42479408820000,PI,IP,001,153,15427,15428,7899,1,PERF
42479408820000,PI,IP,001,154,15464,15465,7899,1,PERF
42479408820000,PI,IP,001,155,15504,15505,7899,1,PERF
42479408820000,PI,IP,001,156,15543,15544,7899,1,PERF
42479408820000,PI,IP,001,157,15583,15584,7899,1,PERF
42479408820000,PI,IP,001,158,15620,15621,7899,1,PERF
42479408820000,PI,IP,001,159,15660,15661,7899,1,PERF
42479408820000,PI,IP,001,160,15669,15700,7899,31,PERF
42479408840100,PI,IP,001,1,11743,16700,5396,4957,PERF
42479408870000,PI,IP,001,1,8340,8646,8260,306,PERF
42479408870000,PI,IP,001,2,8686,8851,8260,165,PERF
42479408870000,PI,IP,001,3,8950,9156,8260,206,PERF
42479408870000,PI,IP,001,4,9255,9461,8260,206,PERF
42479408870000,PI,IP,001,5,9560,9766,8260,206,PERF
42479408870000,PI,IP,001,6,9865,10071,8260,206,PERF
42479408870000,PI,IP,001,7,10170,10376,8260,206,PERF
42479408870000,PI,IP,001,8,10475,10681,8260,206,PERF
42479408870000,PI,IP,001,9,10780,10986,8260,206,PERF
42479408870000,PI,IP,001,10,11085,11291,8260,206,PERF
42479408870000,PI,IP,001,11,11390,11596,8260,206,PERF
42479408870000,PI,IP,001,12,11695,11901,8260,206,PERF
42479408870000,PI,IP,001,13,12000,12206,8260,206,PERF
42479408870000,PI,IP,001,14,12305,12511,8260,206,PERF
42479408870000,PI,IP,001,15,12610,12816,8260,206,PERF
42479408870000,PI,IP,001,16,12915,13121,8260,206,PERF
42479408870000,PI,IP,001,17,13220,13426,8260,206,PERF
42479408890000,PI,IP,001,1,13457,13660,5617,203,PERF
42479408890000,PI,IP,001,2,13741,13944,5617,203,PERF
42479408890000,PI,IP,001,3,14007,14223,5617,216,PERF
42479408890000,PI,IP,001,4,14299,14502,5617,203,PERF
42479408890000,PI,IP,001,5,14581,14781,5617,200,PERF
42479408890000,PI,IP,001,6,14850,15060,5617,210,PERF
42479408890000,PI,IP,001,7,15136,15339,5617,203,PERF
42479408890000,PI,IP,001,8,15415,15618,5617,203,PERF
42479408890000,PI,IP,001,9,15694,15897,5617,203,PERF
42479408890000,PI,IP,001,10,15950,16176,5617,226,PERF
42479408890000,PI,IP,001,11,16252,16455,5617,203,PERF
42479408890000,PI,IP,001,12,16504,16730,5617,226,PERF
42479408890000,PI,IP,001,13,16810,17013,5617,203,PERF
42479408890000,PI,IP,001,14,17089,17292,5617,203,PERF
42479408890000,PI,IP,001,15,17347,17571,5617,224,PERF
42479408890000,PI,IP,001,16,17647,17850,5617,203,PERF
42479408890000,PI,IP,001,17,17926,18129,5617,203,PERF
42479408890000,PI,IP,001,18,18205,18408,5617,203,PERF
42479408910000,PI,IP,001,1,8468,8469,,1,PERF
42479408910000,PI,IP,001,2,8511,8512,,1,PERF
42479408910000,PI,IP,001,3,8554,8555,,1,PERF
42479408910000,PI,IP,001,4,8597,8598,,1,PERF
42479408910000,PI,IP,001,5,8640,8641,,1,PERF
42479408910000,PI,IP,001,6,8683,8684,,1,PERF
42479408910000,PI,IP,001,7,8726,8727,,1,PERF
42479408910000,PI,IP,001,8,8826,8827,,1,PERF
42479408910000,PI,IP,001,9,8869,8870,,1,PERF
42479408910000,PI,IP,001,10,8912,8913,,1,PERF
42479408910000,PI,IP,001,11,8955,8956,,1,PERF
42479408910000,PI,IP,001,12,8998,8999,,1,PERF
42479408910000,PI,IP,001,13,9041,9042,,1,PERF
42479408910000,PI,IP,001,14,9084,9085,,1,PERF
42479408910000,PI,IP,001,15,9184,9185,,1,PERF
42479408910000,PI,IP,001,16,9227,9228,,1,PERF
42479408910000,PI,IP,001,17,9270,9271,,1,PERF
42479408910000,PI,IP,001,18,9313,9314,,1,PERF
42479408910000,PI,IP,001,19,9356,9357,,1,PERF
42479408910000,PI,IP,001,20,9399,9400,,1,PERF
42479408910000,PI,IP,001,21,9442,9443,,1,PERF
42479408910000,PI,IP,001,22,9542,9543,,1,PERF
42479408910000,PI,IP,001,23,9585,9586,,1,PERF
42479408910000,PI,IP,001,24,9628,9629,,1,PERF
42479408910000,PI,IP,001,25,9671,9672,,1,PERF
42479408910000,PI,IP,001,26,9714,9715,,1,PERF
42479408910000,PI,IP,001,27,9757,9758,,1,PERF
42479408910000,PI,IP,001,28,9800,9801,,1,PERF
42479408910000,PI,IP,001,29,9900,9901,,1,PERF
42479408910000,PI,IP,001,30,9943,9944,,1,PERF
42479408910000,PI,IP,001,31,9986,9987,,1,PERF
42479408910000,PI,IP,001,32,10029,10030,,1,PERF
42479408910000,PI,IP,001,33,10072,10073,,1,PERF
42479408910000,PI,IP,001,34,10115,10116,,1,PERF
42479408910000,PI,IP,001,35,10158,10159,,1,PERF
42479408910000,PI,IP,001,36,10258,10259,,1,PERF
42479408910000,PI,IP,001,37,10301,10302,,1,PERF
42479408910000,PI,IP,001,38,10344,10345,,1,PERF
42479408910000,PI,IP,001,39,10387,10388,,1,PERF
42479408910000,PI,IP,001,40,10430,10431,,1,PERF
42479408910000,PI,IP,001,41,10473,10474,,1,PERF
42479408910000,PI,IP,001,42,10516,10517,,1,PERF
42479408910000,PI,IP,001,43,10616,10617,,1,PERF
42479408910000,PI,IP,001,44,10659,10660,,1,PERF
42479408910000,PI,IP,001,45,10702,10703,,1,PERF
42479408910000,PI,IP,001,46,10745,10746,,1,PERF
42479408910000,PI,IP,001,47,10788,10789,,1,PERF
42479408910000,PI,IP,001,48,10831,10832,,1,PERF
42479408910000,PI,IP,001,49,10874,10875,,1,PERF
42479408910000,PI,IP,001,50,10974,10975,,1,PERF
42479408910000,PI,IP,001,51,11017,11018,,1,PERF
42479408910000,PI,IP,001,52,11060,11061,,1,PERF
42479408910000,PI,IP,001,53,11103,11104,,1,PERF
42479408910000,PI,IP,001,54,11146,11147,,1,PERF
42479408910000,PI,IP,001,55,11189,11190,,1,PERF
42479408910000,PI,IP,001,56,11232,11233,,1,PERF
42479408910000,PI,IP,001,57,11332,11333,,1,PERF
42479408910000,PI,IP,001,58,11375,11376,,1,PERF
42479408910000,PI,IP,001,59,11418,11419,,1,PERF
42479408910000,PI,IP,001,60,11461,11462,,1,PERF
42479408910000,PI,IP,001,61,11504,11505,,1,PERF
42479408910000,PI,IP,001,62,11547,11548,,1,PERF
42479408910000,PI,IP,001,63,11590,11591,,1,PERF
42479408910000,PI,IP,001,64,11690,11691,,1,PERF
42479408910000,PI,IP,001,65,11733,11734,,1,PERF
42479408910000,PI,IP,001,66,11776,11777,,1,PERF
42479408910000,PI,IP,001,67,11819,11820,,1,PERF
42479408910000,PI,IP,001,68,11862,11863,,1,PERF
42479408910000,PI,IP,001,69,11905,11906,,1,PERF
42479408910000,PI,IP,001,70,11948,11949,,1,PERF
42479408910000,PI,IP,001,71,12048,12049,,1,PERF
42479408910000,PI,IP,001,72,12091,12092,,1,PERF
42479408910000,PI,IP,001,73,12134,12135,,1,PERF
42479408910000,PI,IP,001,74,12177,12178,,1,PERF
42479408910000,PI,IP,001,75,12220,12221,,1,PERF
42479408910000,PI,IP,001,76,12263,12264,,1,PERF
42479408910000,PI,IP,001,77,12306,12307,,1,PERF
42479408910000,PI,IP,001,78,12383,12384,,1,PERF
42479408910000,PI,IP,001,79,12426,12427,,1,PERF
42479408910000,PI,IP,001,80,12469,12470,,1,PERF
42479408910000,PI,IP,001,81,12512,12513,,1,PERF
42479408910000,PI,IP,001,82,12555,12556,,1,PERF
42479408910000,PI,IP,001,83,12598,12599,,1,PERF
42479408910000,PI,IP,001,84,12641,12642,,1,PERF
42479408930100,PI,IP,001,1,8553,8554,5597,1,PERF
42479408930100,PI,IP,001,2,8630,8631,5597,1,PERF
42479408930100,PI,IP,001,3,8707,8708,5597,1,PERF
42479408930100,PI,IP,001,4,8784,8785,5597,1,PERF
42479408930100,PI,IP,001,5,8863,8864,5597,1,PERF
42479408930100,PI,IP,001,6,8940,8941,5597,1,PERF
42479408930100,PI,IP,001,7,9017,9018,5597,1,PERF
42479408930100,PI,IP,001,8,9094,9095,5597,1,PERF
42479408930100,PI,IP,001,9,9172,9173,5597,1,PERF
42479408930100,PI,IP,001,10,9249,9250,5597,1,PERF
42479408930100,PI,IP,001,11,9326,9327,5597,1,PERF
42479408930100,PI,IP,001,12,9403,9404,5597,1,PERF
42479408930100,PI,IP,001,13,9482,9483,5597,1,PERF
42479408930100,PI,IP,001,14,9559,9560,5597,1,PERF
42479408930100,PI,IP,001,15,9636,9637,5597,1,PERF
42479408930100,PI,IP,001,16,9713,9714,5597,1,PERF
42479408930100,PI,IP,001,17,9791,9792,5597,1,PERF
42479408930100,PI,IP,001,18,9868,9869,5597,1,PERF
42479408930100,PI,IP,001,19,9945,9946,5597,1,PERF
42479408930100,PI,IP,001,20,10022,10023,5597,1,PERF
42479408930100,PI,IP,001,21,10101,10102,5597,1,PERF
42479408930100,PI,IP,001,22,10178,10179,5597,1,PERF
42479408930100,PI,IP,001,23,10255,10256,5597,1,PERF
42479408930100,PI,IP,001,24,10332,10333,5597,1,PERF
42479408930100,PI,IP,001,25,10410,10411,5597,1,PERF
42479408930100,PI,IP,001,26,10487,10488,5597,1,PERF
42479408930100,PI,IP,001,27,10564,10565,5597,1,PERF
42479408930100,PI,IP,001,28,10641,10642,5597,1,PERF
42479408930100,PI,IP,001,29,10720,10721,5597,1,PERF
42479408930100,PI,IP,001,30,10797,10798,5597,1,PERF
42479408930100,PI,IP,001,31,10874,10875,5597,1,PERF
42479408930100,PI,IP,001,32,10951,10952,5597,1,PERF
42479408930100,PI,IP,001,33,11029,11030,5597,1,PERF
42479408930100,PI,IP,001,34,11106,11107,5597,1,PERF
42479408930100,PI,IP,001,35,11183,11184,5597,1,PERF
42479408930100,PI,IP,001,36,11260,11261,5597,1,PERF
42479408930100,PI,IP,001,37,11339,11340,5597,1,PERF
42479408930100,PI,IP,001,38,11416,11417,5597,1,PERF
42479408930100,PI,IP,001,39,11493,11494,5597,1,PERF
42479408930100,PI,IP,001,40,11570,11571,5597,1,PERF
42479408930100,PI,IP,001,41,11648,11649,5597,1,PERF
42479408930100,PI,IP,001,42,11725,11726,5597,1,PERF
42479408930100,PI,IP,001,43,11802,11803,5597,1,PERF
42479408930100,PI,IP,001,44,11879,11880,5597,1,PERF
42479408930100,PI,IP,001,45,11958,11959,5597,1,PERF
42479408930100,PI,IP,001,46,12035,12036,5597,1,PERF
42479408930100,PI,IP,001,47,12112,12113,5597,1,PERF
42479408930100,PI,IP,001,48,12189,12190,5597,1,PERF
42479408930100,PI,IP,001,49,12267,12268,5597,1,PERF
42479408930100,PI,IP,001,50,12344,12345,5597,1,PERF
42479408930100,PI,IP,001,51,12421,12422,5597,1,PERF
42479408930100,PI,IP,001,52,12498,12499,5597,1,PERF
42479408930100,PI,IP,001,53,12576,12577,5597,1,PERF
42479408930100,PI,IP,001,54,12653,12654,5597,1,PERF
42479408930100,PI,IP,001,55,12730,12731,5597,1,PERF
42479408930100,PI,IP,001,56,12801,12808,5597,7,PERF
42479408990000,PI,IP,001,1,7075,12165,5898,5090,PERF
42479409020100,PI,IP,001,1,8600,8601,5036,1,PERF
42479409020100,PI,IP,001,2,8646,8647,5036,1,PERF
42479409020100,PI,IP,001,3,8692,8693,5036,1,PERF
42479409020100,PI,IP,001,4,8738,8739,5036,1,PERF
42479409020100,PI,IP,001,5,8784,8785,5036,1,PERF
42479409020100,PI,IP,001,6,8910,8911,5036,1,PERF
42479409020100,PI,IP,001,7,8956,8957,5036,1,PERF
42479409020100,PI,IP,001,8,9002,9003,5036,1,PERF
42479409020100,PI,IP,001,9,9048,9049,5036,1,PERF
42479409020100,PI,IP,001,10,9094,9095,5036,1,PERF
42479409020100,PI,IP,001,11,9219,9220,5036,1,PERF
42479409020100,PI,IP,001,12,9265,9266,5036,1,PERF
42479409020100,PI,IP,001,13,9311,9312,5036,1,PERF
42479409020100,PI,IP,001,14,9357,9358,5036,1,PERF
42479409020100,PI,IP,001,15,9403,9404,5036,1,PERF
42479409020100,PI,IP,001,16,9529,9530,5036,1,PERF
42479409020100,PI,IP,001,17,9575,9576,5036,1,PERF
42479409020100,PI,IP,001,18,9621,9622,5036,1,PERF
42479409020100,PI,IP,001,19,9667,9668,5036,1,PERF
42479409020100,PI,IP,001,20,9713,9714,5036,1,PERF
42479409020100,PI,IP,001,21,9838,9839,5036,1,PERF
42479409020100,PI,IP,001,22,9884,9885,5036,1,PERF
42479409020100,PI,IP,001,23,9930,9931,5036,1,PERF
42479409020100,PI,IP,001,24,9976,9977,5036,1,PERF
42479409020100,PI,IP,001,25,10022,10023,5036,1,PERF
42479409020100,PI,IP,001,26,10148,10149,5036,1,PERF
42479409020100,PI,IP,001,27,10194,10195,5036,1,PERF
42479409020100,PI,IP,001,28,10240,10241,5036,1,PERF
42479409020100,PI,IP,001,29,10286,10287,5036,1,PERF
42479409020100,PI,IP,001,30,10332,10333,5036,1,PERF
42479409020100,PI,IP,001,31,10457,10458,5036,1,PERF
42479409020100,PI,IP,001,32,10503,10504,5036,1,PERF
42479409020100,PI,IP,001,33,10549,10550,5036,1,PERF
42479409020100,PI,IP,001,34,10595,10596,5036,1,PERF
42479409020100,PI,IP,001,35,10641,10642,5036,1,PERF
42479409020100,PI,IP,001,36,10767,10768,5036,1,PERF
42479409020100,PI,IP,001,37,10813,10814,5036,1,PERF
42479409020100,PI,IP,001,38,10859,10860,5036,1,PERF
42479409020100,PI,IP,001,39,10905,10906,5036,1,PERF
42479409020100,PI,IP,001,40,10951,10952,5036,1,PERF
42479409020100,PI,IP,001,41,11076,11077,5036,1,PERF
42479409020100,PI,IP,001,42,11122,11123,5036,1,PERF
42479409020100,PI,IP,001,43,11168,11169,5036,1,PERF
42479409020100,PI,IP,001,44,11214,11215,5036,1,PERF
42479409020100,PI,IP,001,45,11260,11261,5036,1,PERF
42479409020100,PI,IP,001,46,11386,11387,5036,1,PERF
42479409020100,PI,IP,001,47,11432,11433,5036,1,PERF
42479409020100,PI,IP,001,48,11478,11479,5036,1,PERF
42479409020100,PI,IP,001,49,11524,11525,5036,1,PERF
42479409020100,PI,IP,001,50,11570,11571,5036,1,PERF
42479409020100,PI,IP,001,51,11695,11696,5036,1,PERF
42479409020100,PI,IP,001,52,11741,11742,5036,1,PERF
42479409020100,PI,IP,001,53,11787,11788,5036,1,PERF
42479409020100,PI,IP,001,54,11833,11834,5036,1,PERF
42479409020100,PI,IP,001,55,11879,11880,5036,1,PERF
42479409020100,PI,IP,001,56,12005,12006,5036,1,PERF
42479409020100,PI,IP,001,57,12051,12052,5036,1,PERF
42479409020100,PI,IP,001,58,12097,12098,5036,1,PERF
42479409020100,PI,IP,001,59,12143,12144,5036,1,PERF
42479409020100,PI,IP,001,60,12189,12190,5036,1,PERF
42479409020100,PI,IP,001,61,12360,12361,5036,1,PERF
42479409020100,PI,IP,001,62,12406,12407,5036,1,PERF
42479409020100,PI,IP,001,63,12452,12453,5036,1,PERF
42479409020100,PI,IP,001,64,12484,12485,5036,1,PERF
42479409020100,PI,IP,001,65,12542,12543,5036,1,PERF
42479409020100,PI,IP,001,66,12629,12630,5036,1,PERF
42479409020100,PI,IP,001,67,12669,12670,5036,1,PERF
42479409020100,PI,IP,001,68,12715,12716,5036,1,PERF
42479409020100,PI,IP,001,69,12761,12762,5036,1,PERF
42479409020100,PI,IP,001,70,12807,12808,5036,1,PERF
42479409180000,PI,IP,001,1,8571,8806,5094,235,PERF
42479409180000,PI,IP,001,2,8905,9140,5094,235,PERF
42479409180000,PI,IP,001,3,9239,9474,5094,235,PERF
42479409180000,PI,IP,001,4,9573,9808,5094,235,PERF
42479409180000,PI,IP,001,5,9907,10142,5094,235,PERF
42479409180000,PI,IP,001,6,10241,10476,5094,235,PERF
42479409180000,PI,IP,001,7,10575,10810,5094,235,PERF
42479409180000,PI,IP,001,8,10909,11144,5094,235,PERF
42479409180000,PI,IP,001,9,11243,11478,5094,235,PERF
42479409180000,PI,IP,001,10,11577,11812,5094,235,PERF
42479409180000,PI,IP,001,11,11911,12146,5094,235,PERF
42479409180000,PI,IP,001,12,12245,12480,5094,235,PERF
42479409180000,PI,IP,001,13,12579,12814,5094,235,PERF
42479409230100,PI,IP,001,1,10516,13753,4765,3237,PERF
42479409240000,PI,IP,001,1,7349,12853,6402,5504,PERF
42479409250000,PI,IP,001,1,9773,13593,4987,3820,PERF
42479409290000,PI,IP,001,1,7504,12832,6127,5328,PERF
42479409320000,PI,IP,001,1,11060,11312,5113,252,PERF
42479409320000,PI,IP,001,2,11400,11650,5113,250,PERF
42479409320000,PI,IP,001,3,11736,11972,5113,236,PERF
42479409320000,PI,IP,001,4,12060,12302,5113,242,PERF
42479409320000,PI,IP,001,5,12390,12632,5113,242,PERF
42479409320000,PI,IP,001,6,12720,12962,5113,242,PERF
42479409320000,PI,IP,001,7,13050,13290,5113,240,PERF
42479409320000,PI,IP,001,8,13376,13622,5113,246,PERF
42479409320000,PI,IP,001,9,13710,13952,5113,242,PERF
42479409320000,PI,IP,001,10,14040,14262,5113,222,PERF
42479409320000,PI,IP,001,11,14358,14612,5113,254,PERF
42479409320000,PI,IP,001,12,14700,14942,5113,242,PERF
42479409320000,PI,IP,001,13,15030,15260,5113,230,PERF
42479409360000,PI,IP,001,1,8557,8845,5552,288,PERF
42479409360000,PI,IP,001,2,8944,9232,5552,288,PERF
42479409360000,PI,IP,001,3,9331,9619,5552,288,PERF
42479409360000,PI,IP,001,4,9718,10006,5552,288,PERF
42479409360000,PI,IP,001,5,10105,10393,5552,288,PERF
42479409360000,PI,IP,001,6,10492,10780,5552,288,PERF
42479409360000,PI,IP,001,7,10879,11167,5552,288,PERF
42479409360000,PI,IP,001,8,11266,11554,5552,288,PERF
42479409360000,PI,IP,001,9,11653,11941,5552,288,PERF
42479409360000,PI,IP,001,10,12040,12328,5552,288,PERF
42479409360000,PI,IP,001,11,12427,12715,5552,288,PERF
42479409370000,PI,IP,001,1,8461,8849,,388,PERF
42479409370000,PI,IP,001,2,8948,9336,,388,PERF
42479409370000,PI,IP,001,3,9435,9823,,388,PERF
42479409370000,PI,IP,001,4,9922,10310,,388,PERF
42479409370000,PI,IP,001,5,10409,10797,,388,PERF
42479409370000,PI,IP,001,6,10896,11284,,388,PERF
42479409370000,PI,IP,001,7,11383,11771,,388,PERF
42479409370000,PI,IP,001,8,11870,12258,,388,PERF
42479409370000,PI,PT,001,1,12357,12745,,388,PERF
42479409380000,PI,IP,001,1,10400,15869,5565,5469,PERF
42479409390000,PI,IP,001,1,7220,11692,5366,4472,PERF
42479409400000,PI,IP,001,1,9660,13693,5087,4033,PERF
42479409410000,PI,IP,001,1,9220,13843,6021,4623,PERF
42479409510000,PI,IP,001,1,9259,9261,6016,2,PERF
42479409510000,PI,IP,001,2,9329,9331,6016,2,PERF
42479409510000,PI,IP,001,3,9405,9407,6016,2,PERF
42479409510000,PI,IP,001,4,9469,9471,6016,2,PERF
42479409510000,PI,IP,001,5,9586,9588,6016,2,PERF
42479409510000,PI,IP,001,6,9656,9658,6016,2,PERF
42479409510000,PI,IP,001,7,9726,9728,6016,2,PERF
42479409510000,PI,IP,001,8,9796,9798,6016,2,PERF
42479409510000,PI,IP,001,9,9916,9918,6016,2,PERF
42479409510000,PI,IP,001,10,9983,9985,6016,2,PERF
42479409510000,PI,IP,001,11,10053,10055,6016,2,PERF
42479409510000,PI,IP,001,12,10120,10122,6016,2,PERF
42479409510000,PI,IP,001,13,10240,10242,6016,2,PERF
42479409510000,PI,IP,001,14,10310,10312,6016,2,PERF
42479409510000,PI,IP,001,15,10376,10378,6016,2,PERF
42479409510000,PI,IP,001,16,10450,10452,6016,2,PERF
42479409510000,PI,IP,001,17,10567,10569,6016,2,PERF
42479409510000,PI,IP,001,18,10634,10636,6016,2,PERF
42479409510000,PI,IP,001,19,10707,10709,6016,2,PERF
42479409510000,PI,IP,001,20,10777,10779,6016,2,PERF
42479409510000,PI,IP,001,21,10894,10896,6016,2,PERF
42479409510000,PI,IP,001,22,10964,10966,6016,2,PERF
42479409510000,PI,IP,001,23,11026,11028,6016,2,PERF
42479409510000,PI,IP,001,24,11104,11106,6016,2,PERF
42479409510000,PI,IP,001,25,11221,11223,6016,2,PERF
42479409510000,PI,IP,001,26,11288,11290,6016,2,PERF
42479409510000,PI,IP,001,27,11361,11363,6016,2,PERF
42479409510000,PI,IP,001,28,11413,11415,6016,2,PERF
42479409510000,PI,IP,001,29,11548,11550,6016,2,PERF
42479409510000,PI,IP,001,30,11618,11620,6016,2,PERF
42479409510000,PI,IP,001,31,11690,11692,6016,2,PERF
42479409510000,PI,IP,001,32,11758,11760,6016,2,PERF
42479409510000,PI,IP,001,33,11875,11877,6016,2,PERF
42479409510000,PI,IP,001,34,11950,11952,6016,2,PERF
42479409510000,PI,IP,001,35,12015,12017,6016,2,PERF
42479409510000,PI,IP,001,36,12085,12087,6016,2,PERF
42479409510000,PI,IP,001,37,12208,12208,6016,0,PERF
42479409510000,PI,IP,001,38,12272,12274,6016,2,PERF
42479409510000,PI,IP,001,39,12342,12344,6016,2,PERF
42479409510000,PI,IP,001,40,12412,12414,6016,2,PERF
42479409510000,PI,IP,001,41,12529,12531,6016,2,PERF
42479409510000,PI,IP,001,42,12599,12601,6016,2,PERF
42479409510000,PI,IP,001,43,12669,12671,6016,2,PERF
42479409510000,PI,IP,001,44,12739,12741,6016,2,PERF
42479409510000,PI,IP,001,45,12856,12858,6016,2,PERF
42479409510000,PI,IP,001,46,12926,12928,6016,2,PERF
42479409510000,PI,IP,001,47,12996,12998,6016,2,PERF
42479409510000,PI,IP,001,48,13068,13070,6016,2,PERF
42479409510000,PI,IP,001,49,13183,13185,6016,2,PERF
42479409510000,PI,IP,001,50,13253,13255,6016,2,PERF
42479409510000,PI,IP,001,51,13324,13326,6016,2,PERF
42479409510000,PI,IP,001,52,13393,13395,6016,2,PERF
42479409510000,PI,IP,001,53,13510,13512,6016,2,PERF
42479409510000,PI,IP,001,54,13576,13578,6016,2,PERF
42479409510000,PI,IP,001,55,13650,13652,6016,2,PERF
42479409510000,PI,IP,001,56,13720,13722,6016,2,PERF
42479409510000,PI,IP,001,57,13837,13839,6016,2,PERF
42479409510000,PI,IP,001,58,13894,13896,6016,2,PERF
42479409510000,PI,IP,001,59,13951,13953,6016,2,PERF
42479409510000,PI,IP,001,60,14008,14010,6016,2,PERF
42479409520000,PI,IP,001,1,8517,13415,5155,4898,PERF
42479409530000,PI,IP,001,1,7399,12734,6310,5335,PERF
42479409540000,PI,IP,001,1,9066,9068,6021,2,PERF
42479409540000,PI,IP,001,2,9141,9143,6021,2,PERF
42479409540000,PI,IP,001,3,9216,9218,6021,2,PERF
42479409540000,PI,IP,001,4,9293,9295,6021,2,PERF
42479409540000,PI,IP,001,5,9408,9410,6021,2,PERF
42479409540000,PI,IP,001,6,9483,9485,6021,2,PERF
42479409540000,PI,IP,001,7,9558,9560,6021,2,PERF
42479409540000,PI,IP,001,8,9633,9635,6021,2,PERF
42479409540000,PI,IP,001,9,9756,9758,6021,2,PERF
42479409540000,PI,IP,001,10,9825,9827,6021,2,PERF
42479409540000,PI,IP,001,11,9900,9902,6021,2,PERF
42479409540000,PI,IP,001,12,9957,9959,6021,2,PERF
42479409540000,PI,IP,001,13,10090,10092,6021,2,PERF
42479409540000,PI,IP,001,14,10167,10169,6021,2,PERF
42479409540000,PI,IP,001,15,10242,10244,6021,2,PERF
42479409540000,PI,IP,001,16,10317,10319,6021,2,PERF
42479409540000,PI,IP,001,17,10430,10432,6021,2,PERF
42479409540000,PI,IP,001,18,10509,10511,6021,2,PERF
42479409540000,PI,IP,001,19,10584,10586,6021,2,PERF
42479409540000,PI,IP,001,20,10659,10661,6021,2,PERF
42479409540000,PI,IP,001,21,10772,10774,6021,2,PERF
42479409540000,PI,IP,001,22,10851,10853,6021,2,PERF
42479409540000,PI,IP,001,23,10926,10928,6021,2,PERF
42479409540000,PI,IP,001,24,11001,11003,6021,2,PERF
42479409540000,PI,IP,001,25,11116,11118,6021,2,PERF
42479409540000,PI,IP,001,26,11193,11195,6021,2,PERF
42479409540000,PI,IP,001,27,11268,11270,6021,2,PERF
42479409540000,PI,IP,001,28,11343,11345,6021,2,PERF
42479409540000,PI,IP,001,29,11466,11468,6021,2,PERF
42479409540000,PI,IP,001,30,11535,11537,6021,2,PERF
42479409540000,PI,IP,001,31,11610,11612,6021,2,PERF
42479409540000,PI,IP,001,32,11685,11687,6021,2,PERF
42479409540000,PI,IP,001,33,11808,11810,6021,2,PERF
42479409540000,PI,IP,001,34,11877,11879,6021,2,PERF
42479409540000,PI,IP,001,35,11952,11954,6021,2,PERF
42479409540000,PI,IP,001,36,12027,12029,6021,2,PERF
42479409540000,PI,IP,001,37,12150,12152,6021,2,PERF
42479409540000,PI,IP,001,38,12219,12221,6021,2,PERF
42479409540000,PI,IP,001,39,12294,12296,6021,2,PERF
42479409540000,PI,IP,001,40,12369,12371,6021,2,PERF
42479409540000,PI,IP,001,41,12480,12482,6021,2,PERF
42479409540000,PI,IP,001,42,12561,12563,6021,2,PERF
42479409540000,PI,IP,001,43,12636,12638,6021,2,PERF
42479409540000,PI,IP,001,44,12711,12713,6021,2,PERF
42479409540000,PI,IP,001,45,12828,12830,6021,2,PERF
42479409540000,PI,IP,001,46,12903,12905,6021,2,PERF
42479409540000,PI,IP,001,47,12978,12980,6021,2,PERF
42479409540000,PI,IP,001,48,13053,13055,6021,2,PERF
42479409540000,PI,IP,001,49,13166,13168,6021,2,PERF
42479409540000,PI,IP,001,50,13245,13247,6021,2,PERF
42479409540000,PI,IP,001,51,13320,13322,6021,2,PERF
42479409540000,PI,IP,001,52,13395,13397,6021,2,PERF
42479409540000,PI,IP,001,53,13512,13514,6021,2,PERF
42479409540000,PI,IP,001,54,13587,13589,6021,2,PERF
42479409540000,PI,IP,001,55,13662,13664,6021,2,PERF
42479409540000,PI,IP,001,56,13737,13739,6021,2,PERF
42479409540000,PI,IP,001,57,13854,13856,6021,2,PERF
42479409540000,PI,IP,001,58,13933,13935,6021,2,PERF
42479409540000,PI,IP,001,59,14013,14015,6021,2,PERF
42479409540000,PI,IP,001,60,14092,14094,6021,2,PERF
42479409550000,PI,IP,001,1,10100,14900,5580,4800,PERF
42479409560000,PI,IP,001,1,7418,12723,6307,5305,PERF
42479409570000,PI,IP,001,1,7396,13052,6422,5656,PERF
42479409580000,PI,IP,001,1,10374,13583,4206,3209,PERF
42479409590000,PI,IP,001,1,9230,13403,4765,4173,PERF
42479409600000,PI,IP,001,1,11160,15528,5521,4368,PERF
42479409630000,PI,IP,001,1,7420,12419,5950,4999,PERF
42479409660000,PI,IP,001,1,9925,13810,4393,3885,PERF
42479409710000,PI,IP,001,1,9552,14400,6336,4848,PERF
42479409770000,PI,IP,001,1,8451,15578,7346,7127,PERF
42479409780000,PI,IP,001,1,8429,13483,6855,5054,PERF
42479409780000,PI,PT,003,1,13257,13259,6855,2,PERF
42479409780000,PI,PT,003,2,13289,13291,6855,2,PERF
42479409780000,PI,PT,003,3,13321,13323,6855,2,PERF
42479409780000,PI,PT,003,4,13353,13355,6855,2,PERF
42479409780000,PI,PT,003,5,13385,13387,6855,2,PERF
42479409780000,PI,PT,003,6,13417,13419,6855,2,PERF
42479409780000,PI,PT,003,7,13449,13451,6855,2,PERF
42479409780000,PI,PT,003,8,13481,13483,6855,2,PERF
42479409780000,PI,PT,003,9,13513,13515,6855,2,PERF
42479409780000,PI,PT,003,10,13539,13542,6855,3,PERF
42479409790000,PI,IP,001,1,8342,8623,,281,PERF
42479409790000,PI,IP,001,2,8746,9027,,281,PERF
42479409790000,PI,IP,001,3,9150,9431,,281,PERF
42479409790000,PI,IP,001,4,9554,9835,,281,PERF
42479409790000,PI,IP,001,5,9958,10239,,281,PERF
42479409790000,PI,IP,001,6,10362,10643,,281,PERF
42479409790000,PI,IP,001,7,10766,11047,,281,PERF
42479409790000,PI,IP,001,8,11170,11451,,281,PERF
42479409790000,PI,IP,001,9,11574,11855,,281,PERF
42479409790000,PI,IP,001,10,11978,12259,,281,PERF
42479409790000,PI,IP,001,11,12382,12663,,281,PERF
42479409790000,PI,IP,001,12,12786,13067,,281,PERF
42479409790000,PI,IP,001,13,13190,13471,,281,PERF
42479409790000,PI,IP,001,14,13594,13875,,281,PERF
42479409790000,PI,IP,001,15,13998,14279,,281,PERF
42479409790000,PI,IP,001,16,14402,14683,,281,PERF
42479409790000,PI,IP,001,17,14806,15087,,281,PERF
42479409790000,PI,IP,001,18,15210,15491,,281,PERF
42479409790000,PI,IP,001,19,15703,15895,,192,PERF
42479409800000,PI,IP,001,1,8356,8777,7933,421,PERF
42479409800000,PI,IP,001,2,8897,9318,7933,421,PERF
42479409800000,PI,IP,001,3,9438,9859,7933,421,PERF
42479409800000,PI,IP,001,4,9979,10400,7933,421,PERF
42479409800000,PI,IP,001,5,10520,10941,7933,421,PERF
42479409800000,PI,IP,001,6,11061,11482,7933,421,PERF
42479409800000,PI,IP,001,7,11602,12023,7933,421,PERF
42479409800000,PI,IP,001,8,12143,12564,7933,421,PERF
42479409800000,PI,IP,001,9,12684,13105,7933,421,PERF
42479409800000,PI,IP,001,10,13225,13646,7933,421,PERF
42479409800000,PI,IP,001,11,13766,14187,7933,421,PERF
42479409800000,PI,IP,001,12,14307,14728,7933,421,PERF
42479409800000,PI,IP,001,13,14848,15269,7933,421,PERF
42479409800000,PI,IP,001,14,15389,15810,7933,421,PERF
42479409800000,PI,IP,001,15,15850,15868,7933,18,PERF
42479409820000,PI,IP,001,1,11930,12024,,94,PERF
42479409830000,PI,IP,001,1,9795,13987,5384,4192,PERF
42479409870100,PI,IP,001,1,8833,8835,,2,PERF
42479409870100,PI,IP,001,2,8915,8917,,2,PERF
42479409870100,PI,IP,001,3,8997,8999,,2,PERF
42479409870100,PI,IP,001,4,9079,9081,,2,PERF
42479409870100,PI,IP,001,5,9166,9168,,2,PERF
42479409870100,PI,IP,001,6,9248,9250,,2,PERF
42479409870100,PI,IP,001,7,9330,9332,,2,PERF
42479409870100,PI,IP,001,8,9414,9416,,2,PERF
42479409870100,PI,IP,001,9,9499,9501,,2,PERF
42479409870100,PI,IP,001,10,9584,9586,,2,PERF
42479409870100,PI,IP,001,11,9658,9660,,2,PERF
42479409870100,PI,IP,001,12,9745,9747,,2,PERF
42479409870100,PI,IP,001,13,9832,9834,,2,PERF
42479409870100,PI,IP,001,14,9914,9916,,2,PERF
42479409870100,PI,IP,001,15,9996,9998,,2,PERF
42479409870100,PI,IP,001,16,10078,10080,,2,PERF
42479409870100,PI,IP,001,17,10165,10167,,2,PERF
42479409870100,PI,IP,001,18,10247,10249,,2,PERF
42479409870100,PI,IP,001,19,10329,10331,,2,PERF
42479409870100,PI,IP,001,20,10411,10412,,1,PERF
42479409870100,PI,IP,001,21,10498,10500,,2,PERF
42479409870100,PI,IP,001,22,10580,10582,,2,PERF
42479409870100,PI,IP,001,23,10662,10664,,2,PERF
42479409870100,PI,IP,001,24,10744,10746,,2,PERF
42479409870100,PI,IP,001,25,10831,10833,,2,PERF
42479409870100,PI,IP,001,26,10913,10915,,2,PERF
42479409870100,PI,IP,001,27,10995,10997,,2,PERF
42479409870100,PI,IP,001,28,11077,11079,,2,PERF
42479409870100,PI,IP,001,29,11164,11166,,2,PERF
42479409870100,PI,IP,001,30,11246,11248,,2,PERF
42479409870100,PI,IP,001,31,11328,11330,,2,PERF
42479409870100,PI,IP,001,32,11410,11412,,2,PERF
42479409870100,PI,IP,001,33,11497,11499,,2,PERF
42479409870100,PI,IP,001,34,11579,11581,,2,PERF
42479409870100,PI,IP,001,35,11661,11663,,2,PERF
42479409870100,PI,IP,001,36,11743,11745,,2,PERF
42479409870100,PI,IP,001,37,11830,11832,,2,PERF
42479409870100,PI,IP,001,38,11912,11914,,2,PERF
42479409870100,PI,IP,001,39,11994,11996,,2,PERF
42479409870100,PI,IP,001,40,12082,12084,,2,PERF
42479409870100,PI,IP,001,41,12170,12172,,2,PERF
42479409870100,PI,IP,001,42,12242,12244,,2,PERF
42479409870100,PI,IP,001,43,12327,12329,,2,PERF
42479409870100,PI,IP,001,44,12409,12411,,2,PERF
42479409870100,PI,IP,001,45,12496,12498,,2,PERF
42479409870100,PI,IP,001,46,12578,12580,,2,PERF
42479409870100,PI,IP,001,47,12660,12662,,2,PERF
42479409870100,PI,IP,001,48,12742,12744,,2,PERF
42479409870100,PI,IP,001,49,12829,12831,,2,PERF
42479409870100,PI,IP,001,50,12911,12913,,2,PERF
42479409870100,PI,IP,001,51,12993,12995,,2,PERF
42479409870100,PI,IP,001,52,13075,13077,,2,PERF
42479409870100,PI,IP,001,53,13162,13164,,2,PERF
42479409870100,PI,IP,001,54,13244,13446,,202,PERF
42479409870100,PI,IP,001,55,13326,13328,,2,PERF
42479409870100,PI,IP,001,56,13408,13410,,2,PERF
42479409870100,PI,IP,001,57,13494,13496,,2,PERF
42479409870100,PI,IP,001,58,13537,13539,,2,PERF
42479409870100,PI,IP,001,59,13638,13640,,2,PERF
42479409870100,PI,IP,001,60,13710,13712,,2,PERF
42479409890000,PI,IP,001,1,9718,14251,4952,4533,PERF
42479409900000,PI,IP,001,1,10000,10000,3885,0,PERF
42479409900000,PI,IP,001,2,10050,10050,3885,0,PERF
42479409900000,PI,IP,001,3,10100,10100,3885,0,PERF
42479409900000,PI,IP,001,4,10150,10150,3885,0,PERF
42479409900000,PI,IP,001,5,10200,10200,3885,0,PERF
42479409900000,PI,IP,001,6,10250,10250,3885,0,PERF
42479409900000,PI,IP,001,7,10300,10300,3885,0,PERF
42479409900000,PI,IP,001,8,10350,10350,3885,0,PERF
42479409900000,PI,IP,001,9,10400,10400,3885,0,PERF
42479409900000,PI,IP,001,10,10450,10450,3885,0,PERF
42479409900000,PI,IP,001,11,10500,10500,3885,0,PERF
42479409900000,PI,IP,001,12,10550,10550,3885,0,PERF
42479409900000,PI,IP,001,13,10600,10600,3885,0,PERF
42479409900000,PI,IP,001,14,10650,10650,3885,0,PERF
42479409900000,PI,IP,001,15,10700,10700,3885,0,PERF
42479409900000,PI,IP,001,16,10750,10750,3885,0,PERF
42479409900000,PI,IP,001,17,10800,10800,3885,0,PERF
42479409900000,PI,IP,001,18,10850,10850,3885,0,PERF
42479409900000,PI,IP,001,19,10900,10900,3885,0,PERF
42479409900000,PI,IP,001,20,10950,10950,3885,0,PERF
42479409900000,PI,IP,001,21,11000,11000,3885,0,PERF
42479409900000,PI,IP,001,22,11050,11050,3885,0,PERF
42479409900000,PI,IP,001,23,11100,11100,3885,0,PERF
42479409900000,PI,IP,001,24,11150,11150,3885,0,PERF
42479409900000,PI,IP,001,25,11200,11200,3885,0,PERF
42479409900000,PI,IP,001,26,11250,11250,3885,0,PERF
42479409900000,PI,IP,001,27,11300,11300,3885,0,PERF
42479409900000,PI,IP,001,28,11350,11350,3885,0,PERF
42479409900000,PI,IP,001,29,11400,11400,3885,0,PERF
42479409900000,PI,IP,001,30,11450,11450,3885,0,PERF
42479409900000,PI,IP,001,31,11500,11500,3885,0,PERF
42479409900000,PI,IP,001,32,11550,11550,3885,0,PERF
42479409900000,PI,IP,001,33,11600,11600,3885,0,PERF
42479409900000,PI,IP,001,34,11650,11650,3885,0,PERF
42479409900000,PI,IP,001,35,11700,11700,3885,0,PERF
42479409900000,PI,IP,001,36,11750,11750,3885,0,PERF
42479409900000,PI,IP,001,37,11800,11800,3885,0,PERF
42479409900000,PI,IP,001,38,11850,11850,3885,0,PERF
42479409900000,PI,IP,001,39,11900,11900,3885,0,PERF
42479409900000,PI,IP,001,40,11950,11950,3885,0,PERF
42479409900000,PI,IP,001,41,12000,12000,3885,0,PERF
42479409900000,PI,IP,001,42,12050,12050,3885,0,PERF
42479409900000,PI,IP,001,43,12100,12100,3885,0,PERF
42479409900000,PI,IP,001,44,12150,12150,3885,0,PERF
42479409900000,PI,IP,001,45,12200,12200,3885,0,PERF
42479409900000,PI,IP,001,46,12250,12250,3885,0,PERF
42479409900000,PI,IP,001,47,12300,12300,3885,0,PERF
42479409900000,PI,IP,001,48,12350,12350,3885,0,PERF
42479409900000,PI,IP,001,49,12400,12400,3885,0,PERF
42479409900000,PI,IP,001,50,12450,12450,3885,0,PERF
42479409900000,PI,IP,001,51,12500,12500,3885,0,PERF
42479409900000,PI,IP,001,52,12550,12550,3885,0,PERF
42479409900000,PI,IP,001,53,12600,12600,3885,0,PERF
42479409900000,PI,IP,001,54,12650,12650,3885,0,PERF
42479409900000,PI,IP,001,55,12700,12700,3885,0,PERF
42479409900000,PI,IP,001,56,12750,12750,3885,0,PERF
42479409900000,PI,IP,001,57,12800,12800,3885,0,PERF
42479409900000,PI,IP,001,58,12850,12850,3885,0,PERF
42479409900000,PI,IP,001,59,12900,12900,3885,0,PERF
42479409900000,PI,IP,001,60,12950,12950,3885,0,PERF
42479409900000,PI,IP,001,61,13000,13000,3885,0,PERF
42479409900000,PI,IP,001,62,13050,13050,3885,0,PERF
42479409900000,PI,IP,001,63,13100,13100,3885,0,PERF
42479409900000,PI,IP,001,64,13150,13150,3885,0,PERF
42479409900000,PI,IP,001,65,13190,13190,3885,0,PERF
42479409900000,PI,IP,001,66,13229,13229,3885,0,PERF
42479409910000,PI,IP,001,1,9501,14888,6173,5387,PERF
42479409920000,PI,IP,001,1,10638,15000,5059,4362,PERF
42479409970000,PI,IP,001,1,8267,12874,5369,4607,PERF
42479409980000,PI,IP,001,1,9007,9009,6173,2,PERF
42479409980000,PI,IP,001,2,9082,9084,6173,2,PERF
42479409980000,PI,IP,001,3,9160,9162,6173,2,PERF
42479409980000,PI,IP,001,4,9232,9234,6173,2,PERF
42479409980000,PI,IP,001,5,9354,9356,6173,2,PERF
42479409980000,PI,IP,001,6,9429,9431,6173,2,PERF
42479409980000,PI,IP,001,7,9504,9506,6173,2,PERF
42479409980000,PI,IP,001,8,9590,9592,6173,2,PERF
42479409980000,PI,IP,001,9,9701,9703,6173,2,PERF
42479409980000,PI,IP,001,10,9776,9778,6173,2,PERF
42479409980000,PI,IP,001,11,9851,9853,6173,2,PERF
42479409980000,PI,IP,001,12,9930,9932,6173,2,PERF
42479409980000,PI,IP,001,13,10048,10050,6173,2,PERF
42479409980000,PI,IP,001,14,10123,10125,6173,2,PERF
42479409980000,PI,IP,001,15,10198,10200,6173,2,PERF
42479409980000,PI,IP,001,16,10273,10275,6173,2,PERF
42479409980000,PI,IP,001,17,10400,10402,6173,2,PERF
42479409980000,PI,IP,001,18,10470,10472,6173,2,PERF
42479409980000,PI,IP,001,19,10545,10547,6173,2,PERF
42479409980000,PI,IP,001,20,10620,10622,6173,2,PERF
42479409980000,PI,IP,001,21,10746,10748,6173,2,PERF
42479409980000,PI,IP,001,22,10817,10819,6173,2,PERF
42479409980000,PI,IP,001,23,10892,10894,6173,2,PERF
42479409980000,PI,IP,001,24,10967,10969,6173,2,PERF
42479409980000,PI,IP,001,25,11089,11091,6173,2,PERF
42479409980000,PI,IP,001,26,11164,11166,6173,2,PERF
42479409980000,PI,IP,001,27,11239,11241,6173,2,PERF
42479409980000,PI,IP,001,28,11314,11316,6173,2,PERF
42479409980000,PI,IP,001,29,11436,11438,6173,2,PERF
42479409980000,PI,IP,001,30,11511,11513,6173,2,PERF
42479409980000,PI,IP,001,31,11580,11582,6173,2,PERF
42479409980000,PI,IP,001,32,11661,11663,6173,2,PERF
42479409980000,PI,IP,001,33,11783,11785,6173,2,PERF
42479409980000,PI,IP,001,34,11858,11860,6173,2,PERF
42479409980000,PI,IP,001,35,11923,11925,6173,2,PERF
42479409980000,PI,IP,001,36,12005,12007,6173,2,PERF
42479409980000,PI,IP,001,37,12130,12132,6173,2,PERF
42479409980000,PI,IP,001,38,12205,12207,6173,2,PERF
42479409980000,PI,IP,001,39,12280,12282,6173,2,PERF
42479409980000,PI,IP,001,40,12352,12354,6173,2,PERF
42479409980000,PI,IP,001,41,12477,12479,6173,2,PERF
42479409980000,PI,IP,001,42,12552,12554,6173,2,PERF
42479409980000,PI,IP,001,43,12627,12629,6173,2,PERF
42479409980000,PI,IP,001,44,12712,12714,6173,2,PERF
42479409980000,PI,IP,001,45,12824,12826,6173,2,PERF
42479409980000,PI,IP,001,46,12899,12901,6173,2,PERF
42479409980000,PI,IP,001,47,12974,12976,6173,2,PERF
42479409980000,PI,IP,001,48,13045,13047,6173,2,PERF
42479409980000,PI,IP,001,49,13171,13173,6173,2,PERF
42479409980000,PI,IP,001,50,13246,13248,6173,2,PERF
42479409980000,PI,IP,001,51,13321,13323,6173,2,PERF
42479409980000,PI,IP,001,52,13392,13394,6173,2,PERF
42479409980000,PI,IP,001,53,13518,13520,6173,2,PERF
42479409980000,PI,IP,001,54,13593,13595,6173,2,PERF
42479409980000,PI,IP,001,55,13668,13670,6173,2,PERF
42479409980000,PI,IP,001,56,13743,13745,6173,2,PERF
42479409980000,PI,IP,001,57,13865,13867,6173,2,PERF
42479409980000,PI,IP,001,58,13940,13942,6173,2,PERF
42479409980000,PI,IP,001,59,14015,14017,6173,2,PERF
42479409980000,PI,IP,001,60,14090,14092,6173,2,PERF
42479410020000,PI,IP,001,1,11108,15205,5017,4097,PERF
42479410050000,PI,IP,001,1,9228,14548,6157,5320,PERF
42479410190000,PI,IP,001,1,9230,14847,6500,5617,PERF
42479410200000,PI,IP,001,1,10450,10450,5871,0,PERF
42479410200000,PI,IP,001,2,10500,10500,5871,0,PERF
42479410200000,PI,IP,001,3,10550,10550,5871,0,PERF
42479410200000,PI,IP,001,4,10600,10600,5871,0,PERF
42479410200000,PI,IP,001,5,10650,10650,5871,0,PERF
42479410200000,PI,IP,001,6,10700,10700,5871,0,PERF
42479410200000,PI,IP,001,7,10750,10750,5871,0,PERF
42479410200000,PI,IP,001,8,10800,10800,5871,0,PERF
42479410200000,PI,IP,001,9,10850,10850,5871,0,PERF
42479410200000,PI,IP,001,10,10900,10900,5871,0,PERF
42479410200000,PI,IP,001,11,10950,10950,5871,0,PERF
42479410200000,PI,IP,001,12,11000,11000,5871,0,PERF
42479410200000,PI,IP,001,13,11050,11050,5871,0,PERF
42479410200000,PI,IP,001,14,11100,11100,5871,0,PERF
42479410200000,PI,IP,001,15,11150,11150,5871,0,PERF
42479410200000,PI,IP,001,16,11200,11200,5871,0,PERF
42479410200000,PI,IP,001,17,11250,11250,5871,0,PERF
42479410200000,PI,IP,001,18,11300,11300,5871,0,PERF
42479410200000,PI,IP,001,19,11350,11350,5871,0,PERF
42479410200000,PI,IP,001,20,11400,11400,5871,0,PERF
42479410200000,PI,IP,001,21,11450,11450,5871,0,PERF
42479410200000,PI,IP,001,22,11500,11500,5871,0,PERF
42479410200000,PI,IP,001,23,11550,11550,5871,0,PERF
42479410200000,PI,IP,001,24,11600,11600,5871,0,PERF
42479410200000,PI,IP,001,25,11650,11650,5871,0,PERF
42479410200000,PI,IP,001,26,11700,11700,5871,0,PERF
42479410200000,PI,IP,001,27,11750,11750,5871,0,PERF
42479410200000,PI,IP,001,28,11800,11800,5871,0,PERF
42479410200000,PI,IP,001,29,11850,11850,5871,0,PERF
42479410200000,PI,IP,001,30,11900,11900,5871,0,PERF
42479410200000,PI,IP,001,31,11950,11950,5871,0,PERF
42479410200000,PI,IP,001,32,12000,12000,5871,0,PERF
42479410200000,PI,IP,001,33,12050,12050,5871,0,PERF
42479410200000,PI,IP,001,34,12100,12100,5871,0,PERF
42479410200000,PI,IP,001,35,12150,12150,5871,0,PERF
42479410200000,PI,IP,001,36,12200,12200,5871,0,PERF
42479410200000,PI,IP,001,37,12250,12250,5871,0,PERF
42479410200000,PI,IP,001,38,12300,12300,5871,0,PERF
42479410200000,PI,IP,001,39,12350,12350,5871,0,PERF
42479410200000,PI,IP,001,40,12400,12400,5871,0,PERF
42479410200000,PI,IP,001,41,12450,12450,5871,0,PERF
42479410200000,PI,IP,001,42,12500,12500,5871,0,PERF
42479410200000,PI,IP,001,43,12550,12550,5871,0,PERF
42479410200000,PI,IP,001,44,12600,12600,5871,0,PERF
42479410200000,PI,IP,001,45,12650,12650,5871,0,PERF
42479410200000,PI,IP,001,46,12700,12700,5871,0,PERF
42479410200000,PI,IP,001,47,12750,12750,5871,0,PERF
42479410200000,PI,IP,001,48,12800,12800,5871,0,PERF
42479410200000,PI,IP,001,49,12850,12850,5871,0,PERF
42479410200000,PI,IP,001,50,12900,12900,5871,0,PERF
42479410200000,PI,IP,001,51,12950,12950,5871,0,PERF
42479410200000,PI,IP,001,52,13000,13000,5871,0,PERF
42479410200000,PI,IP,001,53,13050,13050,5871,0,PERF
42479410200000,PI,IP,001,54,13100,13100,5871,0,PERF
42479410200000,PI,IP,001,55,13150,13150,5871,0,PERF
42479410200000,PI,IP,001,56,13200,13200,5871,0,PERF
42479410200000,PI,IP,001,57,13250,13250,5871,0,PERF
42479410200000,PI,IP,001,58,13300,13300,5871,0,PERF
42479410200000,PI,IP,001,59,13350,13350,5871,0,PERF
42479410200000,PI,IP,001,60,13400,13400,5871,0,PERF
42479410200000,PI,IP,001,61,13450,13450,5871,0,PERF
42479410200000,PI,IP,001,62,13500,13500,5871,0,PERF
42479410200000,PI,IP,001,63,13550,13550,5871,0,PERF
42479410200000,PI,IP,001,64,13600,13600,5871,0,PERF
42479410200000,PI,IP,001,65,13650,13650,5871,0,PERF
42479410200000,PI,IP,001,66,13700,13700,5871,0,PERF
42479410200000,PI,IP,001,67,13750,13750,5871,0,PERF
42479410200000,PI,IP,001,68,13800,13800,5871,0,PERF
42479410200000,PI,IP,001,69,13850,13850,5871,0,PERF
42479410200000,PI,IP,001,70,13900,13900,5871,0,PERF
42479410200000,PI,IP,001,71,13950,13950,5871,0,PERF
42479410200000,PI,IP,001,72,14000,14000,5871,0,PERF
42479410200000,PI,IP,001,73,14050,14050,5871,0,PERF
42479410200000,PI,IP,001,74,14100,14100,5871,0,PERF
42479410200000,PI,IP,001,75,14150,14150,5871,0,PERF
42479410200000,PI,IP,001,76,14200,14200,5871,0,PERF
42479410200000,PI,IP,001,77,14250,14250,5871,0,PERF
42479410200000,PI,IP,001,78,14300,14300,5871,0,PERF
42479410200000,PI,IP,001,79,14350,14350,5871,0,PERF
42479410200000,PI,IP,001,80,14400,14400,5871,0,PERF
42479410200000,PI,IP,001,81,14450,14450,5871,0,PERF
42479410200000,PI,IP,001,82,14500,14500,5871,0,PERF
42479410200000,PI,IP,001,83,14550,14550,5871,0,PERF
42479410200000,PI,IP,001,84,14600,14600,5871,0,PERF
42479410200000,PI,IP,001,85,14650,14650,5871,0,PERF
42479410200000,PI,IP,001,86,14700,14700,5871,0,PERF
42479410200000,PI,IP,001,87,14750,14750,5871,0,PERF
42479410200000,PI,IP,001,88,14800,14800,5871,0,PERF
42479410200000,PI,IP,001,89,14850,14850,5871,0,PERF
42479410200000,PI,IP,001,90,14900,14900,5871,0,PERF
42479410200000,PI,IP,001,91,14950,14950,5871,0,PERF
42479410200000,PI,IP,001,92,15000,15000,5871,0,PERF
42479410200000,PI,IP,001,93,15050,15050,5871,0,PERF
42479410200000,PI,IP,001,94,15100,15100,5871,0,PERF
42479410200000,PI,IP,001,95,15150,15150,5871,0,PERF
42479410200000,PI,IP,001,96,15200,15200,5871,0,PERF
42479410210000,PI,IP,001,1,8301,14394,6103,6093,PERF
42479410240000,PI,IP,001,1,8475,15216,7629,6741,PERF
42479410280000,PI,IP,001,1,10358,14479,5141,4121,PERF
42479410290000,PI,IP,001,1,10358,14499,5120,4141,PERF
42479410300000,PI,IP,001,1,10320,14445,5119,4125,PERF
42479410310000,PI,IP,001,1,10500,13297,3297,2797,PERF
42479410320000,PI,IP,001,1,12720,12962,4397,242,PERF
42479410320000,PI,IP,001,2,13040,13282,4397,242,PERF
42479410320000,PI,IP,001,3,13360,13602,4397,242,PERF
42479410320000,PI,IP,001,4,13680,13922,4397,242,PERF
42479410320000,PI,IP,001,5,14000,14242,4397,242,PERF
42479410320000,PI,IP,001,6,14320,14562,4397,242,PERF
42479410320000,PI,IP,001,7,14640,14882,4397,242,PERF
42479410320000,PI,IP,001,8,14960,15202,4397,242,PERF
42479410320000,PI,IP,001,9,15280,15522,4397,242,PERF
42479410320000,PI,IP,001,10,15600,15842,4397,242,PERF
42479410320000,PI,IP,001,11,15920,16162,4397,242,PERF
42479410320000,PI,IP,001,12,16240,16482,4397,242,PERF
42479410330000,PI,IP,001,1,10070,15421,6912,5351,PERF
42479410350000,PI,IP,001,1,10223,15155,5969,4932,PERF
42479410380000,PI,IP,001,1,8969,8971,6199,2,PERF
42479410380000,PI,IP,001,2,9065,9067,6199,2,PERF
42479410380000,PI,IP,001,3,9158,9160,6199,2,PERF
42479410380000,PI,IP,001,4,9262,9264,6199,2,PERF
42479410380000,PI,IP,001,5,9351,9353,6199,2,PERF
42479410380000,PI,IP,001,6,9447,9449,6199,2,PERF
42479410380000,PI,IP,001,7,9543,9547,6199,4,PERF
42479410380000,PI,IP,001,8,9639,9641,6199,2,PERF
42479410380000,PI,IP,001,9,9733,9735,6199,2,PERF
42479410380000,PI,IP,001,10,9829,9831,6199,2,PERF
42479410380000,PI,IP,001,11,9925,9927,6199,2,PERF
42479410380000,PI,IP,001,12,10018,10020,6199,2,PERF
42479410380000,PI,IP,001,13,10108,10110,6199,2,PERF
42479410380000,PI,IP,001,14,10211,10213,6199,2,PERF
42479410380000,PI,IP,001,15,10307,10309,6199,2,PERF
42479410380000,PI,IP,001,16,10403,10405,6199,2,PERF
42479410380000,PI,IP,001,17,10497,10499,6199,2,PERF
42479410380000,PI,IP,001,18,10593,10595,6199,2,PERF
42479410380000,PI,IP,001,19,10689,10691,6199,2,PERF
42479410380000,PI,IP,001,20,10785,10787,6199,2,PERF
42479410380000,PI,IP,001,21,10879,10881,6199,2,PERF
42479410380000,PI,IP,001,22,10972,10974,6199,2,PERF
42479410380000,PI,IP,001,23,11074,11076,6199,2,PERF
42479410380000,PI,IP,001,24,11167,11169,6199,2,PERF
42479410380000,PI,IP,001,25,11261,11263,6199,2,PERF
42479410380000,PI,IP,001,26,11357,11359,6199,2,PERF
42479410380000,PI,IP,001,27,11453,11455,6199,2,PERF
42479410380000,PI,IP,001,28,11549,11551,6199,2,PERF
42479410380000,PI,IP,001,29,11643,11645,6199,2,PERF
42479410380000,PI,IP,001,30,11739,11741,6199,2,PERF
42479410380000,PI,IP,001,31,11835,11837,6199,2,PERF
42479410380000,PI,IP,001,32,11928,11930,6199,2,PERF
42479410380000,PI,IP,001,33,12029,12031,6199,2,PERF
42479410380000,PI,IP,001,34,12121,12123,6199,2,PERF
42479410380000,PI,IP,001,35,12217,12219,6199,2,PERF
42479410380000,PI,IP,001,36,12313,12315,6199,2,PERF
42479410380000,PI,IP,001,37,12480,12491,6199,11,PERF
42479410380000,PI,IP,001,38,12503,12505,6199,2,PERF
42479410380000,PI,IP,001,39,12599,12601,6199,2,PERF
42479410380000,PI,IP,001,40,12695,12697,6199,2,PERF
42479410380000,PI,IP,001,41,12780,12791,6199,11,PERF
42479410380000,PI,IP,001,42,12880,12882,6199,2,PERF
42479410380000,PI,IP,001,43,12981,12983,6199,2,PERF
42479410380000,PI,IP,001,44,13077,13079,6199,2,PERF
42479410380000,PI,IP,001,45,13171,13173,6199,2,PERF
42479410380000,PI,IP,001,46,13267,13269,6199,2,PERF
42479410380000,PI,IP,001,47,13363,13365,6199,2,PERF
42479410380000,PI,IP,001,48,13459,13461,6199,2,PERF
42479410380000,PI,IP,001,49,13553,13555,6199,2,PERF
42479410380000,PI,IP,001,50,13649,13651,6199,2,PERF
42479410380000,PI,IP,001,51,13745,13747,6199,2,PERF
42479410380000,PI,IP,001,52,13841,13843,6199,2,PERF
42479410380000,PI,IP,001,53,13935,13937,6199,2,PERF
42479410380000,PI,IP,001,54,14010,14012,6199,2,PERF
42479410380000,PI,IP,001,55,14085,14087,6199,2,PERF
42479410380000,PI,IP,001,56,14160,14162,6199,2,PERF
42479410390000,PI,IP,001,1,8747,12406,4224,3659,PERF
42479410440000,PI,IP,001,1,8324,15602,,7278,PERF
42479410460000,PI,IP,001,1,7801,12490,5702,4689,PERF
42479410470000,PI,IP,001,1,10150,10400,6921,250,PERF
42479410470000,PI,IP,001,2,10450,10700,6921,250,PERF
42479410470000,PI,IP,001,3,10750,11000,6921,250,PERF
42479410470000,PI,IP,001,4,11050,11300,6921,250,PERF
42479410470000,PI,IP,001,5,11350,11600,6921,250,PERF
42479410470000,PI,IP,001,6,11650,11900,6921,250,PERF
42479410470000,PI,IP,001,7,11950,12200,6921,250,PERF
42479410470000,PI,IP,001,8,12250,12500,6921,250,PERF
42479410470000,PI,IP,001,9,12550,12800,6921,250,PERF
42479410470000,PI,IP,001,10,12850,13100,6921,250,PERF
42479410470000,PI,IP,001,11,13150,13400,6921,250,PERF
42479410470000,PI,IP,001,12,13450,13700,6921,250,PERF
42479410470000,PI,IP,001,13,13750,14000,6921,250,PERF
42479410470000,PI,IP,001,14,14050,14300,6921,250,PERF
42479410470000,PI,IP,001,15,14350,14600,6921,250,PERF
42479410470000,PI,IP,001,16,14650,14900,6921,250,PERF
42479410470000,PI,IP,001,17,14950,15200,6921,250,PERF
42479410470000,PI,IP,001,18,15250,15500,6921,250,PERF
42479410470000,PI,IP,001,19,15550,15800,6921,250,PERF
42479410470000,PI,IP,001,20,15850,16100,6921,250,PERF
42479410480000,PI,IP,001,1,12718,16790,4489,4072,PERF
42479410490000,PI,IP,001,1,10099,14958,5302,4859,PERF
42479410510000,PI,IP,001,1,9988,15492,6837,5504,PERF
42479410520000,PI,IP,001,1,7664,12677,5915,5013,PERF
42479410530000,PI,IP,001,1,9410,14738,6222,5328,PERF
42479410540000,PI,IP,001,1,9919,14878,6313,4959,PERF
42479410550000,PI,IP,001,1,10793,15045,5478,4252,PERF
42479410590000,PI,IP,001,1,10200,10450,,250,PERF
42479410590000,PI,IP,001,2,10500,10750,,250,PERF
42479410590000,PI,IP,001,3,10800,11050,,250,PERF
42479410590000,PI,IP,001,4,11100,11350,,250,PERF
42479410590000,PI,IP,001,5,11400,11650,,250,PERF
42479410590000,PI,IP,001,6,11700,11950,,250,PERF
42479410590000,PI,IP,001,7,12000,12250,,250,PERF
42479410590000,PI,IP,001,8,12300,12550,,250,PERF
42479410590000,PI,IP,001,9,12600,12850,,250,PERF
42479410590000,PI,IP,001,10,12900,13150,,250,PERF
42479410590000,PI,IP,001,11,13200,13450,,250,PERF
42479410590000,PI,IP,001,12,13500,13750,,250,PERF
42479410590000,PI,IP,001,13,13800,14050,,250,PERF
42479410590000,PI,IP,001,14,14100,14350,,250,PERF
42479410590000,PI,IP,001,15,14400,14650,,250,PERF
42479410590000,PI,IP,001,16,14700,14950,,250,PERF
42479410590000,PI,IP,001,17,15000,15250,,250,PERF
42479410590000,PI,IP,001,18,15300,15550,,250,PERF
42479410590000,PI,IP,001,19,15600,15850,,250,PERF
42479410590000,PI,IP,001,20,15900,16150,,250,PERF
42479410590000,PI,IP,001,21,16200,16450,,250,PERF
42479410600000,PI,IP,001,1,8928,8930,6051,2,PERF
42479410600000,PI,IP,001,2,9018,9020,6051,2,PERF
42479410600000,PI,IP,001,3,9108,9110,6051,2,PERF
42479410600000,PI,IP,001,4,9198,9200,6051,2,PERF
42479410600000,PI,IP,001,5,9292,9294,6051,2,PERF
42479410600000,PI,IP,001,6,9382,9384,6051,2,PERF
42479410600000,PI,IP,001,7,9472,9474,6051,2,PERF
42479410600000,PI,IP,001,8,9562,9564,6051,2,PERF
42479410600000,PI,IP,001,9,9565,9567,6051,2,PERF
42479410600000,PI,IP,001,10,9746,9748,6051,2,PERF
42479410600000,PI,IP,001,11,9836,9838,6051,2,PERF
42479410600000,PI,IP,001,12,9926,9928,6051,2,PERF
42479410600000,PI,IP,001,13,10020,10022,6051,2,PERF
42479410600000,PI,IP,001,14,10110,10112,6051,2,PERF
42479410600000,PI,IP,001,15,10200,10202,6051,2,PERF
42479410600000,PI,IP,001,16,10290,10292,6051,2,PERF
42479410600000,PI,IP,001,17,10384,10386,6051,2,PERF
42479410600000,PI,IP,001,18,10474,10476,6051,2,PERF
42479410600000,PI,IP,001,19,10564,10566,6051,2,PERF
42479410600000,PI,IP,001,20,10654,10656,6051,2,PERF
42479410600000,PI,IP,001,21,10748,10750,6051,2,PERF
42479410600000,PI,IP,001,22,10838,10840,6051,2,PERF
42479410600000,PI,IP,001,23,10928,10930,6051,2,PERF
42479410600000,PI,IP,001,24,11018,11020,6051,2,PERF
42479410600000,PI,IP,001,25,11112,11114,6051,2,PERF
42479410600000,PI,IP,001,26,11202,11204,6051,2,PERF
42479410600000,PI,IP,001,27,11292,11294,6051,2,PERF
42479410600000,PI,IP,001,28,11382,11384,6051,2,PERF
42479410600000,PI,IP,001,29,11476,11478,6051,2,PERF
42479410600000,PI,IP,001,30,11566,11568,6051,2,PERF
42479410600000,PI,IP,001,31,11656,11658,6051,2,PERF
42479410600000,PI,IP,001,32,11746,11748,6051,2,PERF
42479410600000,PI,IP,001,33,11840,11842,6051,2,PERF
42479410600000,PI,IP,001,34,11930,11932,6051,2,PERF
42479410600000,PI,IP,001,35,12020,12022,6051,2,PERF
42479410600000,PI,IP,001,36,12110,12112,6051,2,PERF
42479410600000,PI,IP,001,37,12206,12208,6051,2,PERF
42479410600000,PI,IP,001,38,12296,12298,6051,2,PERF
42479410600000,PI,IP,001,39,12386,12388,6051,2,PERF
42479410600000,PI,IP,001,40,12476,12478,6051,2,PERF
42479410600000,PI,IP,001,41,12566,12568,6051,2,PERF
42479410600000,PI,IP,001,42,12656,12658,6051,2,PERF
42479410600000,PI,IP,001,43,12746,12748,6051,2,PERF
42479410600000,PI,IP,001,44,12838,12840,6051,2,PERF
42479410600000,PI,IP,001,45,12935,12937,6051,2,PERF
42479410600000,PI,IP,001,46,13025,13027,6051,2,PERF
42479410600000,PI,IP,001,47,13116,13118,6051,2,PERF
42479410600000,PI,IP,001,48,13207,13209,6051,2,PERF
42479410600000,PI,IP,001,49,13298,13300,6051,2,PERF
42479410600000,PI,IP,001,50,13389,13390,6051,1,PERF
42479410600000,PI,IP,001,51,13478,13480,6051,2,PERF
42479410600000,PI,IP,001,52,13560,13562,6051,2,PERF
42479410600000,PI,IP,001,53,13660,13662,6051,2,PERF
42479410600000,PI,IP,001,54,13750,13752,6051,2,PERF
42479410600000,PI,IP,001,55,13840,13842,6051,2,PERF
42479410600000,PI,IP,001,56,13930,13932,6051,2,PERF
42479410600000,PI,IP,001,57,14035,14037,6051,2,PERF
42479410600000,PI,IP,001,58,14110,14112,6051,2,PERF
42479410600000,PI,IP,001,59,14185,14187,6051,2,PERF
42479410600000,PI,IP,001,60,14260,14262,6051,2,PERF
42479410610100,PI,IP,001,1,9746,14466,6051,4720,PERF
42479410620000,PI,IP,001,1,9314,14962,6507,5648,PERF
42479410630000,PI,IP,001,1,11200,15902,5412,4702,PERF
42479410640000,PI,IP,001,1,9154,9156,5817,2,PERF
42479410640000,PI,IP,001,2,9240,9242,5817,2,PERF
42479410640000,PI,IP,001,3,9316,9318,5817,2,PERF
42479410640000,PI,IP,001,4,9404,9406,5817,2,PERF
42479410640000,PI,IP,001,5,9495,9497,5817,2,PERF
42479410640000,PI,IP,001,6,9579,9581,5817,2,PERF
42479410640000,PI,IP,001,7,9663,9665,5817,2,PERF
42479410640000,PI,IP,001,8,9747,9749,5817,2,PERF
42479410640000,PI,IP,001,9,9836,9838,5817,2,PERF
42479410640000,PI,IP,001,10,9920,9922,5817,2,PERF
42479410640000,PI,IP,001,11,10006,10008,5817,2,PERF
42479410640000,PI,IP,001,12,10084,10086,5817,2,PERF
42479410640000,PI,IP,001,13,10175,10177,5817,2,PERF
42479410640000,PI,IP,001,14,10261,10263,5817,2,PERF
42479410640000,PI,IP,001,15,10345,10347,5817,2,PERF
42479410640000,PI,IP,001,16,10429,10431,5817,2,PERF
42479410640000,PI,IP,001,17,10518,10520,5817,2,PERF
42479410640000,PI,IP,001,18,10602,10604,5817,2,PERF
42479410640000,PI,IP,001,19,10686,10688,5817,2,PERF
42479410640000,PI,IP,001,20,10770,10772,5817,2,PERF
42479410640000,PI,IP,001,21,10859,10861,5817,2,PERF
42479410640000,PI,IP,001,22,10939,10941,5817,2,PERF
42479410640000,PI,IP,001,23,11027,11029,5817,2,PERF
42479410640000,PI,IP,001,24,11111,11113,5817,2,PERF
42479410640000,PI,IP,001,25,11200,11202,5817,2,PERF
42479410640000,PI,IP,001,26,11284,11286,5817,2,PERF
42479410640000,PI,IP,001,27,11368,11370,5817,2,PERF
42479410640000,PI,IP,001,28,11452,11454,5817,2,PERF
42479410640000,PI,IP,001,29,11541,11543,5817,2,PERF
42479410640000,PI,IP,001,30,11625,11627,5817,2,PERF
42479410640000,PI,IP,001,31,11710,11712,5817,2,PERF
42479410640000,PI,IP,001,32,11788,11790,5817,2,PERF
42479410640000,PI,IP,001,33,11878,11880,5817,2,PERF
42479410640000,PI,IP,001,34,11966,11968,5817,2,PERF
42479410640000,PI,IP,001,35,12050,12052,5817,2,PERF
42479410640000,PI,IP,001,36,12134,12136,5817,2,PERF
42479410640000,PI,IP,001,37,12223,12225,5817,2,PERF
42479410640000,PI,IP,001,38,12307,12309,5817,2,PERF
42479410640000,PI,IP,001,39,12391,12393,5817,2,PERF
42479410640000,PI,IP,001,40,12479,12481,5817,2,PERF
42479410640000,PI,IP,001,41,12560,12562,5817,2,PERF
42479410640000,PI,IP,001,42,12648,12650,5817,2,PERF
42479410640000,PI,IP,001,43,12732,12734,5817,2,PERF
42479410640000,PI,IP,001,44,12816,12818,5817,2,PERF
42479410640000,PI,IP,001,45,12905,12907,5817,2,PERF
42479410640000,PI,IP,001,46,12989,12991,5817,2,PERF
42479410640000,PI,IP,001,47,13073,13075,5817,2,PERF
42479410640000,PI,IP,001,48,13157,13159,5817,2,PERF
42479410640000,PI,IP,001,49,13246,13248,5817,2,PERF
42479410640000,PI,IP,001,50,13326,13328,5817,2,PERF
42479410640000,PI,IP,001,51,13414,13416,5817,2,PERF
42479410640000,PI,IP,001,52,13498,13500,5817,2,PERF
42479410640000,PI,IP,001,53,13587,13589,5817,2,PERF
42479410640000,PI,IP,001,54,13671,13673,5817,2,PERF
42479410640000,PI,IP,001,55,13755,13757,5817,2,PERF
42479410640000,PI,IP,001,56,13839,13841,5817,2,PERF
42479410640000,PI,IP,001,57,13944,13946,5817,2,PERF
42479410640000,PI,IP,001,58,14019,14021,5817,2,PERF
42479410640000,PI,IP,001,59,14094,14096,5817,2,PERF
42479410640000,PI,IP,001,60,14169,14171,5817,2,PERF
42479410650000,PI,IP,001,1,10500,10750,6295,250,PERF
42479410650000,PI,IP,001,2,10800,11050,6295,250,PERF
42479410650000,PI,IP,001,3,11100,11350,6295,250,PERF
42479410650000,PI,IP,001,4,11400,11650,6295,250,PERF
42479410650000,PI,IP,001,5,11700,11950,6295,250,PERF
42479410650000,PI,IP,001,6,12000,12250,6295,250,PERF
42479410650000,PI,IP,001,7,12300,12550,6295,250,PERF
42479410650000,PI,IP,001,8,12600,12850,6295,250,PERF
42479410650000,PI,IP,001,9,12900,13150,6295,250,PERF
42479410650000,PI,IP,001,10,13200,13450,6295,250,PERF
42479410650000,PI,IP,001,11,13500,13750,6295,250,PERF
42479410650000,PI,IP,001,12,13800,14050,6295,250,PERF
42479410650000,PI,IP,001,13,14100,14350,6295,250,PERF
42479410650000,PI,IP,001,14,14400,14650,6295,250,PERF
42479410650000,PI,IP,001,15,14700,14950,6295,250,PERF
42479410650000,PI,IP,001,16,15000,15250,6295,250,PERF
42479410650000,PI,IP,001,17,15300,15555,6295,255,PERF
42479410650000,PI,IP,001,18,15600,15835,6295,235,PERF
42479410670000,PI,IP,001,1,8510,14674,7013,6164,PERF
42479410680000,PI,IP,001,1,8351,8353,6311,2,PERF
42479410680000,PI,IP,001,2,8391,8393,6311,2,PERF
42479410680000,PI,IP,001,3,8431,8433,6311,2,PERF
42479410680000,PI,IP,001,4,8471,8473,6311,2,PERF
42479410680000,PI,IP,001,5,8511,8513,6311,2,PERF
42479410680000,PI,IP,001,6,8609,8611,6311,2,PERF
42479410680000,PI,IP,001,7,8649,8651,6311,2,PERF
42479410680000,PI,IP,001,8,8689,8691,6311,2,PERF
42479410680000,PI,IP,001,9,8729,8731,6311,2,PERF
42479410680000,PI,IP,001,10,8769,8771,6311,2,PERF
42479410680000,PI,IP,001,11,8867,8869,6311,2,PERF
42479410680000,PI,IP,001,12,8907,8909,6311,2,PERF
42479410680000,PI,IP,001,13,8947,8949,6311,2,PERF
42479410680000,PI,IP,001,14,8987,8989,6311,2,PERF
42479410680000,PI,IP,001,15,9027,9029,6311,2,PERF
42479410680000,PI,IP,001,16,9125,9127,6311,2,PERF
42479410680000,PI,IP,001,17,9165,9167,6311,2,PERF
42479410680000,PI,IP,001,18,9205,9207,6311,2,PERF
42479410680000,PI,IP,001,19,9245,9247,6311,2,PERF
42479410680000,PI,IP,001,20,9285,9287,6311,2,PERF
42479410680000,PI,IP,001,21,9383,9385,6311,2,PERF
42479410680000,PI,IP,001,22,9423,9425,6311,2,PERF
42479410680000,PI,IP,001,23,9463,9465,6311,2,PERF
42479410680000,PI,IP,001,24,9503,9505,6311,2,PERF
42479410680000,PI,IP,001,25,9543,9545,6311,2,PERF
42479410680000,PI,IP,001,26,9641,9643,6311,2,PERF
42479410680000,PI,IP,001,27,9681,9683,6311,2,PERF
42479410680000,PI,IP,001,28,9721,9723,6311,2,PERF
42479410680000,PI,IP,001,29,9761,9763,6311,2,PERF
42479410680000,PI,IP,001,30,9801,9803,6311,2,PERF
42479410680000,PI,IP,001,31,9899,9901,6311,2,PERF
42479410680000,PI,IP,001,32,9939,9941,6311,2,PERF
42479410680000,PI,IP,001,33,9979,9981,6311,2,PERF
42479410680000,PI,IP,001,34,10019,10021,6311,2,PERF
42479410680000,PI,IP,001,35,10059,10061,6311,2,PERF
42479410680000,PI,IP,001,36,10157,10159,6311,2,PERF
42479410680000,PI,IP,001,37,10197,10199,6311,2,PERF
42479410680000,PI,IP,001,38,10237,10239,6311,2,PERF
42479410680000,PI,IP,001,39,10277,10279,6311,2,PERF
42479410680000,PI,IP,001,40,10317,10319,6311,2,PERF
42479410680000,PI,IP,001,41,10415,10417,6311,2,PERF
42479410680000,PI,IP,001,42,10455,10457,6311,2,PERF
42479410680000,PI,IP,001,43,10495,10497,6311,2,PERF
42479410680000,PI,IP,001,44,10535,10537,6311,2,PERF
42479410680000,PI,IP,001,45,10575,10577,6311,2,PERF
42479410680000,PI,IP,001,46,10673,10675,6311,2,PERF
42479410680000,PI,IP,001,47,10713,10715,6311,2,PERF
42479410680000,PI,IP,001,48,10753,10755,6311,2,PERF
42479410680000,PI,IP,001,49,10793,10795,6311,2,PERF
42479410680000,PI,IP,001,50,10833,10835,6311,2,PERF
42479410680000,PI,IP,001,51,10931,10933,6311,2,PERF
42479410680000,PI,IP,001,52,10971,10973,6311,2,PERF
42479410680000,PI,IP,001,53,11011,11013,6311,2,PERF
42479410680000,PI,IP,001,54,11051,11053,6311,2,PERF
42479410680000,PI,IP,001,55,11091,11093,6311,2,PERF
42479410680000,PI,IP,001,56,11189,11191,6311,2,PERF
42479410680000,PI,IP,001,57,11229,11231,6311,2,PERF
42479410680000,PI,IP,001,58,11269,11271,6311,2,PERF
42479410680000,PI,IP,001,59,11309,11311,6311,2,PERF
42479410680000,PI,IP,001,60,11349,11351,6311,2,PERF
42479410680000,PI,IP,001,61,11447,11449,6311,2,PERF
42479410680000,PI,IP,001,62,11487,11489,6311,2,PERF
42479410680000,PI,IP,001,63,11527,11529,6311,2,PERF
42479410680000,PI,IP,001,64,11567,11569,6311,2,PERF
42479410680000,PI,IP,001,65,11607,11609,6311,2,PERF
42479410680000,PI,IP,001,66,11705,11707,6311,2,PERF
42479410680000,PI,IP,001,67,11745,11747,6311,2,PERF
42479410680000,PI,IP,001,68,11785,11787,6311,2,PERF
42479410680000,PI,IP,001,69,11825,11827,6311,2,PERF
42479410680000,PI,IP,001,70,11865,11867,6311,2,PERF
42479410680000,PI,IP,001,71,11963,11965,6311,2,PERF
42479410680000,PI,IP,001,72,12003,12005,6311,2,PERF
42479410680000,PI,IP,001,73,12043,12045,6311,2,PERF
42479410680000,PI,IP,001,74,12083,12085,6311,2,PERF
42479410680000,PI,IP,001,75,12123,12125,6311,2,PERF
42479410680000,PI,IP,001,76,12221,12223,6311,2,PERF
42479410680000,PI,IP,001,77,12261,12263,6311,2,PERF
42479410680000,PI,IP,001,78,12301,12303,6311,2,PERF
42479410680000,PI,IP,001,79,12341,12343,6311,2,PERF
42479410680000,PI,IP,001,80,12381,12383,6311,2,PERF
42479410680000,PI,IP,001,81,12479,12481,6311,2,PERF
42479410680000,PI,IP,001,82,12519,12521,6311,2,PERF
42479410680000,PI,IP,001,83,12559,12561,6311,2,PERF
42479410680000,PI,IP,001,84,12599,12601,6311,2,PERF
42479410680000,PI,IP,001,85,12639,12641,6311,2,PERF
42479410680000,PI,IP,001,86,12737,12739,6311,2,PERF
42479410680000,PI,IP,001,87,12777,12779,6311,2,PERF
42479410680000,PI,IP,001,88,12817,12819,6311,2,PERF
42479410680000,PI,IP,001,89,12857,12859,6311,2,PERF
42479410680000,PI,IP,001,90,12897,12899,6311,2,PERF
42479410680000,PI,IP,001,91,12995,12997,6311,2,PERF
42479410680000,PI,IP,001,92,13035,13037,6311,2,PERF
42479410680000,PI,IP,001,93,13075,13077,6311,2,PERF
42479410680000,PI,IP,001,94,13115,13117,6311,2,PERF
42479410680000,PI,IP,001,95,13155,13157,6311,2,PERF
42479410680000,PI,IP,001,96,13253,13255,6311,2,PERF
42479410680000,PI,IP,001,97,13293,13295,6311,2,PERF
42479410680000,PI,IP,001,98,13333,13335,6311,2,PERF
42479410680000,PI,IP,001,99,13373,13375,6311,2,PERF
42479410680000,PI,IP,001,100,13413,13415,6311,2,PERF
42479410680000,PI,IP,001,101,13511,13513,6311,2,PERF
42479410680000,PI,IP,001,102,13551,13553,6311,2,PERF
42479410680000,PI,IP,001,103,13591,13593,6311,2,PERF
42479410680000,PI,IP,001,104,13631,13633,6311,2,PERF
42479410680000,PI,IP,001,105,13671,13671,6311,0,PERF
42479410680000,PI,IP,001,106,13769,13771,6311,2,PERF
42479410680000,PI,IP,001,107,13809,13811,6311,2,PERF
42479410680000,PI,IP,001,108,13849,13851,6311,2,PERF
42479410680000,PI,IP,001,109,13889,13891,6311,2,PERF
42479410680000,PI,IP,001,110,13929,13931,6311,2,PERF
42479410680000,PI,IP,001,111,14027,14029,6311,2,PERF
42479410680000,PI,IP,001,112,14067,14069,6311,2,PERF
42479410680000,PI,IP,001,113,14107,14109,6311,2,PERF
42479410680000,PI,IP,001,114,14147,14149,6311,2,PERF
42479410680000,PI,IP,001,115,14187,14189,6311,2,PERF
42479410680000,PI,IP,001,116,14247,14249,6311,2,PERF
42479410680000,PI,IP,001,117,14286,14288,6311,2,PERF
42479410680000,PI,IP,001,118,14323,14325,6311,2,PERF
42479410680000,PI,IP,001,119,14362,14364,6311,2,PERF
42479410680000,PI,IP,001,120,14400,14402,6311,2,PERF
42479410690000,PI,IP,001,1,8351,13086,5351,4735,PERF
42479410700000,PI,IP,001,1,8453,13272,5222,4819,PERF
42479410710000,PI,IP,001,1,8419,15039,6812,6620,PERF
42479410730000,PI,IP,001,1,7518,12447,5750,4929,PERF
42479410740000,PI,IP,001,1,8934,8936,5683,2,PERF
42479410740000,PI,IP,001,2,9019,9021,5683,2,PERF
42479410740000,PI,IP,001,3,9098,9100,5683,2,PERF
42479410740000,PI,IP,001,4,9177,9179,5683,2,PERF
42479410740000,PI,IP,001,5,9254,9256,5683,2,PERF
42479410740000,PI,IP,001,6,9320,9322,5683,2,PERF
42479410740000,PI,IP,001,7,9417,9419,5683,2,PERF
42479410740000,PI,IP,001,8,9496,9498,5683,2,PERF
42479410740000,PI,IP,001,9,9580,9582,5683,2,PERF
42479410740000,PI,IP,001,10,9657,9659,5683,2,PERF
42479410740000,PI,IP,001,11,9736,9738,5683,2,PERF
42479410740000,PI,IP,001,12,9815,9817,5683,2,PERF
42479410740000,PI,IP,001,13,9900,9902,5683,2,PERF
42479410740000,PI,IP,001,14,9976,9978,5683,2,PERF
42479410740000,PI,IP,001,15,10055,10057,5683,2,PERF
42479410740000,PI,IP,001,16,10134,10136,5683,2,PERF
42479410740000,PI,IP,001,17,10206,10208,5683,2,PERF
42479410740000,PI,IP,001,18,10295,10297,5683,2,PERF
42479410740000,PI,IP,001,19,10374,10376,5683,2,PERF
42479410740000,PI,IP,001,20,10453,10455,5683,2,PERF
42479410740000,PI,IP,001,21,10535,10537,5683,2,PERF
42479410740000,PI,IP,001,22,10614,10616,5683,2,PERF
42479410740000,PI,IP,001,23,10693,10695,5683,2,PERF
42479410740000,PI,IP,001,24,10772,10774,5683,2,PERF
42479410740000,PI,IP,001,25,10854,10856,5683,2,PERF
42479410740000,PI,IP,001,26,10933,10935,5683,2,PERF
42479410740000,PI,IP,001,27,11012,11014,5683,2,PERF
42479410740000,PI,IP,001,28,11091,11093,5683,2,PERF
42479410740000,PI,IP,001,29,11173,11175,5683,2,PERF
42479410740000,PI,IP,001,30,11258,11260,5683,2,PERF
42479410740000,PI,IP,001,31,11331,11333,5683,2,PERF
42479410740000,PI,IP,001,32,11410,11412,5683,2,PERF
42479410740000,PI,IP,001,33,11492,11494,5683,2,PERF
42479410740000,PI,IP,001,34,11571,11573,5683,2,PERF
42479410740000,PI,IP,001,35,11662,11664,5683,2,PERF
42479410740000,PI,IP,001,36,11729,11731,5683,2,PERF
42479410740000,PI,IP,001,37,11811,11813,5683,2,PERF
42479410740000,PI,IP,001,38,11890,11892,5683,2,PERF
42479410740000,PI,IP,001,39,11964,11966,5683,2,PERF
42479410740000,PI,IP,001,40,12048,12050,5683,2,PERF
42479410740000,PI,IP,001,41,12130,12132,5683,2,PERF
42479410740000,PI,IP,001,42,12209,12211,5683,2,PERF
42479410740000,PI,IP,001,43,12292,12294,5683,2,PERF
42479410740000,PI,IP,001,44,12367,12369,5683,2,PERF
42479410740000,PI,IP,001,45,12449,12451,5683,2,PERF
42479410740000,PI,IP,001,46,12528,12530,5683,2,PERF
42479410740000,PI,IP,001,47,12610,12612,5683,2,PERF
42479410740000,PI,IP,001,48,12686,12688,5683,2,PERF
42479410740000,PI,IP,001,49,12768,12770,5683,2,PERF
42479410740000,PI,IP,001,50,12847,12849,5683,2,PERF
42479410740000,PI,IP,001,51,12926,12928,5683,2,PERF
42479410740000,PI,IP,001,52,13005,13007,5683,2,PERF
42479410740000,PI,IP,001,53,13087,13089,5683,2,PERF
42479410740000,PI,IP,001,54,13166,13168,5683,2,PERF
42479410740000,PI,IP,001,55,13245,13247,5683,2,PERF
42479410740000,PI,IP,001,56,13324,13326,5683,2,PERF
42479410740000,PI,IP,001,57,13406,13408,5683,2,PERF
42479410740000,PI,IP,001,58,13476,13478,5683,2,PERF
42479410740000,PI,IP,001,59,13546,13548,5683,2,PERF
42479410740000,PI,IP,001,60,13616,13618,5683,2,PERF
42479410750000,PI,IP,001,1,8810,8812,6125,2,PERF
42479410750000,PI,IP,001,2,8904,8906,6125,2,PERF
42479410750000,PI,IP,001,3,8998,9000,6125,2,PERF
42479410750000,PI,IP,001,4,9092,9094,6125,2,PERF
42479410750000,PI,IP,001,5,9190,9192,6125,2,PERF
42479410750000,PI,IP,001,6,9282,9284,6125,2,PERF
42479410750000,PI,IP,001,7,9382,9384,6125,2,PERF
42479410750000,PI,IP,001,8,9474,9476,6125,2,PERF
42479410750000,PI,IP,001,9,9570,9572,6125,2,PERF
42479410750000,PI,IP,001,10,9664,9666,6125,2,PERF
42479410750000,PI,IP,001,11,9758,9760,6125,2,PERF
42479410750000,PI,IP,001,12,9852,9854,6125,2,PERF
42479410750000,PI,IP,001,13,9950,9952,6125,2,PERF
42479410750000,PI,IP,001,14,10044,10046,6125,2,PERF
42479410750000,PI,IP,001,15,10138,10140,6125,2,PERF
42479410750000,PI,IP,001,16,10232,10234,6125,2,PERF
42479410750000,PI,IP,001,17,10336,10338,6125,2,PERF
42479410750000,PI,IP,001,18,10424,10426,6125,2,PERF
42479410750000,PI,IP,001,19,10518,10520,6125,2,PERF
42479410750000,PI,IP,001,20,10612,10614,6125,2,PERF
42479410750000,PI,IP,001,21,10710,10722,6125,12,PERF
42479410750000,PI,IP,001,22,10804,10806,6125,2,PERF
42479410750000,PI,IP,001,23,10898,10900,6125,2,PERF
42479410750000,PI,IP,001,24,10992,10994,6125,2,PERF
42479410750000,PI,IP,001,25,11090,11092,6125,2,PERF
42479410750000,PI,IP,001,26,11184,11186,6125,2,PERF
42479410750000,PI,IP,001,27,11276,11278,6125,2,PERF
42479410750000,PI,IP,001,28,11378,11380,6125,2,PERF
42479410750000,PI,IP,001,29,11470,11472,6125,2,PERF
42479410750000,PI,IP,001,30,11564,11566,6125,2,PERF
42479410750000,PI,IP,001,31,11658,11660,6125,2,PERF
42479410750000,PI,IP,001,32,11752,11754,6125,2,PERF
42479410750000,PI,IP,001,33,11850,11852,6125,2,PERF
42479410750000,PI,IP,001,34,11944,11946,6125,2,PERF
42479410750000,PI,IP,001,35,12038,12040,6125,2,PERF
42479410750000,PI,IP,001,36,12132,12134,6125,2,PERF
42479410750000,PI,IP,001,37,12230,12232,6125,2,PERF
42479410750000,PI,IP,001,38,12320,12322,6125,2,PERF
42479410750000,PI,IP,001,39,12424,12426,6125,2,PERF
42479410750000,PI,IP,001,40,12514,12516,6125,2,PERF
42479410750000,PI,IP,001,41,12610,12612,6125,2,PERF
42479410750000,PI,IP,001,42,12704,12706,6125,2,PERF
42479410750000,PI,IP,001,43,12798,12800,6125,2,PERF
42479410750000,PI,IP,001,44,12892,12894,6125,2,PERF
42479410750000,PI,IP,001,45,12990,12992,6125,2,PERF
42479410750000,PI,IP,001,46,13084,13086,6125,2,PERF
42479410750000,PI,IP,001,47,13176,13178,6125,2,PERF
42479410750000,PI,IP,001,48,13266,13268,6125,2,PERF
42479410750000,PI,IP,001,49,13372,13374,6125,2,PERF
42479410750000,PI,IP,001,50,13464,13466,6125,2,PERF
42479410750000,PI,IP,001,51,13558,13560,6125,2,PERF
42479410750000,PI,IP,001,52,13652,13654,6125,2,PERF
42479410750000,PI,IP,001,53,13750,13752,6125,2,PERF
42479410750000,PI,IP,001,54,13844,13846,6125,2,PERF
42479410750000,PI,IP,001,55,13938,13940,6125,2,PERF
42479410750000,PI,IP,001,56,14032,14034,6125,2,PERF
42479410750000,PI,IP,001,57,14130,14132,6125,2,PERF
42479410750000,PI,IP,001,58,14210,14212,6125,2,PERF
42479410750000,PI,IP,001,59,14290,14292,6125,2,PERF
42479410750000,PI,IP,001,60,14370,14372,6125,2,PERF
42479410760000,PI,IP,001,1,8445,14053,6228,5608,PERF
42479410770000,PI,IP,001,1,7234,12554,6115,5320,PERF
42479410780000,PI,IP,001,1,8432,13809,6380,5377,PERF
42479410800000,PI,IP,001,1,8544,12685,4932,4141,PERF
42479410900000,PI,IP,001,1,8330,13914,5938,5584,PERF
42479410930000,PI,IP,001,1,8479,13378,5675,4899,PERF
42479410940100,PI,IP,001,1,12543,16476,4595,3933,PERF
42479410960000,PI,IP,001,1,8394,13131,5531,4737,PERF
42479410970000,PI,IP,001,1,9518,14433,5642,4915,PERF
42479410980000,PI,IP,001,1,9578,14479,5597,4901,PERF
42479411020000,PI,PT,001,1,8216,14552,,6336,PERF
42479411030000,PI,IP,001,1,8629,14250,6228,5621,PERF
42479411040000,PI,IP,001,1,8309,14373,6901,6064,PERF
42479411050000,PI,IP,001,1,12224,15698,4500,3474,PERF
42479411070000,PI,IP,001,1,9772,14922,6460,5150,PERF
42479411080000,PI,IP,001,1,9515,14480,6297,4965,PERF
42479411100000,PI,IP,001,1,9483,14485,5906,5002,PERF
42479411130000,PI,IP,002,1,8445,14335,6139,5890,PERF
42479411130000,PI,PT,001,1,14180,14182,6139,2,PERF
42479411130000,PI,PT,001,2,14219,14221,6139,2,PERF
42479411130000,PI,PT,001,3,14258,14260,6139,2,PERF
42479411130000,PI,PT,001,4,14295,14297,6139,2,PERF
42479411130000,PI,PT,001,5,14333,14335,6139,2,PERF
42479411140000,PI,IP,001,1,8462,14326,5997,5864,PERF
42479411150000,PI,IP,001,1,12130,15952,4709,3822,PERF
42479411170000,PI,IP,001,1,8908,8910,6183,2,PERF
42479411170000,PI,IP,001,2,8997,8999,6183,2,PERF
42479411170000,PI,IP,001,3,9086,9088,6183,2,PERF
42479411170000,PI,IP,001,4,9175,9177,6183,2,PERF
42479411170000,PI,IP,001,5,9272,9274,6183,2,PERF
42479411170000,PI,IP,001,6,9360,9362,6183,2,PERF
42479411170000,PI,IP,001,7,9449,9451,6183,2,PERF
42479411170000,PI,IP,001,8,9538,9540,6183,2,PERF
42479411170000,PI,IP,001,9,9634,9636,6183,2,PERF
42479411170000,PI,IP,001,10,9723,9725,6183,2,PERF
42479411170000,PI,IP,001,11,9812,9814,6183,2,PERF
42479411170000,PI,IP,001,12,9901,9903,6183,2,PERF
42479411170000,PI,IP,001,13,9994,9996,6183,2,PERF
42479411170000,PI,IP,001,14,10090,10092,6183,2,PERF
42479411170000,PI,IP,001,15,10176,10178,6183,2,PERF
42479411170000,PI,IP,001,16,10264,10266,6183,2,PERF
42479411170000,PI,IP,001,17,10360,10362,6183,2,PERF
42479411170000,PI,IP,001,18,10449,10451,6183,2,PERF
42479411170000,PI,IP,001,19,10538,10540,6183,2,PERF
42479411170000,PI,IP,001,20,10627,10629,6183,2,PERF
42479411170000,PI,IP,001,21,10723,10725,6183,2,PERF
42479411170000,PI,IP,001,22,10812,10814,6183,2,PERF
42479411170000,PI,IP,001,23,10898,10900,6183,2,PERF
42479411170000,PI,IP,001,24,10994,10996,6183,2,PERF
42479411170000,PI,IP,001,25,11086,11088,6183,2,PERF
42479411170000,PI,IP,001,26,11175,11177,6183,2,PERF
42479411170000,PI,IP,001,27,11264,11266,6183,2,PERF
42479411170000,PI,IP,001,28,11353,11355,6183,2,PERF
42479411170000,PI,IP,001,29,11449,11451,6183,2,PERF
42479411170000,PI,IP,001,30,11536,11538,6183,2,PERF
42479411170000,PI,IP,001,31,11622,11624,6183,2,PERF
42479411170000,PI,IP,001,32,11710,11712,6183,2,PERF
42479411170000,PI,IP,001,33,11812,11814,6183,2,PERF
42479411170000,PI,IP,001,34,11901,11903,6183,2,PERF
42479411170000,PI,IP,001,35,11990,11992,6183,2,PERF
42479411170000,PI,IP,001,36,12079,12081,6183,2,PERF
42479411170000,PI,IP,001,37,12175,12177,6183,2,PERF
42479411170000,PI,IP,001,38,12262,12264,6183,2,PERF
42479411170000,PI,IP,001,39,12348,12350,6183,2,PERF
42479411170000,PI,IP,001,40,12434,12436,6183,2,PERF
42479411170000,PI,IP,001,41,12538,12540,6183,2,PERF
42479411170000,PI,IP,001,42,12627,12629,6183,2,PERF
42479411170000,PI,IP,001,43,12716,12718,6183,2,PERF
42479411170000,PI,IP,001,44,12805,12807,6183,2,PERF
42479411170000,PI,IP,001,45,12898,12900,6183,2,PERF
42479411170000,PI,IP,001,46,12994,12996,6183,2,PERF
42479411170000,PI,IP,001,47,13079,13081,6183,2,PERF
42479411170000,PI,IP,001,48,13168,13170,6183,2,PERF
42479411170000,PI,IP,001,49,13264,13266,6183,2,PERF
42479411170000,PI,IP,001,50,13353,13355,6183,2,PERF
42479411170000,PI,IP,001,51,13442,13444,6183,2,PERF
42479411170000,PI,IP,001,52,13531,13533,6183,2,PERF
42479411170000,PI,IP,001,53,13627,13629,6183,2,PERF
42479411170000,PI,IP,001,54,13716,13718,6183,2,PERF
42479411170000,PI,IP,001,55,13805,13807,6183,2,PERF
42479411170000,PI,IP,001,56,13894,13896,6183,2,PERF
42479411170000,PI,IP,001,57,13990,13992,6183,2,PERF
42479411170000,PI,IP,001,58,14065,14067,6183,2,PERF
42479411170000,PI,IP,001,59,14140,14142,6183,2,PERF
42479411170000,PI,IP,001,60,14215,14217,6183,2,PERF
42479411180000,PI,IP,001,1,9950,10200,5846,250,PERF
42479411180000,PI,IP,001,2,10250,10500,5846,250,PERF
42479411180000,PI,IP,001,3,10550,10800,5846,250,PERF
42479411180000,PI,IP,001,4,10850,11100,5846,250,PERF
42479411180000,PI,IP,001,5,11150,11400,5846,250,PERF
42479411180000,PI,IP,001,6,11450,11700,5846,250,PERF
42479411180000,PI,IP,001,7,11750,12000,5846,250,PERF
42479411180000,PI,IP,001,8,12050,12300,5846,250,PERF
42479411180000,PI,IP,001,9,12350,12600,5846,250,PERF
42479411180000,PI,IP,001,10,12650,12900,5846,250,PERF
42479411180000,PI,IP,001,11,12950,13200,5846,250,PERF
42479411180000,PI,IP,001,12,13250,13500,5846,250,PERF
42479411180000,PI,IP,001,13,13550,13800,5846,250,PERF
42479411180000,PI,IP,001,14,13850,14100,5846,250,PERF
42479411180000,PI,IP,001,15,14150,14400,5846,250,PERF
42479411180000,PI,IP,001,16,14450,14700,5846,250,PERF
42479411180000,PI,IP,001,17,14750,15000,5846,250,PERF
42479411180000,PI,IP,001,18,15050,15300,5846,250,PERF
42479411190000,PI,IP,001,1,9462,14612,6599,5150,PERF
42479411200000,PI,IP,001,1,9495,13560,5553,4065,PERF
42479411210000,PI,IP,001,1,7692,12719,6077,5027,PERF
42479411220000,PI,IP,001,1,7593,12620,6047,5027,PERF
42479411250100,PI,IP,001,1,10165,15559,6467,5394,PERF
42479411260000,PI,IP,001,1,10488,14232,4739,3744,PERF
42479411270000,PI,IP,001,1,9073,9075,6161,2,PERF
42479411270000,PI,IP,001,2,9159,9161,6161,2,PERF
42479411270000,PI,IP,001,3,9241,9243,6161,2,PERF
42479411270000,PI,IP,001,4,9323,9325,6161,2,PERF
42479411270000,PI,IP,001,5,9411,9413,6161,2,PERF
42479411270000,PI,IP,001,6,9493,9495,6161,2,PERF
42479411270000,PI,IP,001,7,9575,9577,6161,2,PERF
42479411270000,PI,IP,001,8,9657,9659,6161,2,PERF
42479411270000,PI,IP,001,9,9745,9747,6161,2,PERF
42479411270000,PI,IP,001,10,9827,9829,6161,2,PERF
42479411270000,PI,IP,001,11,9909,9911,6161,2,PERF
42479411270000,PI,IP,001,12,9991,9993,6161,2,PERF
42479411270000,PI,IP,001,13,10079,10081,6161,2,PERF
42479411270000,PI,IP,001,14,10162,10164,6161,2,PERF
42479411270000,PI,IP,001,15,10248,10250,6161,2,PERF
42479411270000,PI,IP,001,16,10325,10327,6161,2,PERF
42479411270000,PI,IP,001,17,10412,10414,6161,2,PERF
42479411270000,PI,IP,001,18,10495,10497,6161,2,PERF
42479411270000,PI,IP,001,19,10577,10579,6161,2,PERF
42479411270000,PI,IP,001,20,10659,10661,6161,2,PERF
42479411270000,PI,IP,001,21,10747,10749,6161,2,PERF
42479411270000,PI,IP,001,22,10829,10831,6161,2,PERF
42479411270000,PI,IP,001,23,10911,10913,6161,2,PERF
42479411270000,PI,IP,001,24,10993,10995,6161,2,PERF
42479411270000,PI,IP,001,25,11081,11083,6161,2,PERF
42479411270000,PI,IP,001,26,11163,11165,6161,2,PERF
42479411270000,PI,IP,001,27,11245,11247,6161,2,PERF
42479411270000,PI,IP,001,28,11327,11329,6161,2,PERF
42479411270000,PI,IP,001,29,11415,11417,6161,2,PERF
42479411270000,PI,IP,001,30,11497,11499,6161,2,PERF
42479411270000,PI,IP,001,31,11528,11584,6161,56,PERF
42479411270000,PI,IP,001,32,11659,11661,6161,2,PERF
42479411270000,PI,IP,001,33,11750,11752,6161,2,PERF
42479411270000,PI,IP,001,34,11828,11830,6161,2,PERF
42479411270000,PI,IP,001,35,11913,11915,6161,2,PERF
42479411270000,PI,IP,001,36,11995,11997,6161,2,PERF
42479411270000,PI,IP,001,37,12083,12085,6161,2,PERF
42479411270000,PI,IP,001,38,12165,12167,6161,2,PERF
42479411270000,PI,IP,001,39,12247,12249,6161,2,PERF
42479411270000,PI,IP,001,40,12329,12331,6161,2,PERF
42479411270000,PI,IP,001,41,12471,12473,6161,2,PERF
42479411270000,PI,IP,001,42,12499,12501,6161,2,PERF
42479411270000,PI,IP,001,43,12581,12583,6161,2,PERF
42479411270000,PI,IP,001,44,12663,12665,6161,2,PERF
42479411270000,PI,IP,001,45,12751,12753,6161,2,PERF
42479411270000,PI,IP,001,46,12826,12828,6161,2,PERF
42479411270000,PI,IP,001,47,12901,12903,6161,2,PERF
42479411270000,PI,IP,001,48,12976,12978,6161,2,PERF
42479411280000,PI,IP,001,1,8927,12704,4330,3777,PERF
42479411290000,PI,IP,001,1,9755,14303,5860,4548,PERF
42479411300000,PI,IP,001,1,9138,14091,5786,4953,PERF
42479411310000,PI,IP,001,1,9580,14132,5725,4552,PERF
42479411320000,PI,IP,001,1,9808,14622,6103,4814,PERF
42479411330000,PI,IP,001,1,9202,14303,6001,5101,PERF
42479411340000,PI,IP,001,1,10046,14562,5943,4516,PERF
42479411350000,PI,IP,001,1,8984,8986,5907,2,PERF
42479411350000,PI,IP,001,2,9059,9061,5907,2,PERF
42479411350000,PI,IP,001,3,9140,9142,5907,2,PERF
42479411350000,PI,IP,001,4,9221,9223,5907,2,PERF
42479411350000,PI,IP,001,5,9309,9311,5907,2,PERF
42479411350000,PI,IP,001,6,9390,9392,5907,2,PERF
42479411350000,PI,IP,001,7,9471,9473,5907,2,PERF
42479411350000,PI,IP,001,8,9552,9554,5907,2,PERF
42479411350000,PI,IP,001,9,9640,9642,5907,2,PERF
42479411350000,PI,IP,001,10,9721,9723,5907,2,PERF
42479411350000,PI,IP,001,11,9802,9804,5907,2,PERF
42479411350000,PI,IP,001,12,9884,9886,5907,2,PERF
42479411350000,PI,IP,001,13,9971,9973,5907,2,PERF
42479411350000,PI,IP,001,14,10054,10056,5907,2,PERF
42479411350000,PI,IP,001,15,10128,10130,5907,2,PERF
42479411350000,PI,IP,001,16,10210,10212,5907,2,PERF
42479411350000,PI,IP,001,17,10298,10300,5907,2,PERF
42479411350000,PI,IP,001,18,10383,10385,5907,2,PERF
42479411350000,PI,IP,001,19,10464,10466,5907,2,PERF
42479411350000,PI,IP,001,20,10545,10547,5907,2,PERF
42479411350000,PI,IP,001,21,10633,10635,5907,2,PERF
42479411350000,PI,IP,001,22,10714,10716,5907,2,PERF
42479411350000,PI,IP,001,23,10795,10797,5907,2,PERF
42479411350000,PI,IP,001,24,10876,10878,5907,2,PERF
42479411350000,PI,IP,001,25,10946,10966,5907,20,PERF
42479411350000,PI,IP,001,26,11045,11047,5907,2,PERF
42479411350000,PI,IP,001,27,11126,11128,5907,2,PERF
42479411350000,PI,IP,001,28,11211,11213,5907,2,PERF
42479411350000,PI,IP,001,29,11295,11297,5907,2,PERF
42479411350000,PI,IP,001,30,11378,11380,5907,2,PERF
42479411350000,PI,IP,001,31,11454,11456,5907,2,PERF
42479411350000,PI,IP,001,32,11538,11540,5907,2,PERF
42479411350000,PI,IP,001,33,11624,11626,5907,2,PERF
42479411350000,PI,IP,001,34,11707,11709,5907,2,PERF
42479411350000,PI,IP,001,35,11788,11790,5907,2,PERF
42479411350000,PI,IP,001,36,11869,11871,5907,2,PERF
42479411350000,PI,IP,001,37,11957,11959,5907,2,PERF
42479411350000,PI,IP,001,38,12038,12040,5907,2,PERF
42479411350000,PI,IP,001,39,12119,12121,5907,2,PERF
42479411350000,PI,IP,001,40,12200,12202,5907,2,PERF
42479411350000,PI,IP,001,41,12288,12290,5907,2,PERF
42479411350000,PI,IP,001,42,12369,12371,5907,2,PERF
42479411350000,PI,IP,001,43,12450,12452,5907,2,PERF
42479411350000,PI,IP,001,44,12531,12533,5907,2,PERF
42479411350000,PI,IP,001,45,12619,12621,5907,2,PERF
42479411350000,PI,IP,001,46,12704,12706,5907,2,PERF
42479411350000,PI,IP,001,47,12780,12782,5907,2,PERF
42479411350000,PI,IP,001,48,12862,12864,5907,2,PERF
42479411350000,PI,IP,001,49,12950,12952,5907,2,PERF
42479411350000,PI,IP,001,50,13031,13033,5907,2,PERF
42479411350000,PI,IP,001,51,13112,13114,5907,2,PERF
42479411350000,PI,IP,001,52,13193,13195,5907,2,PERF
42479411350000,PI,IP,001,53,13281,13283,5907,2,PERF
42479411350000,PI,IP,001,54,13362,13364,5907,2,PERF
42479411350000,PI,IP,001,55,13443,13445,5907,2,PERF
42479411350000,PI,IP,001,56,13524,13526,5907,2,PERF
42479411350000,PI,IP,001,57,13612,13614,5907,2,PERF
42479411350000,PI,IP,001,58,13683,13685,5907,2,PERF
42479411350000,PI,IP,001,59,13754,13756,5907,2,PERF
42479411350000,PI,IP,001,60,13825,13827,5907,2,PERF
42479411360000,PI,IP,001,1,8620,12899,4941,4279,PERF
42479411390000,PI,IP,001,1,11690,15672,4771,3982,PERF
42479411410000,PI,IP,001,1,11100,15772,4889,4672,PERF
42479411430100,PI,IP,001,1,10288,14523,5486,4235,PERF
42479411440100,PI,IP,001,1,9236,13907,6016,4671,PERF
42479411450100,PI,IP,001,1,11961,16599,5356,4638,PERF
42479411460000,PI,IP,001,1,8289,13605,5631,5316,PERF
42479411470000,PI,IP,001,1,8230,13123,5385,4893,PERF
42479411480000,PI,IP,001,1,8898,8900,5953,2,PERF
42479411480000,PI,IP,001,2,8983,8985,5953,2,PERF
42479411480000,PI,IP,001,3,9068,9070,5953,2,PERF
42479411480000,PI,IP,001,4,9155,9157,5953,2,PERF
42479411480000,PI,IP,001,5,9243,9245,5953,2,PERF
42479411480000,PI,IP,001,6,9328,9330,5953,2,PERF
42479411480000,PI,IP,001,7,9411,9413,5953,2,PERF
42479411480000,PI,IP,001,8,9500,9502,5953,2,PERF
42479411480000,PI,IP,001,9,9588,9590,5953,2,PERF
42479411480000,PI,IP,001,10,9673,9675,5953,2,PERF
42479411480000,PI,IP,001,11,9758,9760,5953,2,PERF
42479411480000,PI,IP,001,12,9845,9847,5953,2,PERF
42479411480000,PI,IP,001,13,9933,9935,5953,2,PERF
42479411480000,PI,IP,001,14,10018,10020,5953,2,PERF
42479411480000,PI,IP,001,15,10103,10105,5953,2,PERF
42479411480000,PI,IP,001,16,10184,10186,5953,2,PERF
42479411480000,PI,IP,001,17,10278,10280,5953,2,PERF
42479411480000,PI,IP,001,18,10363,10365,5953,2,PERF
42479411480000,PI,IP,001,19,10448,10450,5953,2,PERF
42479411480000,PI,IP,001,20,10533,10535,5953,2,PERF
42479411480000,PI,IP,001,21,10623,10625,5953,2,PERF
42479411480000,PI,IP,001,22,10708,10710,5953,2,PERF
42479411480000,PI,IP,001,23,10793,10795,5953,2,PERF
42479411480000,PI,IP,001,24,10872,10874,5953,2,PERF
42479411480000,PI,IP,001,25,10968,10970,5953,2,PERF
42479411480000,PI,IP,001,26,11053,11055,5953,2,PERF
42479411480000,PI,IP,001,27,11138,11140,5953,2,PERF
42479411480000,PI,IP,001,28,11223,11225,5953,2,PERF
42479411480000,PI,IP,001,29,11313,11315,5953,2,PERF
42479411480000,PI,IP,001,30,11398,11400,5953,2,PERF
42479411480000,PI,IP,001,31,11483,11485,5953,2,PERF
42479411480000,PI,IP,001,32,11568,11570,5953,2,PERF
42479411480000,PI,IP,001,33,11658,11660,5953,2,PERF
42479411480000,PI,IP,001,34,11743,11745,5953,2,PERF
42479411480000,PI,IP,001,35,11828,11830,5953,2,PERF
42479411480000,PI,IP,001,36,11913,11915,5953,2,PERF
42479411480000,PI,IP,001,37,12000,12002,5953,2,PERF
42479411480000,PI,IP,001,38,12088,12090,5953,2,PERF
42479411480000,PI,IP,001,39,12173,12175,5953,2,PERF
42479411480000,PI,IP,001,40,12258,12260,5953,2,PERF
42479411480000,PI,IP,001,41,12344,12346,5953,2,PERF
42479411480000,PI,IP,001,42,12433,12435,5953,2,PERF
42479411480000,PI,IP,001,43,12518,12520,5953,2,PERF
42479411480000,PI,IP,001,44,12603,12605,5953,2,PERF
42479411480000,PI,IP,001,45,12690,12692,5953,2,PERF
42479411480000,PI,IP,001,46,12778,12780,5953,2,PERF
42479411480000,PI,IP,001,47,12863,12865,5953,2,PERF
42479411480000,PI,IP,001,48,12948,12950,5953,2,PERF
42479411480000,PI,IP,001,49,13038,13040,5953,2,PERF
42479411480000,PI,IP,001,50,13123,13125,5953,2,PERF
42479411480000,PI,IP,001,51,13208,13210,5953,2,PERF
42479411480000,PI,IP,001,52,13293,13295,5953,2,PERF
42479411480000,PI,IP,001,53,13383,13385,5953,2,PERF
42479411480000,PI,IP,001,54,13468,13470,5953,2,PERF
42479411480000,PI,IP,001,55,13553,13555,5953,2,PERF
42479411480000,PI,IP,001,56,13638,13640,5953,2,PERF
42479411480000,PI,IP,001,57,13706,13708,5953,2,PERF
42479411480000,PI,IP,001,58,13785,13787,5953,2,PERF
42479411480000,PI,IP,001,59,13865,13867,5953,2,PERF
42479411480000,PI,IP,001,60,13944,13946,5953,2,PERF
42479411490000,PI,IP,001,1,8845,8847,6046,2,PERF
42479411490000,PI,IP,001,2,8938,8940,6046,2,PERF
42479411490000,PI,IP,001,3,9031,9033,6046,2,PERF
42479411490000,PI,IP,001,4,9124,9126,6046,2,PERF
42479411490000,PI,IP,001,5,9222,9224,6046,2,PERF
42479411490000,PI,IP,001,6,9315,9317,6046,2,PERF
42479411490000,PI,IP,001,7,9400,9402,6046,2,PERF
42479411490000,PI,IP,001,8,9501,9503,6046,2,PERF
42479411490000,PI,IP,001,9,9592,9594,6046,2,PERF
42479411490000,PI,IP,001,10,9629,9631,6046,2,PERF
42479411490000,PI,IP,001,11,9785,9787,6046,2,PERF
42479411490000,PI,IP,001,12,9880,9882,6046,2,PERF
42479411490000,PI,IP,001,13,9976,9978,6046,2,PERF
42479411490000,PI,IP,001,14,10070,10072,6046,2,PERF
42479411490000,PI,IP,001,15,10162,10164,6046,2,PERF
42479411490000,PI,IP,001,16,10253,10255,6046,2,PERF
42479411490000,PI,IP,001,17,10353,10355,6046,2,PERF
42479411490000,PI,IP,001,18,10450,10452,6046,2,PERF
42479411490000,PI,IP,001,19,10539,10541,6046,2,PERF
42479411490000,PI,IP,001,20,10628,10630,6046,2,PERF
42479411490000,PI,IP,001,21,10730,10732,6046,2,PERF
42479411490000,PI,IP,001,22,10816,10818,6046,2,PERF
42479411490000,PI,IP,001,23,10916,10918,6046,2,PERF
42479411490000,PI,IP,001,24,11002,11004,6046,2,PERF
42479411490000,PI,IP,001,25,11107,11109,6046,2,PERF
42479411490000,PI,IP,001,26,11198,11200,6046,2,PERF
42479411490000,PI,IP,001,27,11293,11295,6046,2,PERF
42479411490000,PI,IP,001,28,11386,11388,6046,2,PERF
42479411490000,PI,IP,001,29,11484,11486,6046,2,PERF
42479411490000,PI,IP,001,30,11577,11579,6046,2,PERF
42479411490000,PI,IP,001,31,11670,11672,6046,2,PERF
42479411490000,PI,IP,001,32,11763,11765,6046,2,PERF
42479411490000,PI,IP,001,33,11861,11863,6046,2,PERF
42479411490000,PI,IP,001,34,11954,11956,6046,2,PERF
42479411490000,PI,IP,001,35,12047,12049,6046,2,PERF
42479411490000,PI,IP,001,36,12140,12142,6046,2,PERF
42479411490000,PI,IP,001,37,12232,12234,6046,2,PERF
42479411490000,PI,IP,001,38,12331,12333,6046,2,PERF
42479411490000,PI,IP,001,39,12424,12426,6046,2,PERF
42479411490000,PI,IP,001,40,12517,12519,6046,2,PERF
42479411490000,PI,IP,001,41,12610,12612,6046,2,PERF
42479411490000,PI,IP,001,42,12710,12712,6046,2,PERF
42479411490000,PI,IP,001,43,12801,12803,6046,2,PERF
42479411490000,PI,IP,001,44,12894,12896,6046,2,PERF
42479411490000,PI,IP,001,45,12992,12994,6046,2,PERF
42479411490000,PI,IP,001,46,13085,13087,6046,2,PERF
42479411490000,PI,IP,001,47,13178,13180,6046,2,PERF
42479411490000,PI,IP,001,48,13271,13273,6046,2,PERF
42479411490000,PI,IP,001,49,13369,13371,6046,2,PERF
42479411490000,PI,IP,001,50,13462,13464,6046,2,PERF
42479411490000,PI,IP,001,51,13551,13553,6046,2,PERF
42479411490000,PI,IP,001,52,13652,13654,6046,2,PERF
42479411490000,PI,IP,001,53,13746,13748,6046,2,PERF
42479411490000,PI,IP,001,54,13839,13841,6046,2,PERF
42479411490000,PI,IP,001,55,13932,13934,6046,2,PERF
42479411490000,PI,IP,001,56,14025,14027,6046,2,PERF
42479411490000,PI,IP,001,57,14123,14125,6046,2,PERF
42479411490000,PI,IP,001,58,14198,14200,6046,2,PERF
42479411490000,PI,IP,001,59,14273,14275,6046,2,PERF
42479411490000,PI,IP,001,60,14348,14350,6046,2,PERF
42479411500000,PI,IP,001,1,9331,14307,5452,4976,PERF
42479411510000,PI,IP,001,1,11425,15872,4837,4447,PERF
42479411520000,PI,IP,001,1,10469,15982,6565,5513,PERF
42479411530000,PI,IP,001,1,9078,9080,6217,2,PERF
42479411530000,PI,IP,001,2,9161,9162,6217,1,PERF
42479411530000,PI,IP,001,3,9244,9246,6217,2,PERF
42479411530000,PI,IP,001,4,9410,9412,6217,2,PERF
42479411530000,PI,IP,001,5,9490,9492,6217,2,PERF
42479411530000,PI,IP,001,6,9573,9575,6217,2,PERF
42479411530000,PI,IP,001,7,9656,9658,6217,2,PERF
42479411530000,PI,IP,001,8,9736,9738,6217,2,PERF
42479411530000,PI,IP,001,9,9819,9821,6217,2,PERF
42479411530000,PI,IP,001,10,9904,9906,6217,2,PERF
42479411530000,PI,IP,001,11,9985,9987,6217,2,PERF
42479411530000,PI,IP,001,12,10065,10067,6217,2,PERF
42479411530000,PI,IP,001,13,10148,10150,6217,2,PERF
42479411530000,PI,IP,001,14,10231,10233,6217,2,PERF
42479411530000,PI,IP,001,15,10314,10316,6217,2,PERF
42479411530000,PI,IP,001,16,10400,10402,6217,2,PERF
42479411530000,PI,IP,001,17,10477,10479,6217,2,PERF
42479411530000,PI,IP,001,18,10560,10562,6217,2,PERF
42479411530000,PI,IP,001,19,10643,10645,6217,2,PERF
42479411530000,PI,IP,001,20,10723,10725,6217,2,PERF
42479411530000,PI,IP,001,21,10806,10808,6217,2,PERF
42479411530000,PI,IP,001,22,10892,10894,6217,2,PERF
42479411530000,PI,IP,001,23,10970,10972,6217,2,PERF
42479411530000,PI,IP,001,24,11052,11054,6217,2,PERF
42479411530000,PI,IP,001,25,11135,11137,6217,2,PERF
42479411530000,PI,IP,001,26,11218,11220,6217,2,PERF
42479411530000,PI,IP,001,27,11301,11303,6217,2,PERF
42479411530000,PI,IP,001,28,11386,11388,6217,2,PERF
42479411530000,PI,IP,001,29,11464,11466,6217,2,PERF
42479411530000,PI,IP,001,30,11547,11549,6217,2,PERF
42479411530000,PI,IP,001,31,11630,11632,6217,2,PERF
42479411530000,PI,IP,001,32,11710,11712,6217,2,PERF
42479411530000,PI,IP,001,33,11793,11795,6217,2,PERF
42479411530000,PI,IP,001,34,11880,11882,6217,2,PERF
42479411530000,PI,IP,001,35,11959,11961,6217,2,PERF
42479411530000,PI,IP,001,36,12039,12041,6217,2,PERF
42479411530000,PI,IP,001,37,12122,12124,6217,2,PERF
42479411530000,PI,IP,001,38,12250,12270,6217,20,PERF
42479411530000,PI,IP,001,39,12288,12290,6217,2,PERF
42479411530000,PI,IP,001,40,12372,12374,6217,2,PERF
42479411530000,PI,IP,001,41,12451,12453,6217,2,PERF
42479411530000,PI,IP,001,42,12534,12536,6217,2,PERF
42479411530000,PI,IP,001,43,12617,12619,6217,2,PERF
42479411530000,PI,IP,001,44,12697,12699,6217,2,PERF
42479411530000,PI,IP,001,45,12780,12782,6217,2,PERF
42479411530000,PI,IP,001,46,12856,12858,6217,2,PERF
42479411530000,PI,IP,001,47,12946,12948,6217,2,PERF
42479411530000,PI,IP,001,48,13026,13028,6217,2,PERF
42479411530000,PI,IP,001,49,13109,13111,6217,2,PERF
42479411530000,PI,IP,001,50,13192,13194,6217,2,PERF
42479411530000,PI,IP,001,51,13273,13275,6217,2,PERF
42479411530000,PI,IP,001,52,13355,13357,6217,2,PERF
42479411530000,PI,IP,001,53,13438,13440,6217,2,PERF
42479411530000,PI,IP,001,54,13521,13523,6217,2,PERF
42479411530000,PI,IP,001,55,13604,13606,6217,2,PERF
42479411530000,PI,IP,001,56,13684,13686,6217,2,PERF
42479411530000,PI,IP,001,57,13759,13761,6217,2,PERF
42479411530000,PI,IP,001,58,13834,13836,6217,2,PERF
42479411530000,PI,IP,001,59,13909,13911,6217,2,PERF
42479411540000,PI,IP,001,1,8985,8987,6128,2,PERF
42479411540000,PI,IP,001,2,9066,9068,6128,2,PERF
42479411540000,PI,IP,001,3,9147,9149,6128,2,PERF
42479411540000,PI,IP,001,4,9228,9230,6128,2,PERF
42479411540000,PI,IP,001,5,9313,9315,6128,2,PERF
42479411540000,PI,IP,001,6,9394,9396,6128,2,PERF
42479411540000,PI,IP,001,7,9475,9477,6128,2,PERF
42479411540000,PI,IP,001,8,9556,9558,6128,2,PERF
42479411540000,PI,IP,001,9,9641,9643,6128,2,PERF
42479411540000,PI,IP,001,10,9722,9724,6128,2,PERF
42479411540000,PI,IP,001,11,9803,9805,6128,2,PERF
42479411540000,PI,IP,001,12,9882,9884,6128,2,PERF
42479411540000,PI,IP,001,13,9969,9971,6128,2,PERF
42479411540000,PI,IP,001,14,10050,10052,6128,2,PERF
42479411540000,PI,IP,001,15,10131,10133,6128,2,PERF
42479411540000,PI,IP,001,16,10212,10214,6128,2,PERF
42479411540000,PI,IP,001,17,10300,10302,6128,2,PERF
42479411540000,PI,IP,001,18,10378,10380,6128,2,PERF
42479411540000,PI,IP,001,19,10459,10461,6128,2,PERF
42479411540000,PI,IP,001,20,10540,10542,6128,2,PERF
42479411540000,PI,IP,001,21,10625,10627,6128,2,PERF
42479411540000,PI,IP,001,22,10708,10710,6128,2,PERF
42479411540000,PI,IP,001,23,10787,10789,6128,2,PERF
42479411540000,PI,IP,001,24,10868,10870,6128,2,PERF
42479411540000,PI,IP,001,25,10953,10955,6128,2,PERF
42479411540000,PI,IP,001,26,11034,11036,6128,2,PERF
42479411540000,PI,IP,001,27,11115,11117,6128,2,PERF
42479411540000,PI,IP,001,28,11192,11194,6128,2,PERF
42479411540000,PI,IP,001,29,11281,11283,6128,2,PERF
42479411540000,PI,IP,001,30,11362,11364,6128,2,PERF
42479411540000,PI,IP,001,31,11443,11445,6128,2,PERF
42479411540000,PI,IP,001,32,11524,11526,6128,2,PERF
42479411540000,PI,IP,001,33,11610,11612,6128,2,PERF
42479411540000,PI,IP,001,34,11684,11686,6128,2,PERF
42479411540000,PI,IP,001,35,11771,11773,6128,2,PERF
42479411540000,PI,IP,001,36,11852,11854,6128,2,PERF
42479411540000,PI,IP,001,37,11937,11939,6128,2,PERF
42479411540000,PI,IP,001,38,12018,12020,6128,2,PERF
42479411540000,PI,IP,001,39,12100,12102,6128,2,PERF
42479411540000,PI,IP,001,40,12180,12182,6128,2,PERF
42479411540000,PI,IP,001,41,12265,12267,6128,2,PERF
42479411540000,PI,IP,001,42,12346,12348,6128,2,PERF
42479411540000,PI,IP,001,43,12427,12429,6128,2,PERF
42479411540000,PI,IP,001,44,12508,12510,6128,2,PERF
42479411540000,PI,IP,001,45,12593,12595,6128,2,PERF
42479411540000,PI,IP,001,46,12674,12676,6128,2,PERF
42479411540000,PI,IP,001,47,12755,12757,6128,2,PERF
42479411540000,PI,IP,001,48,12836,12838,6128,2,PERF
42479411540000,PI,IP,001,49,12920,12922,6128,2,PERF
42479411540000,PI,IP,001,50,12995,12997,6128,2,PERF
42479411540000,PI,IP,001,51,13070,13072,6128,2,PERF
42479411540000,PI,IP,001,52,13145,13147,6128,2,PERF
42479411550000,PI,IP,001,1,8977,8979,6074,2,PERF
42479411550000,PI,IP,001,2,9064,9066,6074,2,PERF
42479411550000,PI,IP,001,3,9151,9153,6074,2,PERF
42479411550000,PI,IP,001,4,9238,9240,6074,2,PERF
42479411550000,PI,IP,001,5,9330,9332,6074,2,PERF
42479411550000,PI,IP,001,6,9417,9419,6074,2,PERF
42479411550000,PI,IP,001,7,9504,9506,6074,2,PERF
42479411550000,PI,IP,001,8,9591,9593,6074,2,PERF
42479411550000,PI,IP,001,9,9683,9685,6074,2,PERF
42479411550000,PI,IP,001,10,9770,9772,6074,2,PERF
42479411550000,PI,IP,001,11,9857,9859,6074,2,PERF
42479411550000,PI,IP,001,12,9946,9948,6074,2,PERF
42479411550000,PI,IP,001,13,10036,10038,6074,2,PERF
42479411550000,PI,IP,001,14,10124,10126,6074,2,PERF
42479411550000,PI,IP,001,15,10204,10206,6074,2,PERF
42479411550000,PI,IP,001,16,10294,10296,6074,2,PERF
42479411550000,PI,IP,001,17,10386,10388,6074,2,PERF
42479411550000,PI,IP,001,18,10476,10478,6074,2,PERF
42479411550000,PI,IP,001,19,10563,10565,6074,2,PERF
42479411550000,PI,IP,001,20,10650,10652,6074,2,PERF
42479411550000,PI,IP,001,21,10742,10744,6074,2,PERF
42479411550000,PI,IP,001,22,10829,10831,6074,2,PERF
42479411550000,PI,IP,001,23,10916,10918,6074,2,PERF
42479411550000,PI,IP,001,24,11003,11005,6074,2,PERF
42479411550000,PI,IP,001,25,11095,11097,6074,2,PERF
42479411550000,PI,IP,001,26,11182,11184,6074,2,PERF
42479411550000,PI,IP,001,27,11269,11271,6074,2,PERF
42479411550000,PI,IP,001,28,11356,11358,6074,2,PERF
42479411550000,PI,IP,001,29,11448,11450,6074,2,PERF
42479411550000,PI,IP,001,30,11535,11537,6074,2,PERF
42479411550000,PI,IP,001,31,11622,11624,6074,2,PERF
42479411550000,PI,IP,001,32,11709,11711,6074,2,PERF
42479411550000,PI,IP,001,33,11801,11803,6074,2,PERF
42479411550000,PI,IP,001,34,11888,11890,6074,2,PERF
42479411550000,PI,IP,001,35,11975,11977,6074,2,PERF
42479411550000,PI,IP,001,36,12062,12064,6074,2,PERF
42479411550000,PI,IP,001,37,12154,12156,6074,2,PERF
42479411550000,PI,IP,001,38,12241,12243,6074,2,PERF
42479411550000,PI,IP,001,39,12328,12330,6074,2,PERF
42479411550000,PI,IP,001,40,12417,12419,6074,2,PERF
42479411550000,PI,IP,001,41,12507,12509,6074,2,PERF
42479411550000,PI,IP,001,42,12598,12600,6074,2,PERF
42479411550000,PI,IP,001,43,12676,12678,6074,2,PERF
42479411550000,PI,IP,001,44,12766,12768,6074,2,PERF
42479411550000,PI,IP,001,45,12856,12858,6074,2,PERF
42479411550000,PI,IP,001,46,12945,12947,6074,2,PERF
42479411550000,PI,IP,001,47,13034,13036,6074,2,PERF
42479411550000,PI,IP,001,48,13121,13123,6074,2,PERF
42479411550000,PI,IP,001,49,13213,13215,6074,2,PERF
42479411550000,PI,IP,001,50,13300,13302,6074,2,PERF
42479411550000,PI,IP,001,51,13387,13389,6074,2,PERF
42479411550000,PI,IP,001,52,13474,13476,6074,2,PERF
42479411550000,PI,IP,001,53,13566,13568,6074,2,PERF
42479411550000,PI,IP,001,54,13653,13655,6074,2,PERF
42479411550000,PI,IP,001,55,13740,13742,6074,2,PERF
42479411550000,PI,IP,001,56,13827,13829,6074,2,PERF
42479411550000,PI,IP,001,57,13919,13921,6074,2,PERF
42479411550000,PI,IP,001,58,13994,13996,6074,2,PERF
42479411550000,PI,IP,001,59,14069,14071,6074,2,PERF
42479411550000,PI,IP,001,60,14139,14141,6074,2,PERF
42479411560000,PI,IP,001,1,11516,15147,4161,3631,PERF
42479411570000,PI,IP,001,1,12275,15897,4402,3622,PERF
42479411630000,PI,IP,001,1,9175,9432,6081,257,PERF
42479411630000,PI,IP,001,2,9526,9792,6081,266,PERF
42479411630000,PI,IP,001,3,9881,10145,6081,264,PERF
42479411630000,PI,IP,001,4,10234,10500,6081,266,PERF
42479411630000,PI,IP,001,5,10587,10851,6081,264,PERF
42479411630000,PI,IP,001,6,10940,11204,6081,264,PERF
42479411630000,PI,IP,001,7,11293,11511,6081,218,PERF
42479411630000,PI,IP,001,8,11650,11910,6081,260,PERF
42479411630000,PI,IP,001,9,11999,12263,6081,264,PERF
42479411630000,PI,IP,001,10,12352,12616,6081,264,PERF
42479411630000,PI,IP,001,11,12705,12969,6081,264,PERF
42479411630000,PI,IP,001,12,13058,13326,6081,268,PERF
42479411630000,PI,IP,001,13,13496,13760,6081,264,PERF
42479411630000,PI,IP,001,14,13764,14028,6081,264,PERF
42479411630000,PI,IP,001,15,14116,14341,6081,225,PERF
42479411640000,PI,IP,001,1,9465,9697,6045,232,PERF
42479411640000,PI,IP,001,2,9780,10012,6045,232,PERF
42479411640000,PI,IP,001,3,10095,10327,6045,232,PERF
42479411640000,PI,IP,001,4,10410,10642,6045,232,PERF
42479411640000,PI,IP,001,5,10725,10957,6045,232,PERF
42479411640000,PI,IP,001,6,11040,11272,6045,232,PERF
42479411640000,PI,IP,001,7,11355,11587,6045,232,PERF
42479411640000,PI,IP,001,8,11670,11902,6045,232,PERF
42479411640000,PI,IP,001,9,11985,12217,6045,232,PERF
42479411640000,PI,IP,001,10,12300,12526,6045,226,PERF
42479411640000,PI,IP,001,11,12693,12842,6045,149,PERF
42479411640000,PI,IP,001,12,12928,13156,6045,228,PERF
42479411640000,PI,IP,001,13,13243,13481,6045,238,PERF
42479411640000,PI,IP,001,14,13558,13792,6045,234,PERF
42479411640000,PI,IP,001,15,13874,14099,6045,225,PERF
42479411650000,PI,IP,001,1,9738,14653,6344,4915,PERF
42479411660000,PI,IP,001,1,9035,9037,6139,2,PERF
42479411660000,PI,IP,001,2,9121,9123,6139,2,PERF
42479411660000,PI,IP,001,3,9207,9209,6139,2,PERF
42479411660000,PI,IP,001,4,9293,9295,6139,2,PERF
42479411660000,PI,IP,001,5,9391,9393,6139,2,PERF
42479411660000,PI,IP,001,6,9477,9479,6139,2,PERF
42479411660000,PI,IP,001,7,9563,9565,6139,2,PERF
42479411660000,PI,IP,001,8,9649,9651,6139,2,PERF
42479411660000,PI,IP,001,9,9747,9749,6139,2,PERF
42479411660000,PI,IP,001,10,9833,9835,6139,2,PERF
42479411660000,PI,IP,001,11,9919,9921,6139,2,PERF
42479411660000,PI,IP,001,12,10005,10007,6139,2,PERF
42479411660000,PI,IP,001,13,10103,10105,6139,2,PERF
42479411660000,PI,IP,001,14,10189,10191,6139,2,PERF
42479411660000,PI,IP,001,15,10275,10277,6139,2,PERF
42479411660000,PI,IP,001,16,10361,10363,6139,2,PERF
42479411660000,PI,IP,001,17,10459,10461,6139,2,PERF
42479411660000,PI,IP,001,18,10545,10547,6139,2,PERF
42479411660000,PI,IP,001,19,10634,10636,6139,2,PERF
42479411660000,PI,IP,001,20,10714,10716,6139,2,PERF
42479411660000,PI,IP,001,21,10816,10818,6139,2,PERF
42479411660000,PI,IP,001,22,10904,10906,6139,2,PERF
42479411660000,PI,IP,001,23,10986,10988,6139,2,PERF
42479411660000,PI,IP,001,24,11073,11075,6139,2,PERF
42479411660000,PI,IP,001,25,11171,11173,6139,2,PERF
42479411660000,PI,IP,001,26,11254,11256,6139,2,PERF
42479411660000,PI,IP,001,27,11343,11345,6139,2,PERF
42479411660000,PI,IP,001,28,11429,11431,6139,2,PERF
42479411660000,PI,IP,001,29,11526,11528,6139,2,PERF
42479411660000,PI,IP,001,30,11613,11615,6139,2,PERF
42479411660000,PI,IP,001,31,11699,11701,6139,2,PERF
42479411660000,PI,IP,001,32,11785,11787,6139,2,PERF
42479411660000,PI,IP,001,33,11883,11885,6139,2,PERF
42479411660000,PI,IP,001,34,11969,11971,6139,2,PERF
42479411660000,PI,IP,001,35,12055,12057,6139,2,PERF
42479411660000,PI,IP,001,36,12141,12143,6139,2,PERF
42479411660000,PI,IP,001,37,12239,12241,6139,2,PERF
42479411660000,PI,IP,001,38,12325,12327,6139,2,PERF
42479411660000,PI,IP,001,39,12411,12413,6139,2,PERF
42479411660000,PI,IP,001,40,12497,12499,6139,2,PERF
42479411660000,PI,IP,001,41,12595,12597,6139,2,PERF
42479411660000,PI,IP,001,42,12681,12683,6139,2,PERF
42479411660000,PI,IP,001,43,12767,12769,6139,2,PERF
42479411660000,PI,IP,001,44,12854,12856,6139,2,PERF
42479411660000,PI,IP,001,45,12951,12953,6139,2,PERF
42479411660000,PI,IP,001,46,13037,13039,6139,2,PERF
42479411660000,PI,IP,001,47,13126,13128,6139,2,PERF
42479411660000,PI,IP,001,48,13204,13206,6139,2,PERF
42479411660000,PI,IP,001,49,13307,13309,6139,2,PERF
42479411660000,PI,IP,001,50,13398,13400,6139,2,PERF
42479411660000,PI,IP,001,51,13479,13481,6139,2,PERF
42479411660000,PI,IP,001,52,13565,13567,6139,2,PERF
42479411660000,PI,IP,001,53,13663,13665,6139,2,PERF
42479411660000,PI,IP,001,54,13749,13751,6139,2,PERF
42479411660000,PI,IP,001,55,13835,13837,6139,2,PERF
42479411660000,PI,IP,001,56,13921,13923,6139,2,PERF
42479411660000,PI,IP,001,57,14019,14021,6139,2,PERF
42479411660000,PI,IP,001,58,14094,14096,6139,2,PERF
42479411660000,PI,IP,001,59,14169,14171,6139,2,PERF
42479411660000,PI,IP,001,60,14244,14246,6139,2,PERF
42479411680000,PI,IP,001,1,9823,14267,6437,4444,PERF
42479411690000,PI,IP,001,1,9818,15032,6621,5214,PERF
42479411700000,PI,IP,001,1,10966,11176,4988,210,PERF
42479411700000,PI,IP,001,2,11276,11486,4988,210,PERF
42479411700000,PI,IP,001,3,11586,11790,4988,204,PERF
42479411700000,PI,IP,001,4,11896,12106,4988,210,PERF
42479411700000,PI,IP,001,5,12206,12416,4988,210,PERF
42479411700000,PI,IP,001,6,12516,12726,4988,210,PERF
42479411700000,PI,IP,001,7,12826,13036,4988,210,PERF
42479411700000,PI,IP,001,8,13136,13346,4988,210,PERF
42479411700000,PI,IP,001,9,13446,13656,4988,210,PERF
42479411700000,PI,IP,001,10,13756,13966,4988,210,PERF
42479411700000,PI,IP,001,11,14066,14276,4988,210,PERF
42479411700000,PI,IP,001,12,14376,14586,4988,210,PERF
42479411700000,PI,IP,001,13,14686,14896,4988,210,PERF
42479411700000,PI,IP,001,14,14996,15206,4988,210,PERF
42479411700000,PI,IP,001,15,15310,15485,4988,175,PERF
42479411720000,PI,IP,001,1,7444,12734,6346,5290,PERF
42479411750000,PI,IP,001,1,10041,14466,4842,4425,PERF
42479411760000,PI,IP,001,1,9064,9066,6082,2,PERF
42479411760000,PI,IP,001,2,9192,9194,6082,2,PERF
42479411760000,PI,IP,001,3,9279,9281,6082,2,PERF
42479411760000,PI,IP,001,4,9366,9368,6082,2,PERF
42479411760000,PI,IP,001,5,9453,9455,6082,2,PERF
42479411760000,PI,IP,001,6,9540,9542,6082,2,PERF
42479411760000,PI,IP,001,7,9630,9632,6082,2,PERF
42479411760000,PI,IP,001,8,9712,9714,6082,2,PERF
42479411760000,PI,IP,001,9,9800,9802,6082,2,PERF
42479411760000,PI,IP,001,10,9887,9889,6082,2,PERF
42479411760000,PI,IP,001,11,9974,9976,6082,2,PERF
42479411760000,PI,IP,001,12,10061,10063,6082,2,PERF
42479411760000,PI,IP,001,13,10148,10150,6082,2,PERF
42479411760000,PI,IP,001,14,10235,10237,6082,2,PERF
42479411760000,PI,IP,001,15,10322,10324,6082,2,PERF
42479411760000,PI,IP,001,16,10408,10410,6082,2,PERF
42479411760000,PI,IP,001,17,10498,10500,6082,2,PERF
42479411760000,PI,IP,001,18,10576,10578,6082,2,PERF
42479411760000,PI,IP,001,19,10668,10670,6082,2,PERF
42479411760000,PI,IP,001,20,10756,10758,6082,2,PERF
42479411760000,PI,IP,001,21,10843,10845,6082,2,PERF
42479411760000,PI,IP,001,22,10930,10932,6082,2,PERF
42479411760000,PI,IP,001,23,11016,11018,6082,2,PERF
42479411760000,PI,IP,001,24,11103,11105,6082,2,PERF
42479411760000,PI,IP,001,25,11190,11192,6082,2,PERF
42479411760000,PI,IP,001,26,11277,11279,6082,2,PERF
42479411760000,PI,IP,001,27,11364,11366,6082,2,PERF
42479411760000,PI,IP,001,28,11452,11454,6082,2,PERF
42479411760000,PI,IP,001,29,11532,11534,6082,2,PERF
42479411760000,PI,IP,001,30,11624,11626,6082,2,PERF
42479411760000,PI,IP,001,31,11711,11713,6082,2,PERF
42479411760000,PI,IP,001,32,11798,11800,6082,2,PERF
42479411760000,PI,IP,001,33,11885,11887,6082,2,PERF
42479411760000,PI,IP,001,34,11972,11974,6082,2,PERF
42479411760000,PI,IP,001,35,12059,12061,6082,2,PERF
42479411760000,PI,IP,001,36,12146,12148,6082,2,PERF
42479411760000,PI,IP,001,37,12233,12235,6082,2,PERF
42479411760000,PI,IP,001,38,12320,12322,6082,2,PERF
42479411760000,PI,IP,001,39,12408,12410,6082,2,PERF
42479411760000,PI,IP,001,40,12496,12498,6082,2,PERF
42479411760000,PI,IP,001,41,12578,12580,6082,2,PERF
42479411760000,PI,IP,001,42,12667,12669,6082,2,PERF
42479411760000,PI,IP,001,43,12754,12756,6082,2,PERF
42479411760000,PI,IP,001,44,12841,12843,6082,2,PERF
42479411760000,PI,IP,001,45,12928,12930,6082,2,PERF
42479411760000,PI,IP,001,46,13014,13016,6082,2,PERF
42479411760000,PI,IP,001,47,13101,13103,6082,2,PERF
42479411760000,PI,IP,001,48,13188,13190,6082,2,PERF
42479411760000,PI,IP,001,49,13275,13277,6082,2,PERF
42479411760000,PI,IP,001,50,13362,13364,6082,2,PERF
42479411760000,PI,IP,001,51,13453,13455,6082,2,PERF
42479411760000,PI,IP,001,52,13531,13533,6082,2,PERF
42479411760000,PI,IP,001,53,13709,13711,6082,2,PERF
42479411760000,PI,IP,001,54,13587,13589,6082,2,PERF
42479411760000,PI,IP,001,55,13796,13798,6082,2,PERF
42479411760000,PI,IP,001,56,13883,13885,6082,2,PERF
42479411760000,PI,IP,001,57,13970,13972,6082,2,PERF
42479411760000,PI,IP,001,58,14040,14042,6082,2,PERF
42479411760000,PI,IP,001,59,14115,14117,6082,2,PERF
42479411760000,PI,IP,001,60,14190,14192,6082,2,PERF
42479411770000,PI,IP,001,1,8978,8980,6023,2,PERF
42479411770000,PI,IP,001,2,9100,9102,6023,2,PERF
42479411770000,PI,IP,001,3,9187,9189,6023,2,PERF
42479411770000,PI,IP,001,4,9278,9280,6023,2,PERF
42479411770000,PI,IP,001,5,9356,9358,6023,2,PERF
42479411770000,PI,IP,001,6,9447,9449,6023,2,PERF
42479411770000,PI,IP,001,7,9533,9535,6023,2,PERF
42479411770000,PI,IP,001,8,9602,9622,6023,20,PERF
42479411770000,PI,IP,001,9,9707,9709,6023,2,PERF
42479411770000,PI,IP,001,10,9793,9795,6023,2,PERF
42479411770000,PI,IP,001,11,9880,9882,6023,2,PERF
42479411770000,PI,IP,001,12,9967,9969,6023,2,PERF
42479411770000,PI,IP,001,13,10053,10055,6023,2,PERF
42479411770000,PI,IP,001,14,10142,10144,6023,2,PERF
42479411770000,PI,IP,001,15,10232,10234,6023,2,PERF
42479411770000,PI,IP,001,16,10310,10312,6023,2,PERF
42479411770000,PI,IP,001,17,10400,10402,6023,2,PERF
42479411770000,PI,IP,001,18,10486,10488,6023,2,PERF
42479411770000,PI,IP,001,19,10573,10575,6023,2,PERF
42479411770000,PI,IP,001,20,10660,10662,6023,2,PERF
42479411770000,PI,IP,001,21,10746,10748,6023,2,PERF
42479411770000,PI,IP,001,22,10833,10835,6023,2,PERF
42479411770000,PI,IP,001,23,10920,10922,6023,2,PERF
42479411770000,PI,IP,001,24,11006,11008,6023,2,PERF
42479411770000,PI,IP,001,25,11095,11097,6023,2,PERF
42479411770000,PI,IP,001,26,11175,11177,6023,2,PERF
42479411770000,PI,IP,001,27,11266,11268,6023,2,PERF
42479411770000,PI,IP,001,28,11353,11355,6023,2,PERF
42479411770000,PI,IP,001,29,11439,11441,6023,2,PERF
42479411770000,PI,IP,001,30,11526,11528,6023,2,PERF
42479411770000,PI,IP,001,31,11613,11615,6023,2,PERF
42479411770000,PI,IP,001,32,11699,11701,6023,2,PERF
42479411770000,PI,IP,001,33,11800,11802,6023,2,PERF
42479411770000,PI,IP,001,34,11830,11832,6023,2,PERF
42479411770000,PI,IP,001,35,11916,11918,6023,2,PERF
42479411770000,PI,IP,001,36,12008,12010,6023,2,PERF
42479411770000,PI,IP,001,37,12128,12130,6023,2,PERF
42479411770000,PI,IP,001,38,12219,12221,6023,2,PERF
42479411770000,PI,IP,001,39,12310,12312,6023,2,PERF
42479411770000,PI,IP,001,40,12392,12394,6023,2,PERF
42479411770000,PI,IP,001,41,12479,12481,6023,2,PERF
42479411770000,PI,IP,001,42,12566,12568,6023,2,PERF
42479411770000,PI,IP,001,43,12652,12654,6023,2,PERF
42479411770000,PI,IP,001,44,12739,12741,6023,2,PERF
42479411770000,PI,IP,001,45,12825,12827,6023,2,PERF
42479411770000,PI,IP,001,46,12915,12917,6023,2,PERF
42479411770000,PI,IP,001,47,13004,13006,6023,2,PERF
42479411770000,PI,IP,001,48,13081,13083,6023,2,PERF
42479411770000,PI,IP,001,49,13172,13174,6023,2,PERF
42479411770000,PI,IP,001,50,13259,13261,6023,2,PERF
42479411770000,PI,IP,001,51,13345,13347,6023,2,PERF
42479411770000,PI,IP,001,52,13432,13434,6023,2,PERF
42479411770000,PI,IP,001,53,13518,13520,6023,2,PERF
42479411770000,PI,IP,001,54,13605,13607,6023,2,PERF
42479411770000,PI,IP,001,55,13692,13694,6023,2,PERF
42479411770000,PI,IP,001,56,13778,13780,6023,2,PERF
42479411770000,PI,IP,001,57,13865,13867,6023,2,PERF
42479411770000,PI,IP,001,58,13940,13942,6023,2,PERF
42479411770000,PI,IP,001,59,14015,14017,6023,2,PERF
42479411770000,PI,IP,001,60,14090,14092,6023,2,PERF
42479411780000,PI,IP,001,1,9074,9076,6100,2,PERF
42479411780000,PI,IP,001,2,9204,9206,6100,2,PERF
42479411780000,PI,IP,001,3,9292,9294,6100,2,PERF
42479411780000,PI,IP,001,4,9381,9383,6100,2,PERF
42479411780000,PI,IP,001,5,9469,9471,6100,2,PERF
42479411780000,PI,IP,001,6,9558,9560,6100,2,PERF
42479411780000,PI,IP,001,7,9646,9648,6100,2,PERF
42479411780000,PI,IP,001,8,9738,9740,6100,2,PERF
42479411780000,PI,IP,001,9,9816,9818,6100,2,PERF
42479411780000,PI,IP,001,10,9908,9910,6100,2,PERF
42479411780000,PI,IP,001,11,9996,9998,6100,2,PERF
42479411780000,PI,IP,001,12,10089,10091,6100,2,PERF
42479411780000,PI,IP,001,13,10177,10179,6100,2,PERF
42479411780000,PI,IP,001,14,10265,10267,6100,2,PERF
42479411780000,PI,IP,001,15,10354,10356,6100,2,PERF
42479411780000,PI,IP,001,16,10442,10444,6100,2,PERF
42479411780000,PI,IP,001,17,10531,10533,6100,2,PERF
42479411780000,PI,IP,001,18,10619,10621,6100,2,PERF
42479411780000,PI,IP,001,19,10708,10710,6100,2,PERF
42479411780000,PI,IP,001,20,10796,10798,6100,2,PERF
42479411780000,PI,IP,001,21,10885,10887,6100,2,PERF
42479411780000,PI,IP,001,22,10973,10975,6100,2,PERF
42479411780000,PI,IP,001,23,11062,11064,6100,2,PERF
42479411780000,PI,IP,001,24,11150,11152,6100,2,PERF
42479411780000,PI,IP,001,25,11239,11241,6100,2,PERF
42479411780000,PI,IP,001,26,11328,11330,6100,2,PERF
42479411780000,PI,IP,001,27,11418,11420,6100,2,PERF
42479411780000,PI,IP,001,28,11500,11502,6100,2,PERF
42479411780000,PI,IP,001,29,11589,11591,6100,2,PERF
42479411780000,PI,IP,001,30,11681,11683,6100,2,PERF
42479411780000,PI,IP,001,31,11770,11772,6100,2,PERF
42479411780000,PI,IP,001,32,11858,11860,6100,2,PERF
42479411780000,PI,IP,001,33,11947,11949,6100,2,PERF
42479411780000,PI,IP,001,34,12035,12037,6100,2,PERF
42479411780000,PI,IP,001,35,12124,12126,6100,2,PERF
42479411780000,PI,IP,001,36,12212,12214,6100,2,PERF
42479411780000,PI,IP,001,37,12300,12302,6100,2,PERF
42479411780000,PI,IP,001,38,12389,12391,6100,2,PERF
42479411780000,PI,IP,001,39,12477,12479,6100,2,PERF
42479411780000,PI,IP,001,40,12566,12568,6100,2,PERF
42479411780000,PI,IP,001,41,12654,12656,6100,2,PERF
42479411780000,PI,IP,001,42,12743,12745,6100,2,PERF
42479411780000,PI,IP,001,43,12831,12833,6100,2,PERF
42479411780000,PI,IP,001,44,12920,12922,6100,2,PERF
42479411780000,PI,IP,001,45,13008,13010,6100,2,PERF
42479411780000,PI,IP,001,46,13097,13099,6100,2,PERF
42479411780000,PI,IP,001,47,13187,13189,6100,2,PERF
42479411780000,PI,IP,001,48,13277,13279,6100,2,PERF
42479411780000,PI,IP,001,49,13358,13360,6100,2,PERF
42479411780000,PI,IP,001,50,13449,13451,6100,2,PERF
42479411780000,PI,IP,001,51,13539,13541,6100,2,PERF
42479411780000,PI,IP,001,52,13628,13630,6100,2,PERF
42479411780000,PI,IP,001,53,13716,13718,6100,2,PERF
42479411780000,PI,IP,001,54,13805,13807,6100,2,PERF
42479411780000,PI,IP,001,55,13893,13895,6100,2,PERF
42479411780000,PI,IP,001,56,13982,13984,6100,2,PERF
42479411780000,PI,IP,001,57,14070,14072,6100,2,PERF
42479411780000,PI,IP,001,58,14145,14147,6100,2,PERF
42479411780000,PI,IP,001,59,14220,14222,6100,2,PERF
42479411780000,PI,IP,001,60,14295,14297,6100,2,PERF
42479411800000,PI,IP,001,1,8528,12463,4753,3935,PERF
42479411810000,PI,IP,001,1,9793,15019,6183,5226,PERF
42479411820000,PI,IP,001,1,7511,11320,,3809,PERF
42479411840000,PI,IP,001,1,9780,15342,6379,5562,PERF
42479411850000,PI,IP,001,1,9669,15085,6147,5416,PERF
42479411890000,PI,IP,001,1,11633,11635,6276,2,PERF
42479411890000,PI,IP,001,2,11710,11712,6276,2,PERF
42479411890000,PI,IP,001,3,11782,11784,6276,2,PERF
42479411890000,PI,IP,001,4,11864,11866,6276,2,PERF
42479411890000,PI,IP,001,5,11942,11944,6276,2,PERF
42479411890000,PI,IP,001,6,12019,12021,6276,2,PERF
42479411890000,PI,IP,001,7,12096,12097,6276,1,PERF
42479411890000,PI,IP,001,8,12171,12173,6276,2,PERF
42479411890000,PI,IP,001,9,12250,12252,6276,2,PERF
42479411890000,PI,IP,001,10,12326,12328,6276,2,PERF
42479411890000,PI,IP,001,11,12404,12406,6276,2,PERF
42479411890000,PI,IP,001,12,12481,12483,6276,2,PERF
42479411890000,PI,IP,001,13,12554,12556,6276,2,PERF
42479411890000,PI,IP,001,14,12635,12637,6276,2,PERF
42479411890000,PI,IP,001,15,12712,12714,6276,2,PERF
42479411890000,PI,IP,001,16,12790,12792,6276,2,PERF
42479411890000,PI,IP,001,17,12867,12869,6276,2,PERF
42479411890000,PI,IP,001,18,12944,12946,6276,2,PERF
42479411890000,PI,IP,001,19,13021,13023,6276,2,PERF
42479411890000,PI,IP,001,20,13098,13100,6276,2,PERF
42479411890000,PI,IP,001,21,13175,13177,6276,2,PERF
42479411890000,PI,IP,001,22,13252,13254,6276,2,PERF
42479411890000,PI,IP,001,23,13329,13331,6276,2,PERF
42479411890000,PI,IP,001,24,13406,13408,6276,2,PERF
42479411900000,PI,IP,001,1,8914,8916,6135,2,PERF
42479411900000,PI,IP,001,2,9020,9022,6135,2,PERF
42479411900000,PI,IP,001,3,9106,9108,6135,2,PERF
42479411900000,PI,IP,001,4,9192,9194,6135,2,PERF
42479411900000,PI,IP,001,5,9278,9280,6135,2,PERF
42479411900000,PI,IP,001,6,9364,9366,6135,2,PERF
42479411900000,PI,IP,001,7,9451,9453,6135,2,PERF
42479411900000,PI,IP,001,8,9537,9539,6135,2,PERF
42479411900000,PI,IP,001,9,9624,9626,6135,2,PERF
42479411900000,PI,IP,001,10,9702,9704,6135,2,PERF
42479411900000,PI,IP,001,11,9794,9796,6135,2,PERF
42479411900000,PI,IP,001,12,9882,9884,6135,2,PERF
42479411900000,PI,IP,001,13,9968,9970,6135,2,PERF
42479411900000,PI,IP,001,14,10054,10056,6135,2,PERF
42479411900000,PI,IP,001,15,10140,10142,6135,2,PERF
42479411900000,PI,IP,001,16,10227,10229,6135,2,PERF
42479411900000,PI,IP,001,17,10313,10315,6135,2,PERF
42479411900000,PI,IP,001,18,10399,10401,6135,2,PERF
42479411900000,PI,IP,001,19,10486,10488,6135,2,PERF
42479411900000,PI,IP,001,20,10568,10570,6135,2,PERF
42479411900000,PI,IP,001,21,10658,10660,6135,2,PERF
42479411900000,PI,IP,001,22,10744,10746,6135,2,PERF
42479411900000,PI,IP,001,23,10830,10832,6135,2,PERF
42479411900000,PI,IP,001,24,10916,10918,6135,2,PERF
42479411900000,PI,IP,001,25,11002,11004,6135,2,PERF
42479411900000,PI,IP,001,26,11089,11091,6135,2,PERF
42479411900000,PI,IP,001,27,11175,11177,6135,2,PERF
42479411900000,PI,IP,001,28,11261,11263,6135,2,PERF
42479411900000,PI,IP,001,29,11351,11353,6135,2,PERF
42479411900000,PI,IP,001,30,11430,11432,6135,2,PERF
42479411900000,PI,IP,001,31,11520,11522,6135,2,PERF
42479411900000,PI,IP,001,32,11606,11608,6135,2,PERF
42479411900000,PI,IP,001,33,11692,11694,6135,2,PERF
42479411900000,PI,IP,001,34,11778,11780,6135,2,PERF
42479411900000,PI,IP,001,35,11864,11866,6135,2,PERF
42479411900000,PI,IP,001,36,11951,11953,6135,2,PERF
42479411900000,PI,IP,001,37,12037,12039,6135,2,PERF
42479411900000,PI,IP,001,38,12124,12126,6135,2,PERF
42479411900000,PI,IP,001,39,12214,12216,6135,2,PERF
42479411900000,PI,IP,001,40,12295,12297,6135,2,PERF
42479411900000,PI,IP,001,41,12382,12384,6135,2,PERF
42479411900000,PI,IP,001,42,12468,12470,6135,2,PERF
42479411900000,PI,IP,001,43,12554,12556,6135,2,PERF
42479411900000,PI,IP,001,44,12640,12642,6135,2,PERF
42479411900000,PI,IP,001,45,12727,12729,6135,2,PERF
42479411900000,PI,IP,001,46,12813,12815,6135,2,PERF
42479411900000,PI,IP,001,47,12899,12901,6135,2,PERF
42479411900000,PI,IP,001,48,12978,12980,6135,2,PERF
42479411900000,PI,IP,001,49,13071,13073,6135,2,PERF
42479411900000,PI,IP,001,50,13158,13160,6135,2,PERF
42479411900000,PI,IP,001,51,13244,13246,6135,2,PERF
42479411900000,PI,IP,001,52,13330,13332,6135,2,PERF
42479411900000,PI,IP,001,53,13416,13418,6135,2,PERF
42479411900000,PI,IP,001,54,13502,13504,6135,2,PERF
42479411900000,PI,IP,001,55,13589,13591,6135,2,PERF
42479411900000,PI,IP,001,56,13675,13677,6135,2,PERF
42479411900000,PI,IP,001,57,13761,13763,6135,2,PERF
42479411900000,PI,IP,001,58,13841,13843,6135,2,PERF
42479411900000,PI,IP,001,59,13921,13923,6135,2,PERF
42479411900000,PI,IP,001,60,14001,14003,6135,2,PERF
42479411910000,PI,IP,001,1,8918,8920,6076,2,PERF
42479411910000,PI,IP,001,2,9042,9044,6076,2,PERF
42479411910000,PI,IP,001,3,9132,9134,6076,2,PERF
42479411910000,PI,IP,001,4,9223,9225,6076,2,PERF
42479411910000,PI,IP,001,5,9314,9316,6076,2,PERF
42479411910000,PI,IP,001,6,9404,9406,6076,2,PERF
42479411910000,PI,IP,001,7,9496,9498,6076,2,PERF
42479411910000,PI,IP,001,8,9586,9588,6076,2,PERF
42479411910000,PI,IP,001,9,9666,9668,6076,2,PERF
42479411910000,PI,IP,001,10,9768,9770,6076,2,PERF
42479411910000,PI,IP,001,11,9848,9850,6076,2,PERF
42479411910000,PI,IP,001,12,9938,9940,6076,2,PERF
42479411910000,PI,IP,001,13,10030,10032,6076,2,PERF
42479411910000,PI,IP,001,14,10120,10122,6076,2,PERF
42479411910000,PI,IP,001,15,10210,10212,6076,2,PERF
42479411910000,PI,IP,001,16,10302,10304,6076,2,PERF
42479411910000,PI,IP,001,17,10390,10392,6076,2,PERF
42479411910000,PI,IP,001,18,10484,10486,6076,2,PERF
42479411910000,PI,IP,001,19,10574,10576,6076,2,PERF
42479411910000,PI,IP,001,20,10666,10668,6076,2,PERF
42479411910000,PI,IP,001,21,10756,10758,6076,2,PERF
42479411910000,PI,IP,001,22,10848,10850,6076,2,PERF
42479411910000,PI,IP,001,23,10936,10938,6076,2,PERF
42479411910000,PI,IP,001,24,11028,11030,6076,2,PERF
42479411910000,PI,IP,001,25,11116,11118,6076,2,PERF
42479411910000,PI,IP,001,26,11208,11210,6076,2,PERF
42479411910000,PI,IP,001,27,11298,11300,6076,2,PERF
42479411910000,PI,IP,001,28,11388,11390,6076,2,PERF
42479411910000,PI,IP,001,29,11351,11353,6076,2,PERF
42479411910000,PI,IP,001,30,11430,11432,6076,2,PERF
42479411910000,PI,IP,001,31,11520,11522,6076,2,PERF
42479411910000,PI,IP,001,32,11606,11608,6076,2,PERF
42479411910000,PI,IP,001,33,11840,11842,6076,2,PERF
42479411910000,PI,IP,001,34,11930,11932,6076,2,PERF
42479411910000,PI,IP,001,35,12020,12022,6076,2,PERF
42479411910000,PI,IP,001,36,12108,12110,6076,2,PERF
42479411910000,PI,IP,001,37,12208,12210,6076,2,PERF
42479411910000,PI,IP,001,38,12286,12288,6076,2,PERF
42479411910000,PI,IP,001,39,12388,12390,6076,2,PERF
42479411910000,PI,IP,001,40,12478,12480,6076,2,PERF
42479411910000,PI,IP,001,41,12568,12570,6076,2,PERF
42479411910000,PI,IP,001,42,12650,12652,6076,2,PERF
42479411910000,PI,IP,001,43,12740,12742,6076,2,PERF
42479411910000,PI,IP,001,44,12830,12832,6076,2,PERF
42479411910000,PI,IP,001,45,12920,12922,6076,2,PERF
42479411910000,PI,IP,001,46,13012,13014,6076,2,PERF
42479411910000,PI,IP,001,47,13114,13116,6076,2,PERF
42479411910000,PI,IP,001,48,13192,13194,6076,2,PERF
42479411910000,PI,IP,001,49,13284,13286,6076,2,PERF
42479411910000,PI,IP,001,50,13374,13376,6076,2,PERF
42479411910000,PI,IP,001,51,13466,13468,6076,2,PERF
42479411910000,PI,IP,001,52,13562,13564,6076,2,PERF
42479411910000,PI,IP,001,53,13650,13652,6076,2,PERF
42479411910000,PI,IP,001,54,13740,13742,6076,2,PERF
42479411910000,PI,IP,001,55,13830,13832,6076,2,PERF
42479411910000,PI,IP,001,56,13921,13923,6076,2,PERF
42479411910000,PI,IP,001,57,14015,14017,6076,2,PERF
42479411910000,PI,IP,001,58,14095,14097,6076,2,PERF
42479411910000,PI,IP,001,59,14175,14177,6076,2,PERF
42479411910000,PI,IP,001,60,14255,14257,6076,2,PERF
42479411920000,PI,IP,001,1,10872,14137,4923,3265,PERF
42479411930000,PI,IP,001,1,7729,13287,6020,5558,PERF
42479411940000,PI,IP,001,1,9121,14242,6199,5121,PERF
42479411950000,PI,IP,001,1,8937,12585,6002,3648,PERF
42479411970000,PI,IP,001,1,10250,10500,6491,250,PERF
42479411970000,PI,IP,001,2,10550,10800,6491,250,PERF
42479411970000,PI,IP,001,3,10850,11100,6491,250,PERF
42479411970000,PI,IP,001,4,11150,11400,6491,250,PERF
42479411970000,PI,IP,001,5,11450,11700,6491,250,PERF
42479411970000,PI,IP,001,6,11750,12000,6491,250,PERF
42479411970000,PI,IP,001,7,12050,12300,6491,250,PERF
42479411970000,PI,IP,001,8,12350,12600,6491,250,PERF
42479411970000,PI,IP,001,9,12650,12900,6491,250,PERF
42479411970000,PI,IP,001,10,12950,13200,6491,250,PERF
42479411970000,PI,IP,001,11,13250,13500,6491,250,PERF
42479411970000,PI,IP,001,12,13550,13800,6491,250,PERF
42479411970000,PI,IP,001,13,13850,14100,6491,250,PERF
42479411970000,PI,IP,001,14,14150,14400,6491,250,PERF
42479411970000,PI,IP,001,15,14450,14700,6491,250,PERF
42479411970000,PI,IP,001,16,14750,15000,6491,250,PERF
42479411970000,PI,IP,001,17,15050,15300,6491,250,PERF
42479411970000,PI,IP,001,18,15350,15600,6491,250,PERF
42479411970000,PI,IP,001,19,15650,15900,6491,250,PERF
42479411970000,PI,IP,001,20,15950,16200,6491,250,PERF
42479411990000,PI,IP,001,1,10202,15340,5396,5138,PERF
42479412010000,PI,IP,001,1,8175,12845,5825,4670,PERF
42479412020000,PI,IP,001,1,9020,9022,6181,2,PERF
42479412020000,PI,IP,001,2,9110,9112,6181,2,PERF
42479412020000,PI,IP,001,3,9200,9202,6181,2,PERF
42479412020000,PI,IP,001,4,9290,9292,6181,2,PERF
42479412020000,PI,IP,001,5,9392,9394,6181,2,PERF
42479412020000,PI,IP,001,6,9482,9484,6181,2,PERF
42479412020000,PI,IP,001,7,9572,9574,6181,2,PERF
42479412020000,PI,IP,001,8,9662,9664,6181,2,PERF
42479412020000,PI,IP,001,9,9758,9760,6181,2,PERF
42479412020000,PI,IP,001,10,9848,9850,6181,2,PERF
42479412020000,PI,IP,001,11,9938,9940,6181,2,PERF
42479412020000,PI,IP,001,12,10028,10030,6181,2,PERF
42479412020000,PI,IP,001,13,10124,10126,6181,2,PERF
42479412020000,PI,IP,001,14,10214,10216,6181,2,PERF
42479412020000,PI,IP,001,15,10304,10306,6181,2,PERF
42479412020000,PI,IP,001,16,10394,10396,6181,2,PERF
42479412020000,PI,IP,001,17,10492,10494,6181,2,PERF
42479412020000,PI,IP,001,18,10580,10582,6181,2,PERF
42479412020000,PI,IP,001,19,10670,10672,6181,2,PERF
42479412020000,PI,IP,001,20,10760,10762,6181,2,PERF
42479412020000,PI,IP,001,21,10856,10858,6181,2,PERF
42479412020000,PI,IP,001,22,10946,10948,6181,2,PERF
42479412020000,PI,IP,001,23,11036,11038,6181,2,PERF
42479412020000,PI,IP,001,24,11126,11128,6181,2,PERF
42479412020000,PI,IP,001,25,11222,11224,6181,2,PERF
42479412020000,PI,IP,001,26,11312,11314,6181,2,PERF
42479412020000,PI,IP,001,27,11402,11404,6181,2,PERF
42479412020000,PI,IP,001,28,11492,11494,6181,2,PERF
42479412020000,PI,IP,001,29,11588,11590,6181,2,PERF
42479412020000,PI,IP,001,30,11678,11680,6181,2,PERF
42479412020000,PI,IP,001,31,11768,11770,6181,2,PERF
42479412020000,PI,IP,001,32,11858,11860,6181,2,PERF
42479412020000,PI,IP,001,33,11954,11956,6181,2,PERF
42479412020000,PI,IP,001,34,12044,12046,6181,2,PERF
42479412020000,PI,IP,001,35,12134,12136,6181,2,PERF
42479412020000,PI,IP,001,36,12224,12226,6181,2,PERF
42479412020000,PI,IP,001,37,12320,12322,6181,2,PERF
42479412020000,PI,IP,001,38,12410,12412,6181,2,PERF
42479412020000,PI,IP,001,39,12500,12502,6181,2,PERF
42479412020000,PI,IP,001,40,12590,12592,6181,2,PERF
42479412020000,PI,IP,001,41,12686,12688,6181,2,PERF
42479412020000,PI,IP,001,42,12776,12778,6181,2,PERF
42479412020000,PI,IP,001,43,12866,12868,6181,2,PERF
42479412020000,PI,IP,001,44,12956,12958,6181,2,PERF
42479412020000,PI,IP,001,45,13052,13054,6181,2,PERF
42479412020000,PI,IP,001,46,13142,13144,6181,2,PERF
42479412020000,PI,IP,001,47,13232,13234,6181,2,PERF
42479412020000,PI,IP,001,48,13322,13324,6181,2,PERF
42479412020000,PI,IP,001,49,13418,13420,6181,2,PERF
42479412020000,PI,IP,001,50,13508,13510,6181,2,PERF
42479412020000,PI,IP,001,51,13598,13600,6181,2,PERF
42479412020000,PI,IP,001,52,13668,13690,6181,22,PERF
42479412020000,PI,IP,001,53,13786,13788,6181,2,PERF
42479412020000,PI,IP,001,54,13874,13876,6181,2,PERF
42479412020000,PI,IP,001,55,13964,13966,6181,2,PERF
42479412020000,PI,IP,001,56,14054,14056,6181,2,PERF
42479412020000,PI,IP,001,57,14150,14152,6181,2,PERF
42479412020000,PI,IP,001,58,14225,14227,6181,2,PERF
42479412020000,PI,IP,001,59,14300,14302,6181,2,PERF
42479412020000,PI,IP,001,60,14375,14377,6181,2,PERF
42479412030000,PI,IP,001,1,8993,8995,6132,2,PERF
42479412030000,PI,IP,001,2,9072,9074,6132,2,PERF
42479412030000,PI,IP,001,3,9156,9158,6132,2,PERF
42479412030000,PI,IP,001,4,9240,9242,6132,2,PERF
42479412030000,PI,IP,001,5,9327,9329,6132,2,PERF
42479412030000,PI,IP,001,6,9411,9413,6132,2,PERF
42479412030000,PI,IP,001,7,9495,9497,6132,2,PERF
42479412030000,PI,IP,001,8,9583,9585,6132,2,PERF
42479412030000,PI,IP,001,9,9660,9662,6132,2,PERF
42479412030000,PI,IP,001,10,9715,9717,6132,2,PERF
42479412030000,PI,IP,001,11,9834,9836,6132,2,PERF
42479412030000,PI,IP,001,12,9918,9920,6132,2,PERF
42479412030000,PI,IP,001,13,10005,10007,6132,2,PERF
42479412030000,PI,IP,001,14,10089,10091,6132,2,PERF
42479412030000,PI,IP,001,15,10173,10175,6132,2,PERF
42479412030000,PI,IP,001,16,10250,10252,6132,2,PERF
42479412030000,PI,IP,001,17,10340,10342,6132,2,PERF
42479412030000,PI,IP,001,18,10428,10430,6132,2,PERF
42479412030000,PI,IP,001,19,10512,10514,6132,2,PERF
42479412030000,PI,IP,001,20,10596,10598,6132,2,PERF
42479412030000,PI,IP,001,21,10683,10685,6132,2,PERF
42479412030000,PI,IP,001,22,10767,10769,6132,2,PERF
42479412030000,PI,IP,001,23,10854,10886,6132,32,PERF
42479412030000,PI,IP,001,24,10934,10936,6132,2,PERF
42479412030000,PI,IP,001,25,11022,11024,6132,2,PERF
42479412030000,PI,IP,001,26,11106,11108,6132,2,PERF
42479412030000,PI,IP,001,27,11190,11192,6132,2,PERF
42479412030000,PI,IP,001,28,11274,11276,6132,2,PERF
42479412030000,PI,IP,001,29,11361,11363,6132,2,PERF
42479412030000,PI,IP,001,30,11445,11447,6132,2,PERF
42479412030000,PI,IP,001,31,11524,11526,6132,2,PERF
42479412030000,PI,IP,001,32,11613,11615,6132,2,PERF
42479412030000,PI,IP,001,33,11700,11702,6132,2,PERF
42479412030000,PI,IP,001,34,11784,11786,6132,2,PERF
42479412030000,PI,IP,001,35,11868,11870,6132,2,PERF
42479412030000,PI,IP,001,36,11952,11954,6132,2,PERF
42479412030000,PI,IP,001,37,12039,12041,6132,2,PERF
42479412030000,PI,IP,001,38,12127,12129,6132,2,PERF
42479412030000,PI,IP,001,39,12207,12209,6132,2,PERF
42479412030000,PI,IP,001,40,12291,12293,6132,2,PERF
42479412030000,PI,IP,001,41,12378,12380,6132,2,PERF
42479412030000,PI,IP,001,42,12462,12464,6132,2,PERF
42479412030000,PI,IP,001,43,12546,12548,6132,2,PERF
42479412030000,PI,IP,001,44,12660,12662,6132,2,PERF
42479412030000,PI,IP,001,45,12717,12719,6132,2,PERF
42479412030000,PI,IP,001,46,12796,12798,6132,2,PERF
42479412030000,PI,IP,001,47,12885,12887,6132,2,PERF
42479412030000,PI,IP,001,48,12969,12971,6132,2,PERF
42479412030000,PI,IP,001,49,13056,13058,6132,2,PERF
42479412030000,PI,IP,001,50,13140,13142,6132,2,PERF
42479412030000,PI,IP,001,51,13224,13226,6132,2,PERF
42479412030000,PI,IP,001,52,13308,13310,6132,2,PERF
42479412030000,PI,IP,001,53,13388,13390,6132,2,PERF
42479412030000,PI,IP,001,54,13478,13480,6132,2,PERF
42479412030000,PI,IP,001,55,13563,13565,6132,2,PERF
42479412030000,PI,IP,001,56,13642,13644,6132,2,PERF
42479412030000,PI,IP,001,57,13750,13752,6132,2,PERF
42479412030000,PI,IP,001,58,13770,13772,6132,2,PERF
42479412030000,PI,IP,001,59,13820,13822,6132,2,PERF
42479412030000,PI,IP,001,60,13850,13852,6132,2,PERF
42479412040000,PI,IP,001,1,9096,9098,6197,2,PERF
42479412040000,PI,IP,001,2,9187,9189,6197,2,PERF
42479412040000,PI,IP,001,3,9278,9280,6197,2,PERF
42479412040000,PI,IP,001,4,9356,9358,6197,2,PERF
42479412040000,PI,IP,001,5,9460,9462,6197,2,PERF
42479412040000,PI,IP,001,6,9550,9552,6197,2,PERF
42479412040000,PI,IP,001,7,9735,9737,6197,2,PERF
42479412040000,PI,IP,001,8,9741,9743,6197,2,PERF
42479412040000,PI,IP,001,9,9825,9827,6197,2,PERF
42479412040000,PI,IP,001,10,9915,9917,6197,2,PERF
42479412040000,PI,IP,001,11,10005,10007,6197,2,PERF
42479412040000,PI,IP,001,12,10098,10100,6197,2,PERF
42479412040000,PI,IP,001,13,10190,10192,6197,2,PERF
42479412040000,PI,IP,001,14,10280,10282,6197,2,PERF
42479412040000,PI,IP,001,15,10370,10372,6197,2,PERF
42479412040000,PI,IP,001,16,10460,10462,6197,2,PERF
42479412040000,PI,IP,001,17,10555,10557,6197,2,PERF
42479412040000,PI,IP,001,18,10645,10647,6197,2,PERF
42479412040000,PI,IP,001,19,10735,10737,6197,2,PERF
42479412040000,PI,IP,001,20,10825,10827,6197,2,PERF
42479412040000,PI,IP,001,21,10920,10922,6197,2,PERF
42479412040000,PI,IP,001,22,11010,11012,6197,2,PERF
42479412040000,PI,IP,001,23,11100,11102,6197,2,PERF
42479412040000,PI,IP,001,24,11190,11192,6197,2,PERF
42479412040000,PI,IP,001,25,11285,11287,6197,2,PERF
42479412040000,PI,IP,001,26,11375,11377,6197,2,PERF
42479412040000,PI,IP,001,27,11465,11467,6197,2,PERF
42479412040000,PI,IP,001,28,11555,11557,6197,2,PERF
42479412040000,PI,IP,001,29,11650,11652,6197,2,PERF
42479412040000,PI,IP,001,30,11740,11742,6197,2,PERF
42479412040000,PI,IP,001,31,11830,11832,6197,2,PERF
42479412040000,PI,IP,001,32,11920,11922,6197,2,PERF
42479412040000,PI,IP,001,33,12015,12017,6197,2,PERF
42479412040000,PI,IP,001,34,12105,12107,6197,2,PERF
42479412040000,PI,IP,001,35,12195,12197,6197,2,PERF
42479412040000,PI,IP,001,36,12285,12287,6197,2,PERF
42479412040000,PI,IP,001,37,12380,12382,6197,2,PERF
42479412040000,PI,IP,001,38,12470,12472,6197,2,PERF
42479412040000,PI,IP,001,39,12560,12562,6197,2,PERF
42479412040000,PI,IP,001,40,12650,12652,6197,2,PERF
42479412040000,PI,IP,001,41,12745,12747,6197,2,PERF
42479412040000,PI,IP,001,42,12835,12837,6197,2,PERF
42479412040000,PI,IP,001,43,12925,12927,6197,2,PERF
42479412040000,PI,IP,001,44,13015,13017,6197,2,PERF
42479412040000,PI,IP,001,45,13110,13112,6197,2,PERF
42479412040000,PI,IP,001,46,13200,13202,6197,2,PERF
42479412040000,PI,IP,001,47,13290,13292,6197,2,PERF
42479412040000,PI,IP,001,48,13380,13382,6197,2,PERF
42479412040000,PI,IP,001,49,13475,13477,6197,2,PERF
42479412040000,PI,IP,001,50,13565,13567,6197,2,PERF
42479412040000,PI,IP,001,51,13665,13667,6197,2,PERF
42479412040000,PI,IP,001,52,13745,13747,6197,2,PERF
42479412040000,PI,IP,001,53,13840,13842,6197,2,PERF
42479412040000,PI,IP,001,54,13930,13932,6197,2,PERF
42479412040000,PI,IP,001,55,14020,14022,6197,2,PERF
42479412040000,PI,IP,001,56,14110,14112,6197,2,PERF
42479412040000,PI,IP,001,57,14204,14206,6197,2,PERF
42479412040000,PI,IP,001,58,14261,14263,6197,2,PERF
42479412040000,PI,IP,001,59,14318,14320,6197,2,PERF
42479412040000,PI,IP,001,60,14375,14377,6197,2,PERF
42479412050000,PI,IP,001,1,11665,15891,4571,4226,PERF
42479412060000,PI,IP,001,1,7166,12336,6034,5170,PERF
42479412090000,PI,IP,001,1,10990,15420,,4430,PERF
42479412110000,PI,IP,001,1,7479,13728,7729,6249,PERF
42479412120000,PI,IP,001,1,7002,14272,8349,7270,PERF
42479412130000,PI,IP,001,1,8888,8890,6133,2,PERF
42479412130000,PI,IP,001,2,9014,9016,6133,2,PERF
42479412130000,PI,IP,001,3,9101,9103,6133,2,PERF
42479412130000,PI,IP,001,4,9190,9192,6133,2,PERF
42479412130000,PI,IP,001,5,9282,9284,6133,2,PERF
42479412130000,PI,IP,001,6,9362,9364,6133,2,PERF
42479412130000,PI,IP,001,7,9451,9453,6133,2,PERF
42479412130000,PI,IP,001,8,9539,9541,6133,2,PERF
42479412130000,PI,IP,001,9,9626,9628,6133,2,PERF
42479412130000,PI,IP,001,10,9714,9716,6133,2,PERF
42479412130000,PI,IP,001,11,9801,9803,6133,2,PERF
42479412130000,PI,IP,001,12,9889,9891,6133,2,PERF
42479412130000,PI,IP,001,13,9976,9978,6133,2,PERF
42479412130000,PI,IP,001,14,10064,10066,6133,2,PERF
42479412130000,PI,IP,001,15,10151,10153,6133,2,PERF
42479412130000,PI,IP,001,16,10239,10241,6133,2,PERF
42479412130000,PI,IP,001,17,10326,10328,6133,2,PERF
42479412130000,PI,IP,001,18,10416,10418,6133,2,PERF
42479412130000,PI,IP,001,19,10496,10498,6133,2,PERF
42479412130000,PI,IP,001,20,10588,10590,6133,2,PERF
42479412130000,PI,IP,001,21,10676,10678,6133,2,PERF
42479412130000,PI,IP,001,22,10764,10766,6133,2,PERF
42479412130000,PI,IP,001,23,10851,10853,6133,2,PERF
42479412130000,PI,IP,001,24,10939,10941,6133,2,PERF
42479412130000,PI,IP,001,25,11026,11028,6133,2,PERF
42479412130000,PI,IP,001,26,11114,11116,6133,2,PERF
42479412130000,PI,IP,001,27,11201,11203,6133,2,PERF
42479412130000,PI,IP,001,28,11289,11291,6133,2,PERF
42479412130000,PI,IP,001,29,11376,11378,6133,2,PERF
42479412130000,PI,IP,001,30,11464,11466,6133,2,PERF
42479412130000,PI,IP,001,31,11551,11553,6133,2,PERF
42479412130000,PI,IP,001,32,11639,11641,6133,2,PERF
42479412130000,PI,IP,001,33,11730,11732,6133,2,PERF
42479412130000,PI,IP,001,34,11810,11812,6133,2,PERF
42479412130000,PI,IP,001,35,11900,11902,6133,2,PERF
42479412130000,PI,IP,001,36,11989,11991,6133,2,PERF
42479412130000,PI,IP,001,37,12076,12078,6133,2,PERF
42479412130000,PI,IP,001,38,12164,12166,6133,2,PERF
42479412130000,PI,IP,001,39,12251,12253,6133,2,PERF
42479412130000,PI,IP,001,40,12339,12341,6133,2,PERF
42479412130000,PI,IP,001,41,12426,12428,6133,2,PERF
42479412130000,PI,IP,001,42,12514,12516,6133,2,PERF
42479412130000,PI,IP,001,43,12601,12603,6133,2,PERF
42479412130000,PI,IP,001,44,12689,12691,6133,2,PERF
42479412130000,PI,IP,001,45,12776,12778,6133,2,PERF
42479412130000,PI,IP,001,46,12866,12868,6133,2,PERF
42479412130000,PI,IP,001,47,12955,12957,6133,2,PERF
42479412130000,PI,IP,001,48,13034,13036,6133,2,PERF
42479412130000,PI,IP,001,49,13126,13128,6133,2,PERF
42479412130000,PI,IP,001,50,13214,13216,6133,2,PERF
42479412130000,PI,IP,001,51,13301,13303,6133,2,PERF
42479412130000,PI,IP,001,52,13389,13391,6133,2,PERF
42479412130000,PI,IP,001,53,13476,13478,6133,2,PERF
42479412130000,PI,IP,001,54,13564,13566,6133,2,PERF
42479412130000,PI,IP,001,55,13651,13653,6133,2,PERF
42479412130000,PI,IP,001,56,13739,13741,6133,2,PERF
42479412130000,PI,IP,001,57,13826,13826,6133,0,PERF
42479412130000,PI,IP,001,58,13901,13901,6133,0,PERF
42479412130000,PI,IP,001,59,13976,13976,6133,0,PERF
42479412130000,PI,IP,001,60,14042,14042,6133,0,PERF
42479412140000,PI,IP,001,1,8796,8798,6091,2,PERF
42479412140000,PI,IP,001,2,8922,8924,6091,2,PERF
42479412140000,PI,IP,001,3,9011,9013,6091,2,PERF
42479412140000,PI,IP,001,4,9099,9101,6091,2,PERF
42479412140000,PI,IP,001,5,9188,9190,6091,2,PERF
42479412140000,PI,IP,001,6,9277,9279,6091,2,PERF
42479412140000,PI,IP,001,7,9366,9368,6091,2,PERF
42479412140000,PI,IP,001,8,9454,9456,6091,2,PERF
42479412140000,PI,IP,001,9,9543,9545,6091,2,PERF
42479412140000,PI,IP,001,10,9632,9634,6091,2,PERF
42479412140000,PI,IP,001,11,9721,9723,6091,2,PERF
42479412140000,PI,IP,001,12,9809,9811,6091,2,PERF
42479412140000,PI,IP,001,13,9898,9900,6091,2,PERF
42479412140000,PI,IP,001,14,9987,9989,6091,2,PERF
42479412140000,PI,IP,001,15,10076,10078,6091,2,PERF
42479412140000,PI,IP,001,16,10164,10166,6091,2,PERF
42479412140000,PI,IP,001,17,10254,10256,6091,2,PERF
42479412140000,PI,IP,001,18,10344,10346,6091,2,PERF
42479412140000,PI,IP,001,19,10434,10436,6091,2,PERF
42479412140000,PI,IP,001,20,10524,10526,6091,2,PERF
42479412140000,PI,IP,001,21,10604,10606,6091,2,PERF
42479412140000,PI,IP,001,22,10697,10699,6091,2,PERF
42479412140000,PI,IP,001,23,10786,10788,6091,2,PERF
42479412140000,PI,IP,001,24,10874,10876,6091,2,PERF
42479412140000,PI,IP,001,25,10963,10965,6091,2,PERF
42479412140000,PI,IP,001,26,11052,11054,6091,2,PERF
42479412140000,PI,IP,001,27,11141,11143,6091,2,PERF
42479412140000,PI,IP,001,28,11229,11231,6091,2,PERF
42479412140000,PI,IP,001,29,11318,11320,6091,2,PERF
42479412140000,PI,IP,001,30,11407,11409,6091,2,PERF
42479412140000,PI,IP,001,31,11496,11498,6091,2,PERF
42479412140000,PI,IP,001,32,11584,11586,6091,2,PERF
42479412140000,PI,IP,001,33,11673,11675,6091,2,PERF
42479412140000,PI,IP,001,34,11762,11764,6091,2,PERF
42479412140000,PI,IP,001,35,11851,11853,6091,2,PERF
42479412140000,PI,IP,001,36,11939,11941,6091,2,PERF
42479412140000,PI,IP,001,37,12028,12030,6091,2,PERF
42479412140000,PI,IP,001,38,12118,12120,6091,2,PERF
42479412140000,PI,IP,001,39,12210,12212,6091,2,PERF
42479412140000,PI,IP,001,40,12288,12290,6091,2,PERF
42479412140000,PI,IP,001,41,12380,12382,6091,2,PERF
42479412140000,PI,IP,001,42,12472,12474,6091,2,PERF
42479412140000,PI,IP,001,43,12561,12563,6091,2,PERF
42479412140000,PI,IP,001,44,12649,12651,6091,2,PERF
42479412140000,PI,IP,001,45,12738,12740,6091,2,PERF
42479412140000,PI,IP,001,46,12827,12829,6091,2,PERF
42479412140000,PI,IP,001,47,12916,12918,6091,2,PERF
42479412140000,PI,IP,001,48,13004,13006,6091,2,PERF
42479412140000,PI,IP,001,49,13093,13095,6091,2,PERF
42479412140000,PI,IP,001,50,13182,13184,6091,2,PERF
42479412140000,PI,IP,001,51,13271,13273,6091,2,PERF
42479412140000,PI,IP,001,52,13359,13361,6091,2,PERF
42479412140000,PI,IP,001,53,13448,13450,6091,2,PERF
42479412140000,PI,IP,001,54,13537,13539,6091,2,PERF
42479412140000,PI,IP,001,55,13626,13628,6091,2,PERF
42479412140000,PI,IP,001,56,13714,13716,6091,2,PERF
42479412140000,PI,IP,001,57,13803,13803,6091,0,PERF
42479412140000,PI,IP,001,58,13872,13872,6091,0,PERF
42479412140000,PI,IP,001,59,13943,13943,6091,0,PERF
42479412140000,PI,IP,001,60,14013,14013,6091,0,PERF
42479412150000,PI,IP,001,1,9104,9106,6069,2,PERF
42479412150000,PI,IP,001,2,9194,9196,6069,2,PERF
42479412150000,PI,IP,001,3,9284,9286,6069,2,PERF
42479412150000,PI,IP,001,4,9374,9376,6069,2,PERF
42479412150000,PI,IP,001,5,9464,9468,6069,4,PERF
42479412150000,PI,IP,001,6,9554,9556,6069,2,PERF
42479412150000,PI,IP,001,7,9644,9646,6069,2,PERF
42479412150000,PI,IP,001,8,9734,9736,6069,2,PERF
42479412150000,PI,IP,001,9,9824,9826,6069,2,PERF
42479412150000,PI,IP,001,10,9914,9916,6069,2,PERF
42479412150000,PI,IP,001,11,10004,10006,6069,2,PERF
42479412150000,PI,IP,001,12,10094,10096,6069,2,PERF
42479412150000,PI,IP,001,13,10186,10188,6069,2,PERF
42479412150000,PI,IP,001,14,10276,10278,6069,2,PERF
42479412150000,PI,IP,001,15,10368,10370,6069,2,PERF
42479412150000,PI,IP,001,16,10448,10450,6069,2,PERF
42479412150000,PI,IP,001,17,10538,10540,6069,2,PERF
42479412150000,PI,IP,001,18,10630,10632,6069,2,PERF
42479412150000,PI,IP,001,19,10720,10722,6069,2,PERF
42479412150000,PI,IP,001,20,10810,10812,6069,2,PERF
42479412150000,PI,IP,001,21,10902,10904,6069,2,PERF
42479412150000,PI,IP,001,22,10992,10994,6069,2,PERF
42479412150000,PI,IP,001,23,11085,11087,6069,2,PERF
42479412150000,PI,IP,001,24,11172,11174,6069,2,PERF
42479412150000,PI,IP,001,25,11264,11266,6069,2,PERF
42479412150000,PI,IP,001,26,11354,11356,6069,2,PERF
42479412150000,PI,IP,001,27,11446,11448,6069,2,PERF
42479412150000,PI,IP,001,28,11536,11538,6069,2,PERF
42479412150000,PI,IP,001,29,11626,11628,6069,2,PERF
42479412150000,PI,IP,001,30,11716,11718,6069,2,PERF
42479412150000,PI,IP,001,31,11806,11808,6069,2,PERF
42479412150000,PI,IP,001,32,11896,11898,6069,2,PERF
42479412150000,PI,IP,001,33,11986,11988,6069,2,PERF
42479412150000,PI,IP,001,34,12076,12078,6069,2,PERF
42479412150000,PI,IP,001,35,12166,12168,6069,2,PERF
42479412150000,PI,IP,001,36,12257,12259,6069,2,PERF
42479412150000,PI,IP,001,37,12347,12349,6069,2,PERF
42479412150000,PI,IP,001,38,12437,12439,6069,2,PERF
42479412150000,PI,IP,001,39,12527,12529,6069,2,PERF
42479412150000,PI,IP,001,40,12617,12619,6069,2,PERF
42479412150000,PI,IP,001,41,12707,12709,6069,2,PERF
42479412150000,PI,IP,001,42,12797,12799,6069,2,PERF
42479412150000,PI,IP,001,43,12887,12889,6069,2,PERF
42479412150000,PI,IP,001,44,12977,12979,6069,2,PERF
42479412150000,PI,IP,001,45,13067,13069,6069,2,PERF
42479412150000,PI,IP,001,46,13157,13159,6069,2,PERF
42479412150000,PI,IP,001,47,13247,13249,6069,2,PERF
42479412150000,PI,IP,001,48,13338,13340,6069,2,PERF
42479412150000,PI,IP,001,49,13428,13430,6069,2,PERF
42479412150000,PI,IP,001,50,13518,13520,6069,2,PERF
42479412150000,PI,IP,001,51,13608,13610,6069,2,PERF
42479412150000,PI,IP,001,52,13698,13700,6069,2,PERF
42479412150000,PI,IP,001,53,13788,13788,6069,0,PERF
42479412150000,PI,IP,001,54,13863,13863,6069,0,PERF
42479412150000,PI,IP,001,55,13938,13938,6069,0,PERF
42479412150000,PI,IP,001,56,14015,14015,6069,0,PERF
42479412160100,PI,PT,001,1,9474,13948,,4474,PERF
42479412170000,PI,IP,001,1,7126,11826,6025,4700,PERF
42479412180000,PI,IP,001,1,12250,16080,3988,3830,PERF
42479412190000,PI,IP,001,1,7188,12990,6796,5802,PERF
42479412200000,PI,IP,001,1,6967,12037,5994,5070,PERF
42479412210000,PI,IP,001,1,9803,14669,5944,4866,PERF
42479412220000,PI,IP,001,1,9796,14557,5647,4761,PERF
42479412230000,PI,IP,001,1,9761,14483,5704,4722,COMB
42479412240000,PI,IP,001,1,10450,10700,6920,250,PERF
42479412240000,PI,IP,001,2,10750,11000,6920,250,PERF
42479412240000,PI,IP,001,3,11050,11300,6920,250,PERF
42479412240000,PI,IP,001,4,11350,11600,6920,250,PERF
42479412240000,PI,IP,001,5,11650,11900,6920,250,PERF
42479412240000,PI,IP,001,6,11950,12200,6920,250,PERF
42479412240000,PI,IP,001,7,12250,12500,6920,250,PERF
42479412240000,PI,IP,001,8,12550,12800,6920,250,PERF
42479412240000,PI,IP,001,9,12850,13100,6920,250,PERF
42479412240000,PI,IP,001,10,13150,13400,6920,250,PERF
42479412240000,PI,IP,001,11,13450,13700,6920,250,PERF
42479412240000,PI,IP,001,12,13750,14000,6920,250,PERF
42479412240000,PI,IP,001,13,14050,14300,6920,250,PERF
42479412240000,PI,IP,001,14,14350,14600,6920,250,PERF
42479412240000,PI,IP,001,15,14650,14900,6920,250,PERF
42479412240000,PI,IP,001,16,14950,15200,6920,250,PERF
42479412240000,PI,IP,001,17,15250,15500,6920,250,PERF
42479412240000,PI,IP,001,18,15550,15800,6920,250,PERF
42479412250000,PI,IP,001,1,10300,10550,6879,250,PERF
42479412250000,PI,IP,001,2,10600,10850,6879,250,PERF
42479412250000,PI,IP,001,3,10900,11150,6879,250,PERF
42479412250000,PI,IP,001,4,11200,11450,6879,250,PERF
42479412250000,PI,IP,001,5,11500,11750,6879,250,PERF
42479412250000,PI,IP,001,6,11800,12050,6879,250,PERF
42479412250000,PI,IP,001,7,12100,12350,6879,250,PERF
42479412250000,PI,IP,001,8,12400,12650,6879,250,PERF
42479412250000,PI,IP,001,9,12700,12950,6879,250,PERF
42479412250000,PI,IP,001,10,13000,13250,6879,250,PERF
42479412250000,PI,IP,001,11,13300,13550,6879,250,PERF
42479412250000,PI,IP,001,12,13600,13850,6879,250,PERF
42479412250000,PI,IP,001,13,13900,14150,6879,250,PERF
42479412250000,PI,IP,001,14,14200,14450,6879,250,PERF
42479412250000,PI,IP,001,15,14500,14750,6879,250,PERF
42479412250000,PI,IP,001,16,14800,15050,6879,250,PERF
42479412250000,PI,IP,001,17,15100,15350,6879,250,PERF
42479412250000,PI,IP,001,18,15400,15650,6879,250,PERF
42479412250000,PI,IP,001,19,15700,15950,6879,250,PERF
42479412250000,PI,IP,001,20,16000,16250,6879,250,PERF
42479412260000,PI,IP,001,1,7369,11485,5363,4116,PERF
42479412280000,PI,IP,001,1,9554,14829,5970,5275,PERF
42479412290000,PI,PT,001,1,,,,,PERF
42479412300000,PI,IP,001,1,9774,15230,5752,5456,PERF
42479412310000,PI,IP,001,1,9340,14062,5810,4722,PERF
42479412320000,PI,IP,001,1,8629,12621,4722,3992,PERF
42479412330000,PI,IP,001,1,11624,15841,4549,4217,PERF
42479412340000,PI,IP,001,1,9680,14247,5712,4567,PERF
42479412350000,PI,IP,001,1,10105,14962,5642,4857,PERF
42479412360000,PI,IP,001,1,8888,8890,6546,2,PERF
42479412360000,PI,IP,001,2,9011,9013,6546,2,PERF
42479412360000,PI,IP,001,3,9103,9105,6546,2,PERF
42479412360000,PI,IP,001,4,9195,9197,6546,2,PERF
42479412360000,PI,IP,001,5,9287,9289,6546,2,PERF
42479412360000,PI,IP,001,6,9379,9381,6546,2,PERF
42479412360000,PI,IP,001,7,9468,9470,6546,2,PERF
42479412360000,PI,IP,001,8,9560,9562,6546,2,PERF
42479412360000,PI,IP,001,9,9652,9654,6546,2,PERF
42479412360000,PI,IP,001,10,9752,9754,6546,2,PERF
42479412360000,PI,IP,001,11,9832,9834,6546,2,PERF
42479412360000,PI,IP,001,12,9934,9936,6546,2,PERF
42479412360000,PI,IP,001,13,10024,10026,6546,2,PERF
42479412360000,PI,IP,001,14,10116,10118,6546,2,PERF
42479412360000,PI,IP,001,15,10207,10209,6546,2,PERF
42479412360000,PI,IP,001,16,10299,10301,6546,2,PERF
42479412360000,PI,IP,001,17,10391,10393,6546,2,PERF
42479412360000,PI,IP,001,18,10483,10485,6546,2,PERF
42479412360000,PI,IP,001,19,10575,10577,6546,2,PERF
42479412360000,PI,IP,001,20,10667,10669,6546,2,PERF
42479412360000,PI,IP,001,21,10759,10761,6546,2,PERF
42479412360000,PI,IP,001,22,10851,10853,6546,2,PERF
42479412360000,PI,IP,001,23,10943,10945,6546,2,PERF
42479412360000,PI,IP,001,24,11035,11037,6546,2,PERF
42479412360000,PI,IP,001,25,11127,11129,6546,2,PERF
42479412360000,PI,IP,001,26,11219,11221,6546,2,PERF
42479412360000,PI,IP,001,27,11311,11313,6546,2,PERF
42479412360000,PI,IP,001,28,11403,11405,6546,2,PERF
42479412360000,PI,IP,001,29,11495,11497,6546,2,PERF
42479412360000,PI,IP,001,30,11587,11589,6546,2,PERF
42479412360000,PI,IP,001,31,11679,11681,6546,2,PERF
42479412360000,PI,IP,001,32,11771,11773,6546,2,PERF
42479412360000,PI,IP,001,33,11863,11865,6546,2,PERF
42479412360000,PI,IP,001,34,11955,11957,6546,2,PERF
42479412360000,PI,IP,001,35,12047,12049,6546,2,PERF
42479412360000,PI,IP,001,36,12139,12141,6546,2,PERF
42479412360000,PI,IP,001,37,12231,12233,6546,2,PERF
42479412360000,PI,IP,001,38,12323,12325,6546,2,PERF
42479412360000,PI,IP,001,39,12415,12417,6546,2,PERF
42479412360000,PI,IP,001,40,12507,12509,6546,2,PERF
42479412360000,PI,IP,001,41,12599,12601,6546,2,PERF
42479412360000,PI,IP,001,42,12691,12693,6546,2,PERF
42479412360000,PI,IP,001,43,12783,12785,6546,2,PERF
42479412360000,PI,IP,001,44,12875,12877,6546,2,PERF
42479412360000,PI,IP,001,45,12967,12969,6546,2,PERF
42479412360000,PI,IP,001,46,13059,13061,6546,2,PERF
42479412360000,PI,IP,001,47,13151,13153,6546,2,PERF
42479412360000,PI,IP,001,48,13243,13245,6546,2,PERF
42479412360000,PI,IP,001,49,13536,13538,6546,2,PERF
42479412360000,PI,IP,001,50,13631,13632,6546,1,PERF
42479412360000,PI,IP,001,51,13727,13729,6546,2,PERF
42479412360000,PI,IP,001,52,13823,13825,6546,2,PERF
42479412360000,PI,IP,001,53,13919,13921,6546,2,PERF
42479412360000,PI,IP,001,54,14015,14017,6546,2,PERF
42479412360000,PI,IP,001,55,14110,14112,6546,2,PERF
42479412360000,PI,IP,001,56,14206,14208,6546,2,PERF
42479412360000,PI,IP,001,57,14302,14304,6546,2,PERF
42479412360000,PI,IP,001,58,14382,14384,6546,2,PERF
42479412360000,PI,IP,001,59,14462,14464,6546,2,PERF
42479412360000,PI,IP,001,60,14542,14544,6546,2,PERF
42479412370000,PI,IP,001,1,8978,8980,6294,2,PERF
42479412370000,PI,IP,001,2,9085,9087,6294,2,PERF
42479412370000,PI,IP,001,3,9171,9173,6294,2,PERF
42479412370000,PI,IP,001,4,9257,9259,6294,2,PERF
42479412370000,PI,IP,001,5,9343,9345,6294,2,PERF
42479412370000,PI,IP,001,6,9428,9430,6294,2,PERF
42479412370000,PI,IP,001,7,9514,9516,6294,2,PERF
42479412370000,PI,IP,001,8,9600,9602,6294,2,PERF
42479412370000,PI,IP,001,9,9686,9688,6294,2,PERF
42479412370000,PI,IP,001,10,9771,9773,6294,2,PERF
42479412370000,PI,IP,001,11,9857,9859,6294,2,PERF
42479412370000,PI,IP,001,12,9943,9945,6294,2,PERF
42479412370000,PI,IP,001,13,10029,10031,6294,2,PERF
42479412370000,PI,IP,001,14,10114,10116,6294,2,PERF
42479412370000,PI,IP,001,15,10200,10202,6294,2,PERF
42479412370000,PI,IP,001,16,10286,10288,6294,2,PERF
42479412370000,PI,IP,001,17,10372,10374,6294,2,PERF
42479412370000,PI,IP,001,18,10457,10459,6294,2,PERF
42479412370000,PI,IP,001,19,10543,10545,6294,2,PERF
42479412370000,PI,IP,001,20,10629,10631,6294,2,PERF
42479412370000,PI,IP,001,21,10715,10717,6294,2,PERF
42479412370000,PI,IP,001,22,10800,10802,6294,2,PERF
42479412370000,PI,IP,001,23,10886,10888,6294,2,PERF
42479412370000,PI,IP,001,24,10972,10974,6294,2,PERF
42479412370000,PI,IP,001,25,11058,11060,6294,2,PERF
42479412370000,PI,IP,001,26,11143,11145,6294,2,PERF
42479412370000,PI,IP,001,27,11229,11231,6294,2,PERF
42479412370000,PI,IP,001,28,11315,11317,6294,2,PERF
42479412370000,PI,IP,001,29,11401,11403,6294,2,PERF
42479412370000,PI,IP,001,30,11487,11489,6294,2,PERF
42479412370000,PI,IP,001,31,11572,11574,6294,2,PERF
42479412370000,PI,IP,001,32,11658,11660,6294,2,PERF
42479412370000,PI,IP,001,33,11742,11744,6294,2,PERF
42479412370000,PI,IP,001,34,11830,11832,6294,2,PERF
42479412370000,PI,IP,001,35,11915,11917,6294,2,PERF
42479412370000,PI,IP,001,36,12001,12003,6294,2,PERF
42479412370000,PI,IP,001,37,12087,12089,6294,2,PERF
42479412370000,PI,IP,001,38,12173,12175,6294,2,PERF
42479412370000,PI,IP,001,39,12258,12260,6294,2,PERF
42479412370000,PI,IP,001,40,12344,12346,6294,2,PERF
42479412370000,PI,IP,001,41,12430,12432,6294,2,PERF
42479412370000,PI,IP,001,42,12516,12518,6294,2,PERF
42479412370000,PI,IP,001,43,12601,12603,6294,2,PERF
42479412370000,PI,IP,001,44,12687,12689,6294,2,PERF
42479412370000,PI,IP,001,45,12773,12775,6294,2,PERF
42479412370000,PI,IP,001,46,12859,12861,6294,2,PERF
42479412370000,PI,IP,001,47,12944,12946,6294,2,PERF
42479412370000,PI,IP,001,48,13030,13032,6294,2,PERF
42479412370000,PI,IP,001,49,13116,13118,6294,2,PERF
42479412370000,PI,IP,001,50,13191,13193,6294,2,PERF
42479412370000,PI,IP,001,51,13266,13268,6294,2,PERF
42479412370000,PI,IP,001,52,13341,13343,6294,2,PERF
42479412380000,PI,IP,001,1,8883,8885,6380,2,PERF
42479412380000,PI,IP,001,2,9020,9022,6380,2,PERF
42479412380000,PI,IP,001,3,9114,9116,6380,2,PERF
42479412380000,PI,IP,001,4,9209,9211,6380,2,PERF
42479412380000,PI,IP,001,5,9303,9305,6380,2,PERF
42479412380000,PI,IP,001,6,9397,9399,6380,2,PERF
42479412380000,PI,IP,001,7,9491,9493,6380,2,PERF
42479412380000,PI,IP,001,8,9580,9582,6380,2,PERF
42479412380000,PI,IP,001,9,9679,9681,6380,2,PERF
42479412380000,PI,IP,001,10,9773,9775,6380,2,PERF
42479412380000,PI,IP,001,11,9867,9869,6380,2,PERF
42479412380000,PI,IP,001,12,9961,9963,6380,2,PERF
42479412380000,PI,IP,001,13,10055,10057,6380,2,PERF
42479412380000,PI,IP,001,14,10149,10151,6380,2,PERF
42479412380000,PI,IP,001,15,10243,10245,6380,2,PERF
42479412380000,PI,IP,001,16,10338,10340,6380,2,PERF
42479412380000,PI,IP,001,17,10432,10434,6380,2,PERF
42479412380000,PI,IP,001,18,10526,10528,6380,2,PERF
42479412380000,PI,IP,001,19,10620,10622,6380,2,PERF
42479412380000,PI,IP,001,20,10712,10714,6380,2,PERF
42479412380000,PI,IP,001,21,10804,10806,6380,2,PERF
42479412380000,PI,IP,001,22,10906,10908,6380,2,PERF
42479412380000,PI,IP,001,23,10996,10998,6380,2,PERF
42479412380000,PI,IP,001,24,11090,11092,6380,2,PERF
42479412380000,PI,IP,001,25,11184,11186,6380,2,PERF
42479412380000,PI,IP,001,26,11278,11280,6380,2,PERF
42479412380000,PI,IP,001,27,11372,11374,6380,2,PERF
42479412380000,PI,IP,001,28,11467,11469,6380,2,PERF
42479412380000,PI,IP,001,29,11561,11563,6380,2,PERF
42479412380000,PI,IP,001,30,11652,11654,6380,2,PERF
42479412380000,PI,IP,001,31,11744,11746,6380,2,PERF
42479412380000,PI,IP,001,32,11846,11848,6380,2,PERF
42479412380000,PI,IP,001,33,11938,11940,6380,2,PERF
42479412380000,PI,IP,001,34,12031,12033,6380,2,PERF
42479412380000,PI,IP,001,35,12125,12127,6380,2,PERF
42479412380000,PI,IP,001,36,12219,12221,6380,2,PERF
42479412380000,PI,IP,001,37,12313,12315,6380,2,PERF
42479412380000,PI,IP,001,38,12407,12409,6380,2,PERF
42479412380000,PI,IP,001,39,12501,12503,6380,2,PERF
42479412380000,PI,IP,001,40,12596,12598,6380,2,PERF
42479412380000,PI,IP,001,41,12690,12692,6380,2,PERF
42479412380000,PI,IP,001,42,12784,12786,6380,2,PERF
42479412380000,PI,IP,001,43,12878,12880,6380,2,PERF
42479412380000,PI,IP,001,44,12972,12974,6380,2,PERF
42479412380000,PI,IP,001,45,13062,13064,6380,2,PERF
42479412380000,PI,IP,001,46,13164,13166,6380,2,PERF
42479412380000,PI,IP,001,47,13256,13258,6380,2,PERF
42479412380000,PI,IP,001,48,13348,13350,6380,2,PERF
42479412380000,PI,IP,001,49,13442,13444,6380,2,PERF
42479412380000,PI,IP,001,50,13536,13538,6380,2,PERF
42479412380000,PI,IP,001,51,13630,13632,6380,2,PERF
42479412380000,PI,IP,001,52,13725,13727,6380,2,PERF
42479412380000,PI,IP,001,53,13819,13821,6380,2,PERF
42479412380000,PI,IP,001,54,13913,13915,6380,2,PERF
42479412380000,PI,IP,001,55,14007,14009,6380,2,PERF
42479412380000,PI,IP,001,56,14101,14103,6380,2,PERF
42479412380000,PI,IP,001,57,14206,14208,6380,2,PERF
42479412380000,PI,IP,001,58,14286,14288,6380,2,PERF
42479412380000,PI,IP,001,59,14366,14368,6380,2,PERF
42479412380000,PI,IP,001,60,14446,14448,6380,2,PERF
42479412400000,PI,IP,001,1,7580,14511,7396,6931,PERF
42479412410000,PI,IP,001,1,9312,14270,5862,4958,PERF
42479412430000,PI,IP,001,1,7509,14729,7526,7220,PERF
42479412440000,PI,IP,001,1,7596,14518,6861,6922,PERF
42479412450000,PI,IP,001,1,9479,15556,6877,6077,PERF
42479412460000,PI,IP,001,1,10690,14836,5798,4146,PERF
42479412470000,PI,IP,001,1,10020,15792,6402,5772,PERF
42479412480000,PI,IP,001,1,10318,10556,,238,PERF
42479412490000,PI,IP,001,1,7211,12207,5956,4996,PERF
42479412510000,PI,IP,001,1,9455,14922,6691,5467,PERF
42479412520000,PI,IP,001,1,8621,12418,4721,3797,PERF
42479412540000,PI,IP,001,1,8870,8872,5618,2,PERF
42479412540000,PI,IP,001,2,8951,8953,5618,2,PERF
42479412540000,PI,IP,001,3,9032,9034,5618,2,PERF
42479412540000,PI,IP,001,4,9116,9118,5618,2,PERF
42479412540000,PI,IP,001,5,9194,9196,5618,2,PERF
42479412540000,PI,IP,001,6,9275,9277,5618,2,PERF
42479412540000,PI,IP,001,7,9355,9357,5618,2,PERF
42479412540000,PI,IP,001,8,9436,9438,5618,2,PERF
42479412540000,PI,IP,001,9,9512,9514,5618,2,PERF
42479412540000,PI,IP,001,10,9598,9600,5618,2,PERF
42479412540000,PI,IP,001,11,9679,9681,5618,2,PERF
42479412540000,PI,IP,001,12,9759,9761,5618,2,PERF
42479412540000,PI,IP,001,13,9842,9844,5618,2,PERF
42479412540000,PI,IP,001,14,9920,9922,5618,2,PERF
42479412540000,PI,IP,001,15,10002,10004,5618,2,PERF
42479412540000,PI,IP,001,16,10083,10085,5618,2,PERF
42479412540000,PI,IP,001,17,10163,10165,5618,2,PERF
42479412540000,PI,IP,001,18,10238,10240,5618,2,PERF
42479412540000,PI,IP,001,19,10325,10327,5618,2,PERF
42479412540000,PI,IP,001,20,10406,10408,5618,2,PERF
42479412540000,PI,IP,001,21,10487,10489,5618,2,PERF
42479412540000,PI,IP,001,22,10567,10569,5618,2,PERF
42479412540000,PI,IP,001,23,10646,10648,5618,2,PERF
42479412540000,PI,IP,001,24,10729,10731,5618,2,PERF
42479412540000,PI,IP,001,25,10810,10812,5618,2,PERF
42479412540000,PI,IP,001,26,10891,10893,5618,2,PERF
42479412540000,PI,IP,001,27,10964,10966,5618,2,PERF
42479412540000,PI,IP,001,28,11052,11054,5618,2,PERF
42479412540000,PI,IP,001,29,11133,11135,5618,2,PERF
42479412540000,PI,IP,001,30,11214,11216,5618,2,PERF
42479412540000,PI,IP,001,31,11295,11297,5618,2,PERF
42479412540000,PI,IP,001,32,11371,11373,5618,2,PERF
42479412540000,PI,IP,001,33,11456,11458,5618,2,PERF
42479412540000,PI,IP,001,34,11537,11539,5618,2,PERF
42479412540000,PI,IP,001,35,11618,11620,5618,2,PERF
42479412540000,PI,IP,001,36,11699,11701,5618,2,PERF
42479412540000,PI,IP,001,37,11778,11780,5618,2,PERF
42479412540000,PI,IP,001,38,11860,11862,5618,2,PERF
42479412540000,PI,IP,001,39,11941,11943,5618,2,PERF
42479412540000,PI,IP,001,40,12022,12024,5618,2,PERF
42479412540000,PI,IP,001,41,12107,12109,5618,2,PERF
42479412540000,PI,IP,001,42,12184,12186,5618,2,PERF
42479412540000,PI,IP,001,43,12264,12266,5618,2,PERF
42479412540000,PI,IP,001,44,12345,12347,5618,2,PERF
42479412540000,PI,IP,001,45,12426,12428,5618,2,PERF
42479412540000,PI,IP,001,46,12504,12506,5618,2,PERF
42479412540000,PI,IP,001,47,12588,12590,5618,2,PERF
42479412540000,PI,IP,001,48,12668,12670,5618,2,PERF
42479412540000,PI,IP,001,49,12749,12751,5618,2,PERF
42479412540000,PI,IP,001,50,12830,12832,5618,2,PERF
42479412540000,PI,IP,001,51,12911,12913,5618,2,PERF
42479412540000,PI,IP,001,52,12992,12994,5618,2,PERF
42479412540000,PI,IP,001,53,13072,13074,5618,2,PERF
42479412540000,PI,IP,001,54,13153,13155,5618,2,PERF
42479412540000,PI,IP,001,55,13234,13236,5618,2,PERF
42479412540000,PI,IP,001,56,13315,13317,5618,2,PERF
42479412540000,PI,IP,001,57,13410,13412,5618,2,PERF
42479412540000,PI,IP,001,58,13485,13487,5618,2,PERF
42479412540000,PI,IP,001,59,13560,13562,5618,2,PERF
42479412540000,PI,IP,001,60,13635,13637,5618,2,PERF
42479412550000,PI,IP,001,1,6879,12055,6005,5176,PERF
42479412560000,PI,IP,001,1,7512,12141,6105,4629,PERF
42479412630000,PI,IP,001,1,8290,13380,6004,5090,PERF
42479412650000,PI,IP,001,1,7804,13241,6117,5437,PERF
42479412660000,PI,IP,001,1,7439,12202,6247,4763,PERF
42479412670000,PI,IP,001,1,7117,11191,5291,4074,PERF
42479412680000,PI,IP,001,1,11270,15904,4888,4634,PERF
42479412700000,PI,IP,001,1,10015,14694,5933,4679,PERF
42479412740000,PI,IP,001,1,10400,10797,,397,PERF
42479412740000,PI,IP,001,2,10886,15790,,4904,PERF
42479412760000,PI,IP,001,1,10030,14462,6015,4432,PERF
42479412810000,PI,PT,001,1,8915,13674,,4759,PERF
42479412820000,PI,PT,001,1,8938,13900,,4962,PERF
42479412830000,PI,IP,001,1,11920,15180,,3260,PERF
42479412850000,PI,IP,001,1,8892,13369,6134,4477,PERF
42479412860000,PI,PT,001,1,8854,13646,,4792,PERF
42479412870000,PI,IP,001,1,10074,14362,5260,4288,PERF
42479412890000,PI,IP,001,1,8343,13540,6257,5197,PERF
42479412970100,PI,IP,001,1,9575,14453,6464,4878,PERF
42479412990000,PI,IP,001,1,12204,16226,4964,4022,PERF
42479413000000,PI,IP,001,1,7616,14647,,7031,PERF
42479413060000,PI,IP,001,1,9821,16687,7816,6866,PERF
42479413070000,PI,IP,001,1,12644,15950,,3306,PERF
42479413080000,PI,IP,001,1,7870,12883,5990,5013,PERF
42479413090000,PI,IP,001,1,11274,15785,4620,4511,PERF
42479413120000,PI,IP,001,1,8546,16914,9207,8368,PERF
42479413140000,PI,IP,001,1,8319,16385,8196,8066,PERF
42479413150000,PI,PT,001,1,12667,17072,,4405,PERF
42479413160000,PI,IP,001,1,8653,13374,,4721,PERF
42479413170000,PI,IP,001,1,8444,16305,8000,7861,PERF
42479413180000,PI,IP,001,1,8383,13006,4738,4623,PERF
42479413210000,PI,IP,001,1,10300,10550,6944,250,PERF
42479413210000,PI,IP,001,2,10600,10850,6944,250,PERF
42479413210000,PI,IP,001,3,10900,11150,6944,250,PERF
42479413210000,PI,IP,001,4,11200,11450,6944,250,PERF
42479413210000,PI,IP,001,5,11500,11750,6944,250,PERF
42479413210000,PI,IP,001,6,11800,12050,6944,250,PERF
42479413210000,PI,IP,001,7,12100,12350,6944,250,PERF
42479413210000,PI,IP,001,8,12400,12650,6944,250,PERF
42479413210000,PI,IP,001,9,12700,12950,6944,250,PERF
42479413210000,PI,IP,001,10,13000,13250,6944,250,PERF
42479413210000,PI,IP,001,11,13300,13550,6944,250,PERF
42479413210000,PI,IP,001,12,13600,13850,6944,250,PERF
42479413210000,PI,IP,001,13,13900,14150,6944,250,PERF
42479413210000,PI,IP,001,14,14200,14450,6944,250,PERF
42479413210000,PI,IP,001,15,14500,14750,6944,250,PERF
42479413210000,PI,IP,001,16,14800,15050,6944,250,PERF
42479413210000,PI,IP,001,17,15100,15350,6944,250,PERF
42479413210000,PI,IP,001,18,15400,15650,6944,250,PERF
42479413210000,PI,IP,001,19,15700,15950,6944,250,PERF
42479413210000,PI,IP,001,20,16000,16250,6944,250,PERF
42479413250000,PI,IP,001,1,8517,13927,6170,5410,PERF
42479413270000,PI,IP,001,1,12200,12201,3955,1,PERF
42479413270000,PI,IP,001,2,12257,12258,3955,1,PERF
42479413270000,PI,IP,001,3,12314,12315,3955,1,PERF
42479413270000,PI,IP,001,4,12370,12371,3955,1,PERF
42479413270000,PI,IP,001,5,12427,12428,3955,1,PERF
42479413270000,PI,IP,001,6,12484,12485,3955,1,PERF
42479413270000,PI,IP,001,7,12541,12542,3955,1,PERF
42479413270000,PI,IP,001,8,12598,12599,3955,1,PERF
42479413270000,PI,IP,001,9,12654,12655,3955,1,PERF
42479413270000,PI,IP,001,10,12711,12712,3955,1,PERF
42479413270000,PI,IP,001,11,12768,12769,3955,1,PERF
42479413270000,PI,IP,001,12,12825,12826,3955,1,PERF
42479413270000,PI,IP,001,13,12882,12883,3955,1,PERF
42479413270000,PI,IP,001,14,12938,12939,3955,1,PERF
42479413270000,PI,IP,001,15,12995,12996,3955,1,PERF
42479413270000,PI,IP,001,16,13052,13053,3955,1,PERF
42479413270000,PI,IP,001,17,13109,13110,3955,1,PERF
42479413270000,PI,IP,001,18,13166,13167,3955,1,PERF
42479413270000,PI,IP,001,19,13222,13223,3955,1,PERF
42479413270000,PI,IP,001,20,13279,13280,3955,1,PERF
42479413270000,PI,IP,001,21,13336,13337,3955,1,PERF
42479413270000,PI,IP,001,22,13393,13394,3955,1,PERF
42479413270000,PI,IP,001,23,13450,13451,3955,1,PERF
42479413270000,PI,IP,001,24,13506,13507,3955,1,PERF
42479413270000,PI,IP,001,25,13563,13564,3955,1,PERF
42479413270000,PI,IP,001,26,13620,13621,3955,1,PERF
42479413270000,PI,IP,001,27,13677,13678,3955,1,PERF
42479413270000,PI,IP,001,28,13734,13735,3955,1,PERF
42479413270000,PI,IP,001,29,13790,13791,3955,1,PERF
42479413270000,PI,IP,001,30,13847,13848,3955,1,PERF
42479413270000,PI,IP,001,31,13904,13905,3955,1,PERF
42479413270000,PI,IP,001,32,13961,13962,3955,1,PERF
42479413270000,PI,IP,001,33,14018,14019,3955,1,PERF
42479413270000,PI,IP,001,34,14074,14075,3955,1,PERF
42479413270000,PI,IP,001,35,14131,14132,3955,1,PERF
42479413270000,PI,IP,001,36,14188,14189,3955,1,PERF
42479413270000,PI,IP,001,37,14245,14246,3955,1,PERF
42479413270000,PI,IP,001,38,14302,14303,3955,1,PERF
42479413270000,PI,IP,001,39,14358,14359,3955,1,PERF
42479413270000,PI,IP,001,40,14415,14416,3955,1,PERF
42479413270000,PI,IP,001,41,14472,14473,3955,1,PERF
42479413270000,PI,IP,001,42,14529,14530,3955,1,PERF
42479413270000,PI,IP,001,43,14586,14587,3955,1,PERF
42479413270000,PI,IP,001,44,14642,14643,3955,1,PERF
42479413270000,PI,IP,001,45,14699,14700,3955,1,PERF
42479413270000,PI,IP,001,46,14756,14757,3955,1,PERF
42479413270000,PI,IP,001,47,14813,14814,3955,1,PERF
42479413270000,PI,IP,001,48,14870,14871,3955,1,PERF
42479413270000,PI,IP,001,49,14926,14927,3955,1,PERF
42479413270000,PI,IP,001,50,14983,14984,3955,1,PERF
42479413270000,PI,IP,001,51,15040,15041,3955,1,PERF
42479413270000,PI,IP,001,52,15097,15098,3955,1,PERF
42479413270000,PI,IP,001,53,15154,15155,3955,1,PERF
42479413270000,PI,IP,001,54,15210,15211,3955,1,PERF
42479413270000,PI,IP,001,55,15262,15263,3955,1,PERF
42479413280000,PI,IP,001,1,10239,14882,5446,4643,PERF
42479413310000,PI,IP,001,1,8547,13178,,4631,PERF
42479413320000,PI,IP,001,1,8250,12848,4897,4598,PERF
42479413330000,PI,IP,001,1,12664,17250,5024,4586,PERF
42479413340000,PI,IP,001,1,10100,10350,6466,250,PERF
42479413340000,PI,IP,001,2,10400,10650,6466,250,PERF
42479413340000,PI,IP,001,3,10700,10950,6466,250,PERF
42479413340000,PI,IP,001,4,11000,11250,6466,250,PERF
42479413340000,PI,IP,001,5,11300,11550,6466,250,PERF
42479413340000,PI,IP,001,6,11600,11850,6466,250,PERF
42479413340000,PI,IP,001,7,11900,12150,6466,250,PERF
42479413340000,PI,IP,001,8,12200,12450,6466,250,PERF
42479413340000,PI,IP,001,9,12500,12750,6466,250,PERF
42479413340000,PI,IP,001,10,12800,13050,6466,250,PERF
42479413340000,PI,IP,001,11,13100,13350,6466,250,PERF
42479413340000,PI,IP,001,12,13400,13650,6466,250,PERF
42479413340000,PI,IP,001,13,13700,13950,6466,250,PERF
42479413340000,PI,IP,001,14,14000,14250,6466,250,PERF
42479413340000,PI,IP,001,15,14300,14550,6466,250,PERF
42479413340000,PI,IP,001,16,14600,14850,6466,250,PERF
42479413340000,PI,IP,001,17,14900,15150,6466,250,PERF
42479413340000,PI,IP,001,18,15200,15450,6466,250,PERF
42479413340000,PI,IP,001,19,15500,15750,6466,250,PERF
42479413340000,PI,IP,001,20,15800,16050,6466,250,PERF
42479413340000,PI,IP,001,21,16100,16350,6466,250,PERF
42479413360000,PI,IP,001,1,9555,14480,5930,4925,PERF
42479413370000,PI,IP,001,1,9616,13450,5605,3834,PERF
42479413380000,PI,IP,001,1,9890,14804,5672,4914,PERF
42479413400000,PI,IP,001,1,10000,10250,6760,250,PERF
42479413400000,PI,IP,001,2,10300,10550,6760,250,PERF
42479413400000,PI,IP,001,3,10600,10850,6760,250,PERF
42479413400000,PI,IP,001,4,10900,11150,6760,250,PERF
42479413400000,PI,IP,001,5,11200,11450,6760,250,PERF
42479413400000,PI,IP,001,6,11500,11750,6760,250,PERF
42479413400000,PI,IP,001,7,11800,12050,6760,250,PERF
42479413400000,PI,IP,001,8,12100,12350,6760,250,PERF
42479413400000,PI,IP,001,9,12400,12650,6760,250,PERF
42479413400000,PI,IP,001,10,12700,12950,6760,250,PERF
42479413400000,PI,IP,001,11,13000,13250,6760,250,PERF
42479413400000,PI,IP,001,12,13300,13550,6760,250,PERF
42479413400000,PI,IP,001,13,13600,13850,6760,250,PERF
42479413400000,PI,IP,001,14,13900,14150,6760,250,PERF
42479413400000,PI,IP,001,15,14200,14450,6760,250,PERF
42479413400000,PI,IP,001,16,14500,14750,6760,250,PERF
42479413400000,PI,IP,001,17,14800,15050,6760,250,PERF
42479413400000,PI,IP,001,18,15100,15350,6760,250,PERF
42479413400000,PI,IP,001,19,15400,15650,6760,250,PERF
42479413400000,PI,IP,001,20,15700,15950,6760,250,PERF
42479413400000,PI,IP,001,21,16000,16250,6760,250,PERF
42479413410000,PI,IP,001,1,9740,14294,6310,4554,PERF
42479413420000,PI,IP,001,1,9072,13935,6025,4863,PERF
42479413430000,PI,PT,001,1,9102,13334,,4232,PERF
42479413440000,PI,PT,001,1,9237,13876,,4639,PERF
42479413460000,PI,IP,001,1,9044,13394,5509,4350,PERF
42479413510000,PI,IP,001,1,10285,16076,8062,5791,PERF
42479413520000,PI,IP,001,1,9678,15928,7032,6250,PERF
42479413530000,PI,IP,001,1,10058,16585,7712,6527,PERF
42479413550000,PI,IP,001,1,10792,14703,4913,3911,PERF
42479413560000,PI,IP,001,1,8928,14657,6700,5729,PERF
42479413570000,PI,IP,001,1,11562,16649,7089,5087,PERF
42479413590000,PI,IP,001,1,8911,8912,6461,1,PERF
42479413590000,PI,IP,001,2,9050,9052,6461,2,PERF
42479413590000,PI,IP,001,3,9144,9146,6461,2,PERF
42479413590000,PI,IP,001,4,9238,9240,6461,2,PERF
42479413590000,PI,IP,001,5,9333,9335,6461,2,PERF
42479413590000,PI,IP,001,6,9427,9429,6461,2,PERF
42479413590000,PI,IP,001,7,9521,9523,6461,2,PERF
42479413590000,PI,IP,001,8,9616,9618,6461,2,PERF
42479413590000,PI,IP,001,9,9708,9710,6461,2,PERF
42479413590000,PI,IP,001,10,9800,9802,6461,2,PERF
42479413590000,PI,IP,001,11,9902,9904,6461,2,PERF
42479413590000,PI,IP,001,12,9994,9996,6461,2,PERF
42479413590000,PI,IP,001,13,10088,10090,6461,2,PERF
42479413590000,PI,IP,001,14,10182,10184,6461,2,PERF
42479413590000,PI,IP,001,15,10276,10278,6461,2,PERF
42479413590000,PI,IP,001,16,10371,10373,6461,2,PERF
42479413590000,PI,IP,001,17,10465,10467,6461,2,PERF
42479413590000,PI,IP,001,18,10559,10561,6461,2,PERF
42479413590000,PI,IP,001,19,10654,10656,6461,2,PERF
42479413590000,PI,IP,001,20,10748,10750,6461,2,PERF
42479413590000,PI,IP,001,21,10843,10845,6461,2,PERF
42479413590000,PI,IP,001,22,10936,10938,6461,2,PERF
42479413590000,PI,IP,001,23,11026,11028,6461,2,PERF
42479413590000,PI,IP,001,24,11128,11130,6461,2,PERF
42479413590000,PI,IP,001,25,11220,11222,6461,2,PERF
42479413590000,PI,IP,001,26,11314,11316,6461,2,PERF
42479413590000,PI,IP,001,27,11409,11411,6461,2,PERF
42479413590000,PI,IP,001,28,11503,11505,6461,2,PERF
42479413590000,PI,IP,001,29,11598,11600,6461,2,PERF
42479413590000,PI,IP,001,30,11692,11694,6461,2,PERF
42479413590000,PI,IP,001,31,11786,11788,6461,2,PERF
42479413590000,PI,IP,001,32,11881,11883,6461,2,PERF
42479413590000,PI,IP,001,33,11975,11977,6461,2,PERF
42479413590000,PI,IP,001,34,12069,12071,6461,2,PERF
42479413590000,PI,IP,001,35,12164,12166,6461,2,PERF
42479413590000,PI,IP,001,36,12252,12254,6461,2,PERF
42479413590000,PI,IP,001,37,12356,12358,6461,2,PERF
42479413590000,PI,IP,001,38,12448,12450,6461,2,PERF
42479413590000,PI,IP,001,39,12541,12543,6461,2,PERF
42479413590000,PI,IP,001,40,12636,12638,6461,2,PERF
42479413590000,PI,IP,001,41,12730,12732,6461,2,PERF
42479413590000,PI,IP,001,42,12824,12826,6461,2,PERF
42479413590000,PI,IP,001,43,12919,12921,6461,2,PERF
42479413590000,PI,IP,001,44,13013,13015,6461,2,PERF
42479413590000,PI,IP,001,45,13108,13110,6461,2,PERF
42479413590000,PI,IP,001,46,13202,13204,6461,2,PERF
42479413590000,PI,IP,001,47,13296,13298,6461,2,PERF
42479413590000,PI,IP,001,48,13390,13392,6461,2,PERF
42479413590000,PI,IP,001,49,13481,13483,6461,2,PERF
42479413590000,PI,IP,001,50,13571,13573,6461,2,PERF
42479413590000,PI,IP,001,51,13674,13676,6461,2,PERF
42479413590000,PI,IP,001,52,13768,13770,6461,2,PERF
42479413590000,PI,IP,001,53,13863,13865,6461,2,PERF
42479413590000,PI,IP,001,54,13957,13959,6461,2,PERF
42479413590000,PI,IP,001,55,14051,14053,6461,2,PERF
42479413590000,PI,IP,001,56,14146,14148,6461,2,PERF
42479413590000,PI,IP,001,57,14240,14242,6461,2,PERF
42479413590000,PI,IP,001,58,14320,14322,6461,2,PERF
42479413590000,PI,IP,001,59,14400,14402,6461,2,PERF
42479413590000,PI,IP,001,60,14480,14482,6461,2,PERF
42479413600000,PI,IP,001,1,8882,8884,6307,2,PERF
42479413600000,PI,IP,001,2,9020,9022,6307,2,PERF
42479413600000,PI,IP,001,3,9111,9113,6307,2,PERF
42479413600000,PI,IP,001,4,9202,9204,6307,2,PERF
42479413600000,PI,IP,001,5,9306,9308,6307,2,PERF
42479413600000,PI,IP,001,6,9396,9398,6307,2,PERF
42479413600000,PI,IP,001,7,9488,9490,6307,2,PERF
42479413600000,PI,IP,001,8,9579,9581,6307,2,PERF
42479413600000,PI,IP,001,9,9672,9674,6307,2,PERF
42479413600000,PI,IP,001,10,9764,9766,6307,2,PERF
42479413600000,PI,IP,001,11,9857,9859,6307,2,PERF
42479413600000,PI,IP,001,12,9950,9952,6307,2,PERF
42479413600000,PI,IP,001,13,10043,10045,6307,2,PERF
42479413600000,PI,IP,001,14,10136,10138,6307,2,PERF
42479413600000,PI,IP,001,15,10229,10231,6307,2,PERF
42479413600000,PI,IP,001,16,10322,10324,6307,2,PERF
42479413600000,PI,IP,001,17,10414,10416,6307,2,PERF
42479413600000,PI,IP,001,18,10507,10509,6307,2,PERF
42479413600000,PI,IP,001,19,10600,10602,6307,2,PERF
42479413600000,PI,IP,001,20,10693,10695,6307,2,PERF
42479413600000,PI,IP,001,21,10786,10788,6307,2,PERF
42479413600000,PI,IP,001,22,10879,10881,6307,2,PERF
42479413600000,PI,IP,001,23,10972,10974,6307,2,PERF
42479413600000,PI,IP,001,24,11064,11066,6307,2,PERF
42479413600000,PI,IP,001,25,11157,11159,6307,2,PERF
42479413600000,PI,IP,001,26,11250,11252,6307,2,PERF
42479413600000,PI,IP,001,27,11340,11342,6307,2,PERF
42479413600000,PI,IP,001,28,11432,11434,6307,2,PERF
42479413600000,PI,IP,001,29,11523,11525,6307,2,PERF
42479413600000,PI,IP,001,30,11616,11618,6307,2,PERF
42479413600000,PI,IP,001,31,11719,11721,6307,2,PERF
42479413600000,PI,IP,001,32,11810,11812,6307,2,PERF
42479413600000,PI,IP,001,33,11902,11904,6307,2,PERF
42479413600000,PI,IP,001,34,11993,11995,6307,2,PERF
42479413600000,PI,IP,001,35,12086,12088,6307,2,PERF
42479413600000,PI,IP,001,36,12179,12181,6307,2,PERF
42479413600000,PI,IP,001,37,12272,12274,6307,2,PERF
42479413600000,PI,IP,001,38,12365,12367,6307,2,PERF
42479413600000,PI,IP,001,39,12457,12459,6307,2,PERF
42479413600000,PI,IP,001,40,12550,12552,6307,2,PERF
42479413600000,PI,IP,001,41,12643,12645,6307,2,PERF
42479413600000,PI,IP,001,42,12736,12738,6307,2,PERF
42479413600000,PI,IP,001,43,12829,12831,6307,2,PERF
42479413600000,PI,IP,001,44,12922,12924,6307,2,PERF
42479413600000,PI,IP,001,45,13015,13017,6307,2,PERF
42479413600000,PI,IP,001,46,13107,13109,6307,2,PERF
42479413600000,PI,IP,001,47,13200,13202,6307,2,PERF
42479413600000,PI,IP,001,48,13293,13295,6307,2,PERF
42479413600000,PI,IP,001,49,13386,13388,6307,2,PERF
42479413600000,PI,IP,001,50,13479,13481,6307,2,PERF
42479413600000,PI,IP,001,51,13572,13574,6307,2,PERF
42479413600000,PI,IP,001,52,13663,13665,6307,2,PERF
42479413600000,PI,IP,001,53,13758,13760,6307,2,PERF
42479413600000,PI,IP,001,54,13850,13852,6307,2,PERF
42479413600000,PI,IP,001,55,13943,13945,6307,2,PERF
42479413600000,PI,IP,001,56,14036,14038,6307,2,PERF
42479413600000,PI,IP,001,57,14129,14131,6307,2,PERF
42479413600000,PI,IP,001,58,14209,14211,6307,2,PERF
42479413600000,PI,IP,001,59,14289,14291,6307,2,PERF
42479413600000,PI,IP,001,60,14369,14371,6307,2,PERF
42479413610000,PI,IP,001,1,8980,8982,6257,2,PERF
42479413610000,PI,IP,001,2,9114,9116,6257,2,PERF
42479413610000,PI,IP,001,3,9205,9207,6257,2,PERF
42479413610000,PI,IP,001,4,9299,9301,6257,2,PERF
42479413610000,PI,IP,001,5,9390,9392,6257,2,PERF
42479413610000,PI,IP,001,6,9480,9482,6257,2,PERF
42479413610000,PI,IP,001,7,9572,9574,6257,2,PERF
42479413610000,PI,IP,001,8,9674,9676,6257,2,PERF
42479413610000,PI,IP,001,9,9764,9766,6257,2,PERF
42479413610000,PI,IP,001,10,9857,9859,6257,2,PERF
42479413610000,PI,IP,001,11,9950,9952,6257,2,PERF
42479413610000,PI,IP,001,12,10043,10045,6257,2,PERF
42479413610000,PI,IP,001,13,10136,10138,6257,2,PERF
42479413610000,PI,IP,001,14,10229,10231,6257,2,PERF
42479413610000,PI,IP,001,15,10322,10324,6257,2,PERF
42479413610000,PI,IP,001,16,10414,10416,6257,2,PERF
42479413610000,PI,IP,001,17,10507,10509,6257,2,PERF
42479413610000,PI,IP,001,18,10600,10602,6257,2,PERF
42479413610000,PI,IP,001,19,10693,10695,6257,2,PERF
42479413610000,PI,IP,001,20,10786,10788,6257,2,PERF
42479413610000,PI,IP,001,21,10879,10881,6257,2,PERF
42479413610000,PI,IP,001,22,10972,10974,6257,2,PERF
42479413610000,PI,IP,001,23,11065,11067,6257,2,PERF
42479413610000,PI,IP,001,24,11158,11160,6257,2,PERF
42479413610000,PI,IP,001,25,11251,11253,6257,2,PERF
42479413610000,PI,IP,001,26,11342,11344,6257,2,PERF
42479413610000,PI,IP,001,27,11432,11434,6257,2,PERF
42479413610000,PI,IP,001,28,11526,11528,6257,2,PERF
42479413610000,PI,IP,001,29,11616,11618,6257,2,PERF
42479413610000,PI,IP,001,30,11720,11722,6257,2,PERF
42479413610000,PI,IP,001,31,11812,11814,6257,2,PERF
42479413610000,PI,IP,001,32,11901,11903,6257,2,PERF
42479413610000,PI,IP,001,33,11994,11996,6257,2,PERF
42479413610000,PI,IP,001,34,12087,12089,6257,2,PERF
42479413610000,PI,IP,001,35,12180,12182,6257,2,PERF
42479413610000,PI,IP,001,36,12273,12275,6257,2,PERF
42479413610000,PI,IP,001,37,12366,12368,6257,2,PERF
42479413610000,PI,IP,001,38,12459,12461,6257,2,PERF
42479413610000,PI,IP,001,39,12552,12554,6257,2,PERF
42479413610000,PI,IP,001,40,12644,12646,6257,2,PERF
42479413610000,PI,IP,001,41,12737,12739,6257,2,PERF
42479413610000,PI,IP,001,42,12830,12832,6257,2,PERF
42479413610000,PI,IP,001,43,12923,12925,6257,2,PERF
42479413610000,PI,IP,001,44,13016,13018,6257,2,PERF
42479413610000,PI,IP,001,45,13109,13111,6257,2,PERF
42479413610000,PI,IP,001,46,13202,13204,6257,2,PERF
42479413610000,PI,IP,001,47,13295,13297,6257,2,PERF
42479413610000,PI,IP,001,48,13388,13390,6257,2,PERF
42479413610000,PI,IP,001,49,13481,13483,6257,2,PERF
42479413610000,PI,IP,001,50,13572,13574,6257,2,PERF
42479413610000,PI,IP,001,51,13663,13665,6257,2,PERF
42479413610000,PI,IP,001,52,13754,13756,6257,2,PERF
42479413610000,PI,IP,001,53,13852,13854,6257,2,PERF
42479413610000,PI,IP,001,54,13945,13947,6257,2,PERF
42479413610000,PI,IP,001,55,14038,14040,6257,2,PERF
42479413610000,PI,IP,001,56,14131,14133,6257,2,PERF
42479413610000,PI,IP,001,57,14224,14226,6257,2,PERF
42479413610000,PI,IP,001,58,14304,14306,6257,2,PERF
42479413610000,PI,IP,001,59,14384,14386,6257,2,PERF
42479413610000,PI,IP,001,60,14464,14466,6257,2,PERF
42479413640000,PI,IP,001,1,9518,15425,6668,5907,PERF
42479413660000,PI,IP,001,1,8405,12422,5806,4017,PERF
42479413670000,PI,IP,001,1,8100,12758,5692,4658,PERF
42479413680000,PI,IP,001,1,8253,13245,5800,4992,PERF
42479413690100,PI,IP,001,1,10760,10761,5301,1,PERF
42479413690100,PI,IP,001,2,10816,10817,5301,1,PERF
42479413690100,PI,IP,001,3,10872,10873,5301,1,PERF
42479413690100,PI,IP,001,4,10928,10929,5301,1,PERF
42479413690100,PI,IP,001,5,10980,10981,5301,1,PERF
42479413690100,PI,IP,001,6,11041,11042,5301,1,PERF
42479413690100,PI,IP,001,7,11097,11098,5301,1,PERF
42479413690100,PI,IP,001,8,11153,11154,5301,1,PERF
42479413690100,PI,IP,001,9,11209,11210,5301,1,PERF
42479413690100,PI,IP,001,10,11265,11266,5301,1,PERF
42479413690100,PI,IP,001,11,11322,11323,5301,1,PERF
42479413690100,PI,IP,001,12,11378,11379,5301,1,PERF
42479413690100,PI,IP,001,13,11434,11435,5301,1,PERF
42479413690100,PI,IP,001,14,11490,11491,5301,1,PERF
42479413690100,PI,IP,001,15,11546,11547,5301,1,PERF
42479413690100,PI,IP,001,16,11603,11604,5301,1,PERF
42479413690100,PI,IP,001,17,11659,11660,5301,1,PERF
42479413690100,PI,IP,001,18,11715,11716,5301,1,PERF
42479413690100,PI,IP,001,19,11771,11772,5301,1,PERF
42479413690100,PI,IP,001,20,11810,11811,5301,1,PERF
42479413690100,PI,IP,001,21,11884,11885,5301,1,PERF
42479413690100,PI,IP,001,22,11940,11941,5301,1,PERF
42479413690100,PI,IP,001,23,11996,11997,5301,1,PERF
42479413690100,PI,IP,001,24,12052,12053,5301,1,PERF
42479413690100,PI,IP,001,25,12108,12109,5301,1,PERF
42479413690100,PI,IP,001,26,12165,12166,5301,1,PERF
42479413690100,PI,IP,001,27,12221,12222,5301,1,PERF
42479413690100,PI,IP,001,28,12277,12278,5301,1,PERF
42479413690100,PI,IP,001,29,12333,12334,5301,1,PERF
42479413690100,PI,IP,001,30,12389,12390,5301,1,PERF
42479413690100,PI,IP,001,31,12446,12447,5301,1,PERF
42479413690100,PI,IP,001,32,12502,12503,5301,1,PERF
42479413690100,PI,IP,001,33,12558,12559,5301,1,PERF
42479413690100,PI,IP,001,34,12614,12615,5301,1,PERF
42479413690100,PI,IP,001,35,12670,12671,5301,1,PERF
42479413690100,PI,IP,001,36,12727,12728,5301,1,PERF
42479413690100,PI,IP,001,37,12783,12784,5301,1,PERF
42479413690100,PI,IP,001,38,12839,12840,5301,1,PERF
42479413690100,PI,IP,001,39,12895,12896,5301,1,PERF
42479413690100,PI,IP,001,40,12951,12952,5301,1,PERF
42479413690100,PI,IP,001,41,13008,13009,5301,1,PERF
42479413690100,PI,IP,001,42,13064,13065,5301,1,PERF
42479413690100,PI,IP,001,43,13120,13121,5301,1,PERF
42479413690100,PI,IP,001,44,13176,13177,5301,1,PERF
42479413690100,PI,IP,001,45,13232,13233,5301,1,PERF
42479413690100,PI,IP,001,46,13289,13290,5301,1,PERF
42479413690100,PI,IP,001,47,13345,13346,5301,1,PERF
42479413690100,PI,IP,001,48,13401,13402,5301,1,PERF
42479413690100,PI,IP,001,49,13457,13458,5301,1,PERF
42479413690100,PI,IP,001,50,13513,13514,5301,1,PERF
42479413690100,PI,IP,001,51,13570,13571,5301,1,PERF
42479413690100,PI,IP,001,52,13626,13627,5301,1,PERF
42479413690100,PI,IP,001,53,13682,13683,5301,1,PERF
42479413690100,PI,IP,001,54,13738,13739,5301,1,PERF
42479413690100,PI,IP,001,55,13794,13795,5301,1,PERF
42479413690100,PI,IP,001,56,13851,13852,5301,1,PERF
42479413690100,PI,IP,001,57,13907,13908,5301,1,PERF
42479413690100,PI,IP,001,58,13963,13964,5301,1,PERF
42479413690100,PI,IP,001,59,14019,14020,5301,1,PERF
42479413690100,PI,IP,001,60,14075,14076,5301,1,PERF
42479413690100,PI,IP,001,61,14132,14133,5301,1,PERF
42479413690100,PI,IP,001,62,14188,14189,5301,1,PERF
42479413690100,PI,IP,001,63,14244,14245,5301,1,PERF
42479413690100,PI,IP,001,64,14300,14301,5301,1,PERF
42479413690100,PI,IP,001,65,14356,14357,5301,1,PERF
42479413690100,PI,IP,001,66,14413,14414,5301,1,PERF
42479413690100,PI,IP,001,67,14469,14470,5301,1,PERF
42479413690100,PI,IP,001,68,14525,14526,5301,1,PERF
42479413690100,PI,IP,001,69,14581,14582,5301,1,PERF
42479413690100,PI,IP,001,70,14637,14638,5301,1,PERF
42479413690100,PI,IP,001,71,14694,14695,5301,1,PERF
42479413690100,PI,IP,001,72,14750,14751,5301,1,PERF
42479413690100,PI,IP,001,73,14806,14807,5301,1,PERF
42479413690100,PI,IP,001,74,14862,14863,5301,1,PERF
42479413690100,PI,IP,001,75,14918,14919,5301,1,PERF
42479413690100,PI,IP,001,76,14975,14976,5301,1,PERF
42479413690100,PI,IP,001,77,15031,15032,5301,1,PERF
42479413690100,PI,IP,001,78,15087,15088,5301,1,PERF
42479413690100,PI,IP,001,79,15143,15144,5301,1,PERF
42479413690100,PI,IP,001,80,15199,15200,5301,1,PERF
42479413690100,PI,IP,001,81,15266,15268,5301,2,PERF
42479413690100,PI,IP,001,82,15319,15321,5301,2,PERF
42479413690100,PI,IP,001,83,15375,15377,5301,2,PERF
42479413690100,PI,IP,001,84,15434,15436,5301,2,PERF
42479413690100,PI,IP,001,85,15496,15498,5301,2,PERF
42479413700000,PI,IP,001,1,9400,15818,7343,6418,PERF
42479413710000,PI,IP,001,1,10200,10450,6615,250,PERF
42479413710000,PI,IP,001,2,10500,10750,6615,250,PERF
42479413710000,PI,IP,001,3,10800,11050,6615,250,PERF
42479413710000,PI,IP,001,4,11100,11350,6615,250,PERF
42479413710000,PI,IP,001,5,11400,11650,6615,250,PERF
42479413710000,PI,IP,001,6,11700,11950,6615,250,PERF
42479413710000,PI,IP,001,7,12000,12250,6615,250,PERF
42479413710000,PI,IP,001,8,12300,12550,6615,250,PERF
42479413710000,PI,IP,001,9,12600,12850,6615,250,PERF
42479413710000,PI,IP,001,10,12900,13150,6615,250,PERF
42479413710000,PI,IP,001,11,13200,13450,6615,250,PERF
42479413710000,PI,IP,001,12,13500,13750,6615,250,PERF
42479413710000,PI,IP,001,13,13800,14050,6615,250,PERF
42479413710000,PI,IP,001,14,14100,14350,6615,250,PERF
42479413710000,PI,IP,001,15,14400,14650,6615,250,PERF
42479413710000,PI,IP,001,16,14700,14950,6615,250,PERF
42479413710000,PI,IP,001,17,15000,15250,6615,250,PERF
42479413710000,PI,IP,001,18,15300,15550,6615,250,PERF
42479413710000,PI,IP,001,19,15600,15850,6615,250,PERF
42479413720000,PI,IP,001,1,9794,14755,5783,4961,PERF
42479413730000,PI,IP,001,1,8572,12548,4779,3976,PERF
42479413750000,PI,IP,001,1,9628,14683,7198,5055,PERF
42479413760000,PI,IP,001,1,9102,13325,5207,4223,PERF
42479413770000,PI,IP,001,1,9195,13266,5218,4071,PERF
42479413780000,PI,IP,001,1,9285,13345,5281,4060,PERF
42479413790000,PI,IP,001,1,9202,14052,5543,4850,PERF
42479413800000,PI,IP,001,1,9206,14068,5670,4862,PERF
42479413810000,PI,IP,001,1,9211,14001,5979,4790,PERF
42479414000000,PI,IP,001,1,8872,13630,5895,4758,PERF
42479414060000,PI,IP,001,1,9812,14551,5861,4739,PERF
42479414090000,PI,IP,001,1,10198,15970,6646,5772,PERF
42479414100000,PI,IP,001,1,9899,16062,6642,6163,PERF
42479414110000,PI,IP,001,1,8267,13357,6060,5090,PERF
42479414120000,PI,IP,001,1,9263,14440,6079,5177,PERF
42479414130000,PI,IP,001,1,9270,14036,5959,4766,PERF
42479414140000,PI,PT,001,1,9222,14070,,4848,PERF
42479414150000,PI,IP,001,1,9459,15185,6458,5726,PERF
42479414160000,PI,IP,001,1,9770,14851,6037,5081,PERF
42479414180000,PI,IP,001,1,9720,15314,6859,5594,PERF
42479414190000,PI,IP,001,1,9482,14373,6324,4891,PERF
42479414200000,PI,IP,001,1,10253,14901,5864,4648,PERF
42479414210000,PI,IP,001,1,9552,13020,4194,3468,PERF
42479414220000,PI,IP,001,1,9536,13080,6480,3544,PERF
42479414230000,PI,IP,001,1,9394,12096,6468,2702,PERF
42479414230000,PI,IP,001,2,12413,14629,6468,2216,PERF
42479414240000,PI,IP,001,1,9365,14224,6484,4859,PERF
42479414240000,PI,IP,001,2,14411,14666,6484,255,PERF
42479414250000,PI,IP,001,1,10097,14901,5826,4804,PERF
42479414260000,PI,IP,001,1,9420,14680,6526,5260,PERF
42479414270000,PI,IP,001,1,10350,10600,6800,250,PERF
42479414270000,PI,IP,001,2,10650,10900,6800,250,PERF
42479414270000,PI,IP,001,3,10950,11200,6800,250,PERF
42479414270000,PI,IP,001,4,11250,11500,6800,250,PERF
42479414270000,PI,IP,001,5,11550,11800,6800,250,PERF
42479414270000,PI,IP,001,6,11850,12100,6800,250,PERF
42479414270000,PI,IP,001,7,12150,12400,6800,250,PERF
42479414270000,PI,IP,001,8,12450,12700,6800,250,PERF
42479414270000,PI,IP,001,9,12750,13000,6800,250,PERF
42479414270000,PI,IP,001,10,13050,13300,6800,250,PERF
42479414270000,PI,IP,001,11,13350,13600,6800,250,PERF
42479414270000,PI,IP,001,12,13650,13900,6800,250,PERF
42479414270000,PI,IP,001,13,13950,14200,6800,250,PERF
42479414270000,PI,IP,001,14,14250,14500,6800,250,PERF
42479414270000,PI,IP,001,15,14550,14800,6800,250,PERF
42479414270000,PI,IP,001,16,14850,15100,6800,250,PERF
42479414270000,PI,IP,001,17,15150,15400,6800,250,PERF
42479414270000,PI,IP,001,18,15450,15700,6800,250,PERF
42479414270000,PI,IP,001,19,15750,16000,6800,250,PERF
42479414280000,PI,IP,001,1,9665,13898,5805,4233,PERF
42479414290000,PI,IP,001,1,9413,13665,5674,4252,PERF
42479414300000,PI,IP,001,1,9260,13893,5775,4633,PERF
42479414310000,PI,IP,001,1,9580,14039,5822,4459,PERF
42479414320000,PI,IP,001,1,9154,14429,6436,5275,PERF
42479414330000,PI,IP,001,1,9120,14427,6297,5307,PERF
42479414340000,PI,IP,001,1,9315,14388,6312,5073,PERF
42479414350000,PI,IP,001,1,9265,13763,5748,4498,PERF
42479414370000,PI,IP,001,1,9586,13965,5751,4379,PERF
42479414470000,PI,IP,001,1,10902,16593,6126,5691,PERF
42479414480000,PI,PT,001,1,11318,15438,,4120,PERF
42479414490000,PI,PT,001,1,10032,14984,,4952,PERF
42479414500000,PI,IP,001,1,10140,14490,5888,4350,PERF
42479414510000,PI,PT,001,1,10882,15049,,4167,PERF
42479414520000,PI,IP,001,1,8990,13542,5629,4552,PERF
42479414530000,PI,IP,001,1,9070,13426,5779,4356,PERF
42479414540000,PI,IP,001,1,9084,13832,5887,4748,PERF
42479414580000,PI,IP,001,1,8865,8867,6019,2,PERF
42479414580000,PI,IP,001,2,8994,8996,6019,2,PERF
42479414580000,PI,IP,001,3,9083,9085,6019,2,PERF
42479414580000,PI,IP,001,4,9174,9176,6019,2,PERF
42479414580000,PI,IP,001,5,9264,9266,6019,2,PERF
42479414580000,PI,IP,001,6,9355,9357,6019,2,PERF
42479414580000,PI,IP,001,7,9447,9449,6019,2,PERF
42479414580000,PI,IP,001,8,9526,9528,6019,2,PERF
42479414580000,PI,IP,001,9,9618,9620,6019,2,PERF
42479414580000,PI,IP,001,10,9708,9710,6019,2,PERF
42479414580000,PI,IP,001,11,9800,9802,6019,2,PERF
42479414580000,PI,IP,001,12,9890,9892,6019,2,PERF
42479414580000,PI,IP,001,13,9982,9984,6019,2,PERF
42479414580000,PI,IP,001,14,10072,10074,6019,2,PERF
42479414580000,PI,IP,001,15,10162,10164,6019,2,PERF
42479414580000,PI,IP,001,16,10252,10254,6019,2,PERF
42479414580000,PI,IP,001,17,10342,10344,6019,2,PERF
42479414580000,PI,IP,001,18,10432,10434,6019,2,PERF
42479414580000,PI,IP,001,19,10522,10524,6019,2,PERF
42479414580000,PI,IP,001,20,10612,10614,6019,2,PERF
42479414580000,PI,IP,001,21,10702,10704,6019,2,PERF
42479414580000,PI,IP,001,22,10792,10794,6019,2,PERF
42479414580000,PI,IP,001,23,10882,10884,6019,2,PERF
42479414580000,PI,IP,001,24,10972,10974,6019,2,PERF
42479414580000,PI,IP,001,25,11062,11064,6019,2,PERF
42479414580000,PI,IP,001,26,11152,11154,6019,2,PERF
42479414580000,PI,IP,001,27,11241,11243,6019,2,PERF
42479414580000,PI,IP,001,28,11331,11333,6019,2,PERF
42479414580000,PI,IP,001,29,11421,11423,6019,2,PERF
42479414580000,PI,IP,001,30,11511,11513,6019,2,PERF
42479414580000,PI,IP,001,31,11601,11603,6019,2,PERF
42479414580000,PI,IP,001,32,11691,11693,6019,2,PERF
42479414580000,PI,IP,001,33,11781,11783,6019,2,PERF
42479414580000,PI,IP,001,34,11871,11873,6019,2,PERF
42479414580000,PI,IP,001,35,11961,11963,6019,2,PERF
42479414580000,PI,IP,001,36,12051,12053,6019,2,PERF
42479414580000,PI,IP,001,37,12141,12143,6019,2,PERF
42479414580000,PI,IP,001,38,12231,12233,6019,2,PERF
42479414580000,PI,IP,001,39,12320,12322,6019,2,PERF
42479414580000,PI,IP,001,40,12410,12412,6019,2,PERF
42479414580000,PI,IP,001,41,12500,12502,6019,2,PERF
42479414580000,PI,IP,001,42,12590,12592,6019,2,PERF
42479414580000,PI,IP,001,43,12680,12682,6019,2,PERF
42479414580000,PI,IP,001,44,12770,12772,6019,2,PERF
42479414580000,PI,IP,001,45,12860,12862,6019,2,PERF
42479414580000,PI,IP,001,46,12950,12952,6019,2,PERF
42479414580000,PI,IP,001,47,13040,13042,6019,2,PERF
42479414580000,PI,IP,001,48,13130,13132,6019,2,PERF
42479414580000,PI,IP,001,49,13220,13222,6019,2,PERF
42479414580000,PI,IP,001,50,13310,13312,6019,2,PERF
42479414580000,PI,IP,001,51,13402,13404,6019,2,PERF
42479414580000,PI,IP,001,52,13493,13495,6019,2,PERF
42479414580000,PI,IP,001,53,13579,13581,6019,2,PERF
42479414580000,PI,IP,001,54,13669,13671,6019,2,PERF
42479414580000,PI,IP,001,55,13759,13761,6019,2,PERF
42479414580000,PI,IP,001,56,13849,13851,6019,2,PERF
42479414580000,PI,IP,001,57,13939,13941,6019,2,PERF
42479414580000,PI,IP,001,58,14019,14021,6019,2,PERF
42479414580000,PI,IP,001,59,14099,14101,6019,2,PERF
42479414580000,PI,IP,001,60,14179,14181,6019,2,PERF
42479414590000,PI,IP,001,1,8808,8810,5949,2,PERF
42479414590000,PI,IP,001,2,8925,8927,5949,2,PERF
42479414590000,PI,IP,001,3,9006,9008,5949,2,PERF
42479414590000,PI,IP,001,4,9096,9098,5949,2,PERF
42479414590000,PI,IP,001,5,9200,9202,5949,2,PERF
42479414590000,PI,IP,001,6,9276,9278,5949,2,PERF
42479414590000,PI,IP,001,7,9364,9366,5949,2,PERF
42479414590000,PI,IP,001,8,9452,9454,5949,2,PERF
42479414590000,PI,IP,001,9,9541,9543,5949,2,PERF
42479414590000,PI,IP,001,10,9629,9631,5949,2,PERF
42479414590000,PI,IP,001,11,9718,9720,5949,2,PERF
42479414590000,PI,IP,001,12,9806,9808,5949,2,PERF
42479414590000,PI,IP,001,13,9894,9896,5949,2,PERF
42479414590000,PI,IP,001,14,9983,9985,5949,2,PERF
42479414590000,PI,IP,001,15,10071,10073,5949,2,PERF
42479414590000,PI,IP,001,16,10159,10161,5949,2,PERF
42479414590000,PI,IP,001,17,10248,10250,5949,2,PERF
42479414590000,PI,IP,001,18,10338,10340,5949,2,PERF
42479414590000,PI,IP,001,19,10416,10418,5949,2,PERF
42479414590000,PI,IP,001,20,10508,10510,5949,2,PERF
42479414590000,PI,IP,001,21,10598,10600,5949,2,PERF
42479414590000,PI,IP,001,22,10689,10691,5949,2,PERF
42479414590000,PI,IP,001,23,10778,10780,5949,2,PERF
42479414590000,PI,IP,001,24,10866,10868,5949,2,PERF
42479414590000,PI,IP,001,25,10995,10997,5949,2,PERF
42479414590000,PI,IP,001,26,11043,11045,5949,2,PERF
42479414590000,PI,IP,001,27,11131,11133,5949,2,PERF
42479414590000,PI,IP,001,28,11220,11222,5949,2,PERF
42479414590000,PI,IP,001,29,11308,11310,5949,2,PERF
42479414590000,PI,IP,001,30,11396,11398,5949,2,PERF
42479414590000,PI,IP,001,31,11485,11487,5949,2,PERF
42479414590000,PI,IP,001,32,11573,11575,5949,2,PERF
42479414590000,PI,IP,001,33,11661,11663,5949,2,PERF
42479414590000,PI,IP,001,34,11750,11752,5949,2,PERF
42479414590000,PI,IP,001,35,11840,11842,5949,2,PERF
42479414590000,PI,IP,001,36,11920,11922,5949,2,PERF
42479414590000,PI,IP,001,37,12010,12012,5949,2,PERF
42479414590000,PI,IP,001,38,12101,12103,5949,2,PERF
42479414590000,PI,IP,001,39,12192,12194,5949,2,PERF
42479414590000,PI,IP,001,40,12280,12282,5949,2,PERF
42479414590000,PI,IP,001,41,12368,12370,5949,2,PERF
42479414590000,PI,IP,001,42,12457,12459,5949,2,PERF
42479414590000,PI,IP,001,43,12545,12547,5949,2,PERF
42479414590000,PI,IP,001,44,12633,12635,5949,2,PERF
42479414590000,PI,IP,001,45,12772,12774,5949,2,PERF
42479414590000,PI,IP,001,46,12810,12812,5949,2,PERF
42479414590000,PI,IP,001,47,12898,12900,5949,2,PERF
42479414590000,PI,IP,001,48,12987,12989,5949,2,PERF
42479414590000,PI,IP,001,49,13075,13077,5949,2,PERF
42479414590000,PI,IP,001,50,13163,13165,5949,2,PERF
42479414590000,PI,IP,001,51,13252,13254,5949,2,PERF
42479414590000,PI,IP,001,52,13344,13346,5949,2,PERF
42479414590000,PI,IP,001,53,13429,13431,5949,2,PERF
42479414590000,PI,IP,001,54,13517,13519,5949,2,PERF
42479414590000,PI,IP,001,55,13605,13607,5949,2,PERF
42479414590000,PI,IP,001,56,13694,13696,5949,2,PERF
42479414590000,PI,IP,001,57,13782,13784,5949,2,PERF
42479414590000,PI,IP,001,58,13862,13864,5949,2,PERF
42479414590000,PI,IP,001,59,13942,13944,5949,2,PERF
42479414590000,PI,IP,001,60,14022,14024,5949,2,PERF
42479414600000,PI,IP,001,1,8852,8854,5906,2,PERF
42479414600000,PI,IP,001,2,8985,8987,5906,2,PERF
42479414600000,PI,IP,001,3,9073,9075,5906,2,PERF
42479414600000,PI,IP,001,4,9161,9163,5906,2,PERF
42479414600000,PI,IP,001,5,9249,9251,5906,2,PERF
42479414600000,PI,IP,001,6,9337,9339,5906,2,PERF
42479414600000,PI,IP,001,7,9425,9427,5906,2,PERF
42479414600000,PI,IP,001,8,9513,9515,5906,2,PERF
42479414600000,PI,IP,001,9,9601,9603,5906,2,PERF
42479414600000,PI,IP,001,10,9688,9690,5906,2,PERF
42479414600000,PI,IP,001,11,9776,9778,5906,2,PERF
42479414600000,PI,IP,001,12,9864,9866,5906,2,PERF
42479414600000,PI,IP,001,13,9952,9954,5906,2,PERF
42479414600000,PI,IP,001,14,10040,10042,5906,2,PERF
42479414600000,PI,IP,001,15,10128,10130,5906,2,PERF
42479414600000,PI,IP,001,16,10218,10220,5906,2,PERF
42479414600000,PI,IP,001,17,10308,10310,5906,2,PERF
42479414600000,PI,IP,001,18,10388,10390,5906,2,PERF
42479414600000,PI,IP,001,19,10479,10481,5906,2,PERF
42479414600000,PI,IP,001,20,10567,10569,5906,2,PERF
42479414600000,PI,IP,001,21,10655,10657,5906,2,PERF
42479414600000,PI,IP,001,22,10743,10745,5906,2,PERF
42479414600000,PI,IP,001,23,10831,10833,5906,2,PERF
42479414600000,PI,IP,001,24,10919,10921,5906,2,PERF
42479414600000,PI,IP,001,25,11007,11009,5906,2,PERF
42479414600000,PI,IP,001,26,11095,11097,5906,2,PERF
42479414600000,PI,IP,001,27,11182,11184,5906,2,PERF
42479414600000,PI,IP,001,28,11270,11272,5906,2,PERF
42479414600000,PI,IP,001,29,11358,11360,5906,2,PERF
42479414600000,PI,IP,001,30,11446,11448,5906,2,PERF
42479414600000,PI,IP,001,31,11537,11539,5906,2,PERF
42479414600000,PI,IP,001,32,11616,11618,5906,2,PERF
42479414600000,PI,IP,001,33,11704,11706,5906,2,PERF
42479414600000,PI,IP,001,34,11798,11800,5906,2,PERF
42479414600000,PI,IP,001,35,11886,11888,5906,2,PERF
42479414600000,PI,IP,001,36,11973,11975,5906,2,PERF
42479414600000,PI,IP,001,37,12061,12063,5906,2,PERF
42479414600000,PI,IP,001,38,12149,12151,5906,2,PERF
42479414600000,PI,IP,001,39,12237,12239,5906,2,PERF
42479414600000,PI,IP,001,40,12325,12327,5906,2,PERF
42479414600000,PI,IP,001,41,12413,12415,5906,2,PERF
42479414600000,PI,IP,001,42,12501,12503,5906,2,PERF
42479414600000,PI,IP,001,43,12589,12591,5906,2,PERF
42479414600000,PI,IP,001,44,12677,12679,5906,2,PERF
42479414600000,PI,IP,001,45,12764,12766,5906,2,PERF
42479414600000,PI,IP,001,46,12855,12857,5906,2,PERF
42479414600000,PI,IP,001,47,12944,12946,5906,2,PERF
42479414600000,PI,IP,001,48,13023,13025,5906,2,PERF
42479414600000,PI,IP,001,49,13116,13118,5906,2,PERF
42479414600000,PI,IP,001,50,13204,13206,5906,2,PERF
42479414600000,PI,IP,001,51,13292,13294,5906,2,PERF
42479414600000,PI,IP,001,52,13380,13382,5906,2,PERF
42479414600000,PI,IP,001,53,13467,13469,5906,2,PERF
42479414600000,PI,IP,001,54,13555,13557,5906,2,PERF
42479414600000,PI,IP,001,55,13643,13645,5906,2,PERF
42479414600000,PI,IP,001,56,13731,13733,5906,2,PERF
42479414600000,PI,IP,001,57,13819,13821,5906,2,PERF
42479414600000,PI,IP,001,58,13895,13897,5906,2,PERF
42479414600000,PI,IP,001,59,13971,13973,5906,2,PERF
42479414600000,PI,IP,001,60,14047,14049,5906,2,PERF
42479414610000,PI,IP,001,1,9343,13093,7316,3750,PERF
42479414620000,PI,IP,001,1,11297,11766,,469,PERF
42479414620000,PI,IP,001,2,11791,12025,,234,PERF
42479414630000,PI,IP,001,1,7850,13818,6899,5968,PERF
42479414650000,PI,IP,001,1,8768,13338,5373,4570,PERF
42479414670000,PI,IP,001,1,8445,16312,,7867,PERF
42479414680000,PI,IP,001,1,8324,12765,6268,4441,PERF
42479414690000,PI,IP,001,1,8251,14130,,5879,PERF
42479414700000,PI,IP,001,1,8057,13482,5995,5425,PERF
42479414720000,PI,IP,001,1,9966,9967,4537,1,PERF
42479414720000,PI,IP,001,2,10025,10026,4537,1,PERF
42479414720000,PI,IP,001,3,10084,10085,4537,1,PERF
42479414720000,PI,IP,001,4,10144,10145,4537,1,PERF
42479414720000,PI,IP,001,5,10202,10203,4537,1,PERF
42479414720000,PI,IP,001,6,10261,10262,4537,1,PERF
42479414720000,PI,IP,001,7,10319,10320,4537,1,PERF
42479414720000,PI,IP,001,8,10379,10380,4537,1,PERF
42479414720000,PI,IP,001,9,10438,10439,4537,1,PERF
42479414720000,PI,IP,001,10,10497,10498,4537,1,PERF
42479414720000,PI,IP,001,11,10556,10557,4537,1,PERF
42479414720000,PI,IP,001,12,10615,10616,4537,1,PERF
42479414720000,PI,IP,001,13,10674,10675,4537,1,PERF
42479414720000,PI,IP,001,14,10733,10734,4537,1,PERF
42479414720000,PI,IP,001,15,10792,10793,4537,1,PERF
42479414720000,PI,IP,001,16,10851,10852,4537,1,PERF
42479414720000,PI,IP,001,17,10910,10911,4537,1,PERF
42479414720000,PI,IP,001,18,10969,10970,4537,1,PERF
42479414720000,PI,IP,001,19,11028,11029,4537,1,PERF
42479414720000,PI,IP,001,20,11087,11088,4537,1,PERF
42479414720000,PI,IP,001,21,11146,11147,4537,1,PERF
42479414720000,PI,IP,001,22,11205,11206,4537,1,PERF
42479414720000,PI,IP,001,23,11264,11265,4537,1,PERF
42479414720000,PI,IP,001,24,11323,11324,4537,1,PERF
42479414720000,PI,IP,001,25,11382,11383,4537,1,PERF
42479414720000,PI,IP,001,26,11441,11442,4537,1,PERF
42479414720000,PI,IP,001,27,11500,11501,4537,1,PERF
42479414720000,PI,IP,001,28,11559,11560,4537,1,PERF
42479414720000,PI,IP,001,29,11618,11619,4537,1,PERF
42479414720000,PI,IP,001,30,11677,11678,4537,1,PERF
42479414720000,PI,IP,001,31,11736,11737,4537,1,PERF
42479414720000,PI,IP,001,32,11795,11796,4537,1,PERF
42479414720000,PI,IP,001,33,11854,11855,4537,1,PERF
42479414720000,PI,IP,001,34,11913,11914,4537,1,PERF
42479414720000,PI,IP,001,35,11972,11973,4537,1,PERF
42479414720000,PI,IP,001,36,12031,12032,4537,1,PERF
42479414720000,PI,IP,001,37,12090,12091,4537,1,PERF
42479414720000,PI,IP,001,38,12149,12150,4537,1,PERF
42479414720000,PI,IP,001,39,12208,12209,4537,1,PERF
42479414720000,PI,IP,001,40,12267,12268,4537,1,PERF
42479414720000,PI,IP,001,41,12326,12327,4537,1,PERF
42479414720000,PI,IP,001,42,12385,12386,4537,1,PERF
42479414720000,PI,IP,001,43,12444,12445,4537,1,PERF
42479414720000,PI,IP,001,44,12503,12504,4537,1,PERF
42479414720000,PI,IP,001,45,12562,12563,4537,1,PERF
42479414720000,PI,IP,001,46,12621,12622,4537,1,PERF
42479414720000,PI,IP,001,47,12680,12681,4537,1,PERF
42479414720000,PI,IP,001,48,12739,12740,4537,1,PERF
42479414720000,PI,IP,001,49,12798,12799,4537,1,PERF
42479414720000,PI,IP,001,50,12857,12858,4537,1,PERF
42479414720000,PI,IP,001,51,12916,12917,4537,1,PERF
42479414720000,PI,IP,001,52,12975,12976,4537,1,PERF
42479414720000,PI,IP,001,53,13034,13035,4537,1,PERF
42479414720000,PI,IP,001,54,13093,13094,4537,1,PERF
42479414720000,PI,IP,001,55,13152,13153,4537,1,PERF
42479414720000,PI,IP,001,56,13230,13232,4537,2,PERF
42479414720000,PI,IP,001,57,13299,13301,4537,2,PERF
42479414720000,PI,IP,001,58,13369,13371,4537,2,PERF
42479414720000,PI,IP,001,59,13439,13441,4537,2,PERF
42479414720000,PI,IP,001,60,13508,13510,4537,2,PERF
42479414740000,PI,IP,001,1,8821,8823,6035,2,PERF
42479414740000,PI,IP,001,2,8948,8950,6035,2,PERF
42479414740000,PI,IP,001,3,9040,9042,6035,2,PERF
42479414740000,PI,IP,001,4,9131,9133,6035,2,PERF
42479414740000,PI,IP,001,5,9223,9225,6035,2,PERF
42479414740000,PI,IP,001,6,9314,9316,6035,2,PERF
42479414740000,PI,IP,001,7,9406,9408,6035,2,PERF
42479414740000,PI,IP,001,8,9497,9499,6035,2,PERF
42479414740000,PI,IP,001,9,9589,9591,6035,2,PERF
42479414740000,PI,IP,001,10,9680,9682,6035,2,PERF
42479414740000,PI,IP,001,11,9772,9774,6035,2,PERF
42479414740000,PI,IP,001,12,9863,9865,6035,2,PERF
42479414740000,PI,IP,001,13,9955,9957,6035,2,PERF
42479414740000,PI,IP,001,14,10046,10048,6035,2,PERF
42479414740000,PI,IP,001,15,10138,10140,6035,2,PERF
42479414740000,PI,IP,001,16,10229,10231,6035,2,PERF
42479414740000,PI,IP,001,17,10321,10323,6035,2,PERF
42479414740000,PI,IP,001,18,10412,10414,6035,2,PERF
42479414740000,PI,IP,001,19,10504,10506,6035,2,PERF
42479414740000,PI,IP,001,20,10596,10598,6035,2,PERF
42479414740000,PI,IP,001,21,10687,10689,6035,2,PERF
42479414740000,PI,IP,001,22,10779,10781,6035,2,PERF
42479414740000,PI,IP,001,23,10870,10872,6035,2,PERF
42479414740000,PI,IP,001,24,10962,10964,6035,2,PERF
42479414740000,PI,IP,001,25,11053,11055,6035,2,PERF
42479414740000,PI,IP,001,26,11145,11147,6035,2,PERF
42479414740000,PI,IP,001,27,11236,11238,6035,2,PERF
42479414740000,PI,IP,001,28,11328,11330,6035,2,PERF
42479414740000,PI,IP,001,29,11419,11421,6035,2,PERF
42479414740000,PI,IP,001,30,11511,11513,6035,2,PERF
42479414740000,PI,IP,001,31,11602,11604,6035,2,PERF
42479414740000,PI,IP,001,32,11694,11696,6035,2,PERF
42479414740000,PI,IP,001,33,11785,11787,6035,2,PERF
42479414740000,PI,IP,001,34,11877,11879,6035,2,PERF
42479414740000,PI,IP,001,35,11968,11970,6035,2,PERF
42479414740000,PI,IP,001,36,12060,12062,6035,2,PERF
42479414740000,PI,IP,001,37,12151,12153,6035,2,PERF
42479414740000,PI,IP,001,38,12243,12245,6035,2,PERF
42479414740000,PI,IP,001,39,12335,12337,6035,2,PERF
42479414740000,PI,IP,001,40,12426,12428,6035,2,PERF
42479414740000,PI,IP,001,41,12518,12520,6035,2,PERF
42479414740000,PI,IP,001,42,12609,12611,6035,2,PERF
42479414740000,PI,IP,001,43,12701,12703,6035,2,PERF
42479414740000,PI,IP,001,44,12792,12794,6035,2,PERF
42479414740000,PI,IP,001,45,12884,12886,6035,2,PERF
42479414740000,PI,IP,001,46,12975,12977,6035,2,PERF
42479414740000,PI,IP,001,47,13067,13069,6035,2,PERF
42479414740000,PI,IP,001,48,13158,13160,6035,2,PERF
42479414740000,PI,IP,001,49,13250,13252,6035,2,PERF
42479414740000,PI,IP,001,50,13341,13343,6035,2,PERF
42479414740000,PI,IP,001,51,13433,13435,6035,2,PERF
42479414740000,PI,IP,001,52,13522,13524,6035,2,PERF
42479414740000,PI,IP,001,53,13616,13618,6035,2,PERF
42479414740000,PI,IP,001,54,13707,13709,6035,2,PERF
42479414740000,PI,IP,001,55,13799,13801,6035,2,PERF
42479414740000,PI,IP,001,56,13890,13892,6035,2,PERF
42479414740000,PI,IP,001,57,13982,13984,6035,2,PERF
42479414740000,PI,IP,001,58,14062,14064,6035,2,PERF
42479414740000,PI,IP,001,59,14142,14144,6035,2,PERF
42479414740000,PI,IP,001,60,14222,14224,6035,2,PERF
42479414750000,PI,IP,001,1,8459,11871,5000,3412,PERF
42479414780000,PI,IP,001,1,8810,8812,5959,2,PERF
42479414780000,PI,IP,001,2,8930,8932,5959,2,PERF
42479414780000,PI,IP,001,3,9016,9018,5959,2,PERF
42479414780000,PI,IP,001,4,9103,9105,5959,2,PERF
42479414780000,PI,IP,001,5,9190,9192,5959,2,PERF
42479414780000,PI,IP,001,6,9276,9278,5959,2,PERF
42479414780000,PI,IP,001,7,9363,9365,5959,2,PERF
42479414780000,PI,IP,001,8,9450,9452,5959,2,PERF
42479414780000,PI,IP,001,9,9540,9542,5959,2,PERF
42479414780000,PI,IP,001,10,9619,9621,5959,2,PERF
42479414780000,PI,IP,001,11,9712,9714,5959,2,PERF
42479414780000,PI,IP,001,12,9797,9799,5959,2,PERF
42479414780000,PI,IP,001,13,9883,9885,5959,2,PERF
42479414780000,PI,IP,001,14,9870,9872,5959,2,PERF
42479414780000,PI,IP,001,15,10057,10059,5959,2,PERF
42479414780000,PI,IP,001,16,10143,10145,5959,2,PERF
42479414780000,PI,IP,001,17,10230,10232,5959,2,PERF
42479414780000,PI,IP,001,18,10317,10317,5959,0,PERF
42479414780000,PI,IP,001,19,10404,10406,5959,2,PERF
42479414780000,PI,IP,001,20,10482,10484,5959,2,PERF
42479414780000,PI,IP,001,21,10573,10575,5959,2,PERF
42479414780000,PI,IP,001,22,10666,10668,5959,2,PERF
42479414780000,PI,IP,001,23,10750,10752,5959,2,PERF
42479414780000,PI,IP,001,24,10837,10839,5959,2,PERF
42479414780000,PI,IP,001,25,10924,10926,5959,2,PERF
42479414780000,PI,IP,001,26,11010,11012,5959,2,PERF
42479414780000,PI,IP,001,27,11097,11099,5959,2,PERF
42479414780000,PI,IP,001,28,11184,11186,5959,2,PERF
42479414780000,PI,IP,001,29,11270,11272,5959,2,PERF
42479414780000,PI,IP,001,30,11357,11359,5959,2,PERF
42479414780000,PI,IP,001,31,11438,11440,5959,2,PERF
42479414780000,PI,IP,001,32,11530,11532,5959,2,PERF
42479414780000,PI,IP,001,33,11617,11619,5959,2,PERF
42479414780000,PI,IP,001,34,11704,11706,5959,2,PERF
42479414780000,PI,IP,001,35,11791,11793,5959,2,PERF
42479414780000,PI,IP,001,36,11877,11879,5959,2,PERF
42479414780000,PI,IP,001,37,11964,11966,5959,2,PERF
42479414780000,PI,IP,001,38,12051,12053,5959,2,PERF
42479414780000,PI,IP,001,39,12137,12139,5959,2,PERF
42479414780000,PI,IP,001,40,12224,12226,5959,2,PERF
42479414780000,PI,IP,001,41,12314,12316,5959,2,PERF
42479414780000,PI,IP,001,42,12392,12394,5959,2,PERF
42479414780000,PI,IP,001,43,12484,12486,5959,2,PERF
42479414780000,PI,IP,001,44,12571,12573,5959,2,PERF
42479414780000,PI,IP,001,45,12658,12660,5959,2,PERF
42479414780000,PI,IP,001,46,12744,12746,5959,2,PERF
42479414780000,PI,IP,001,47,12831,12832,5959,1,PERF
42479414780000,PI,IP,001,48,12918,12920,5959,2,PERF
42479414780000,PI,IP,001,49,13004,13006,5959,2,PERF
42479414780000,PI,IP,001,50,13091,13093,5959,2,PERF
42479414780000,PI,IP,001,51,13178,13180,5959,2,PERF
42479414780000,PI,IP,001,52,13258,13260,5959,2,PERF
42479414780000,PI,IP,001,53,13351,13353,5959,2,PERF
42479414780000,PI,IP,001,54,13438,13440,5959,2,PERF
42479414780000,PI,IP,001,55,13525,13527,5959,2,PERF
42479414780000,PI,IP,001,56,13611,13613,5959,2,PERF
42479414780000,PI,IP,001,57,13698,13700,5959,2,PERF
42479414780000,PI,IP,001,58,13769,13771,5959,2,PERF
42479414780000,PI,IP,001,59,13845,13847,5959,2,PERF
42479414780000,PI,IP,001,60,13921,13923,5959,2,PERF
42479414790000,PI,IP,001,1,8834,8836,5981,2,PERF
42479414790000,PI,IP,001,2,8956,8958,5981,2,PERF
42479414790000,PI,IP,001,3,9047,9049,5981,2,PERF
42479414790000,PI,IP,001,4,9135,9137,5981,2,PERF
42479414790000,PI,IP,001,5,9224,9226,5981,2,PERF
42479414790000,PI,IP,001,6,9312,9314,5981,2,PERF
42479414790000,PI,IP,001,7,9401,9403,5981,2,PERF
42479414790000,PI,IP,001,8,9489,9491,5981,2,PERF
42479414790000,PI,IP,001,9,9578,9580,5981,2,PERF
42479414790000,PI,IP,001,10,9666,9668,5981,2,PERF
42479414790000,PI,IP,001,11,9755,9757,5981,2,PERF
42479414790000,PI,IP,001,12,9843,9845,5981,2,PERF
42479414790000,PI,IP,001,13,9932,9934,5981,2,PERF
42479414790000,PI,IP,001,14,10021,10023,5981,2,PERF
42479414790000,PI,IP,001,15,10109,10111,5981,2,PERF
42479414790000,PI,IP,001,16,10200,10202,5981,2,PERF
42479414790000,PI,IP,001,17,10276,10278,5981,2,PERF
42479414790000,PI,IP,001,18,10370,10372,5981,2,PERF
42479414790000,PI,IP,001,19,10460,10462,5981,2,PERF
42479414790000,PI,IP,001,20,10550,10552,5981,2,PERF
42479414790000,PI,IP,001,21,10640,10642,5981,2,PERF
42479414790000,PI,IP,001,22,10729,10731,5981,2,PERF
42479414790000,PI,IP,001,23,10817,10819,5981,2,PERF
42479414790000,PI,IP,001,24,10906,10908,5981,2,PERF
42479414790000,PI,IP,001,25,10995,10997,5981,2,PERF
42479414790000,PI,IP,001,26,11083,11085,5981,2,PERF
42479414790000,PI,IP,001,27,11172,11174,5981,2,PERF
42479414790000,PI,IP,001,28,11260,11262,5981,2,PERF
42479414790000,PI,IP,001,29,11349,11351,5981,2,PERF
42479414790000,PI,IP,001,30,11437,11439,5981,2,PERF
42479414790000,PI,IP,001,31,11526,11528,5981,2,PERF
42479414790000,PI,IP,001,32,11614,11616,5981,2,PERF
42479414790000,PI,IP,001,33,11703,11705,5981,2,PERF
42479414790000,PI,IP,001,34,11791,11793,5981,2,PERF
42479414790000,PI,IP,001,35,11880,11882,5981,2,PERF
42479414790000,PI,IP,001,36,11972,11974,5981,2,PERF
42479414790000,PI,IP,001,37,12052,12054,5981,2,PERF
42479414790000,PI,IP,001,38,12144,12146,5981,2,PERF
42479414790000,PI,IP,001,39,12234,12236,5981,2,PERF
42479414790000,PI,IP,001,40,12323,12325,5981,2,PERF
42479414790000,PI,IP,001,41,12411,12413,5981,2,PERF
42479414790000,PI,IP,001,42,12500,12502,5981,2,PERF
42479414790000,PI,IP,001,43,12588,12590,5981,2,PERF
42479414790000,PI,IP,001,44,12677,12679,5981,2,PERF
42479414790000,PI,IP,001,45,12765,12767,5981,2,PERF
42479414790000,PI,IP,001,46,12854,12856,5981,2,PERF
42479414790000,PI,IP,001,47,12943,12945,5981,2,PERF
42479414790000,PI,IP,001,48,13031,13033,5981,2,PERF
42479414790000,PI,IP,001,49,13120,13122,5981,2,PERF
42479414790000,PI,IP,001,50,13208,13210,5981,2,PERF
42479414790000,PI,IP,001,51,13297,13299,5981,2,PERF
42479414790000,PI,IP,001,52,13385,13387,5981,2,PERF
42479414790000,PI,IP,001,53,13474,13476,5981,2,PERF
42479414790000,PI,IP,001,54,13562,13564,5981,2,PERF
42479414790000,PI,IP,001,55,13651,13653,5981,2,PERF
42479414790000,PI,IP,001,56,13739,13741,5981,2,PERF
42479414790000,PI,IP,001,57,13828,13830,5981,2,PERF
42479414790000,PI,IP,001,58,13904,13906,5981,2,PERF
42479414790000,PI,IP,001,59,13980,13982,5981,2,PERF
42479414790000,PI,IP,001,60,14056,14058,5981,2,PERF
42479414810000,PI,IP,001,1,12278,15702,4531,3424,PERF
42479414820000,PI,IP,001,1,9170,14227,6135,5057,PERF
42479414840000,PI,IP,001,1,9473,14530,6326,5057,PERF
42479414850000,PI,PT,001,1,7846,12730,,4884,PERF
42479414870000,PI,IP,001,1,9355,14916,6809,5561,PERF
42479414890000,PI,IP,001,1,9115,14808,6815,5693,PERF
42479414940000,PI,IP,001,1,8450,14073,6357,5623,PERF
42479414950000,PI,IP,001,1,10042,14331,6390,4289,PERF
42479414960000,PI,IP,001,1,9957,15551,6604,5594,PERF
42479414990000,PI,IP,001,1,9986,15604,6873,5618,PERF
42479415000000,PI,IP,001,1,9064,14073,5919,5009,PERF
42479415010000,PI,IP,001,1,9222,13963,5930,4741,PERF
42479415020000,PI,IP,001,1,9275,14116,5966,4841,PERF
42479415030000,PI,IP,001,1,8783,8785,6028,2,PERF
42479415030000,PI,IP,001,2,8908,8910,6028,2,PERF
42479415030000,PI,IP,001,3,8999,9001,6028,2,PERF
42479415030000,PI,IP,001,4,9090,9092,6028,2,PERF
42479415030000,PI,IP,001,5,9181,9183,6028,2,PERF
42479415030000,PI,IP,001,6,9272,9274,6028,2,PERF
42479415030000,PI,IP,001,7,9363,9365,6028,2,PERF
42479415030000,PI,IP,001,8,9454,9456,6028,2,PERF
42479415030000,PI,IP,001,9,9545,9547,6028,2,PERF
42479415030000,PI,IP,001,10,9636,9638,6028,2,PERF
42479415030000,PI,IP,001,11,9727,9729,6028,2,PERF
42479415030000,PI,IP,001,12,9818,9820,6028,2,PERF
42479415030000,PI,IP,001,13,9909,9911,6028,2,PERF
42479415030000,PI,IP,001,14,10000,10002,6028,2,PERF
42479415030000,PI,IP,001,15,10091,10093,6028,2,PERF
42479415030000,PI,IP,001,16,10182,10183,6028,1,PERF
42479415030000,PI,IP,001,17,10273,10275,6028,2,PERF
42479415030000,PI,IP,001,18,10364,10366,6028,2,PERF
42479415030000,PI,IP,001,19,10445,10447,6028,2,PERF
42479415030000,PI,IP,001,20,10546,10548,6028,2,PERF
42479415030000,PI,IP,001,21,10637,10639,6028,2,PERF
42479415030000,PI,IP,001,22,10728,10730,6028,2,PERF
42479415030000,PI,IP,001,23,10819,10821,6028,2,PERF
42479415030000,PI,IP,001,24,10910,10912,6028,2,PERF
42479415030000,PI,IP,001,25,11001,11003,6028,2,PERF
42479415030000,PI,IP,001,26,11091,11093,6028,2,PERF
42479415030000,PI,IP,001,27,11182,11184,6028,2,PERF
42479415030000,PI,IP,001,28,11273,11275,6028,2,PERF
42479415030000,PI,IP,001,29,11364,11366,6028,2,PERF
42479415030000,PI,IP,001,30,11455,11457,6028,2,PERF
42479415030000,PI,IP,001,31,11546,11548,6028,2,PERF
42479415030000,PI,IP,001,32,11637,11639,6028,2,PERF
42479415030000,PI,IP,001,33,11728,11730,6028,2,PERF
42479415030000,PI,IP,001,34,11819,11821,6028,2,PERF
42479415030000,PI,IP,001,35,11910,11912,6028,2,PERF
42479415030000,PI,IP,001,36,12001,12003,6028,2,PERF
42479415030000,PI,IP,001,37,12092,12094,6028,2,PERF
42479415030000,PI,IP,001,38,12183,12185,6028,2,PERF
42479415030000,PI,IP,001,39,12274,12276,6028,2,PERF
42479415030000,PI,IP,001,40,12365,12367,6028,2,PERF
42479415030000,PI,IP,001,41,12456,12458,6028,2,PERF
42479415030000,PI,IP,001,42,12547,12549,6028,2,PERF
42479415030000,PI,IP,001,43,12638,12640,6028,2,PERF
42479415030000,PI,IP,001,44,12729,12731,6028,2,PERF
42479415030000,PI,IP,001,45,12820,12822,6028,2,PERF
42479415030000,PI,IP,001,46,12911,12913,6028,2,PERF
42479415030000,PI,IP,001,47,13002,13004,6028,2,PERF
42479415030000,PI,IP,001,48,13093,13095,6028,2,PERF
42479415030000,PI,IP,001,49,13184,13186,6028,2,PERF
42479415030000,PI,IP,001,50,13275,13277,6028,2,PERF
42479415030000,PI,IP,001,51,13366,13368,6028,2,PERF
42479415030000,PI,IP,001,52,13457,13459,6028,2,PERF
42479415030000,PI,IP,001,53,13548,13550,6028,2,PERF
42479415030000,PI,IP,001,54,13639,13641,6028,2,PERF
42479415030000,PI,IP,001,55,13730,13731,6028,1,PERF
42479415030000,PI,IP,001,56,13821,13823,6028,2,PERF
42479415030000,PI,IP,001,57,13912,13914,6028,2,PERF
42479415030000,PI,IP,001,58,13992,13994,6028,2,PERF
42479415030000,PI,IP,001,59,14072,14074,6028,2,PERF
42479415030000,PI,IP,001,60,14152,14154,6028,2,PERF
42479415040000,PI,IP,001,1,8785,8787,6159,2,PERF
42479415040000,PI,IP,001,2,8910,8912,6159,2,PERF
42479415040000,PI,IP,001,3,9001,9003,6159,2,PERF
42479415040000,PI,IP,001,4,9092,9094,6159,2,PERF
42479415040000,PI,IP,001,5,9184,9186,6159,2,PERF
42479415040000,PI,IP,001,6,9275,9277,6159,2,PERF
42479415040000,PI,IP,001,7,9366,9368,6159,2,PERF
42479415040000,PI,IP,001,8,9457,9459,6159,2,PERF
42479415040000,PI,IP,001,9,9548,9550,6159,2,PERF
42479415040000,PI,IP,001,10,9639,9641,6159,2,PERF
42479415040000,PI,IP,001,11,9730,9732,6159,2,PERF
42479415040000,PI,IP,001,12,9821,9823,6159,2,PERF
42479415040000,PI,IP,001,13,9912,9914,6159,2,PERF
42479415040000,PI,IP,001,14,10003,10005,6159,2,PERF
42479415040000,PI,IP,001,15,10094,10096,6159,2,PERF
42479415040000,PI,IP,001,16,10185,10187,6159,2,PERF
42479415040000,PI,IP,001,17,10277,10279,6159,2,PERF
42479415040000,PI,IP,001,18,10368,10370,6159,2,PERF
42479415040000,PI,IP,001,19,10459,10461,6159,2,PERF
42479415040000,PI,IP,001,20,10550,10552,6159,2,PERF
42479415040000,PI,IP,001,21,10641,10643,6159,2,PERF
42479415040000,PI,IP,001,22,10732,10734,6159,2,PERF
42479415040000,PI,IP,001,23,10823,10825,6159,2,PERF
42479415040000,PI,IP,001,24,10914,10916,6159,2,PERF
42479415040000,PI,IP,001,25,11005,11007,6159,2,PERF
42479415040000,PI,IP,001,26,11096,11098,6159,2,PERF
42479415040000,PI,IP,001,27,11187,11189,6159,2,PERF
42479415040000,PI,IP,001,28,11279,11281,6159,2,PERF
42479415040000,PI,IP,001,29,11370,11372,6159,2,PERF
42479415040000,PI,IP,001,30,11461,11463,6159,2,PERF
42479415040000,PI,IP,001,31,11552,11554,6159,2,PERF
42479415040000,PI,IP,001,32,11643,11645,6159,2,PERF
42479415040000,PI,IP,001,33,11734,11736,6159,2,PERF
42479415040000,PI,IP,001,34,11825,11827,6159,2,PERF
42479415040000,PI,IP,001,35,11916,11918,6159,2,PERF
42479415040000,PI,IP,001,36,12007,12009,6159,2,PERF
42479415040000,PI,IP,001,37,12098,12100,6159,2,PERF
42479415040000,PI,IP,001,38,12189,12191,6159,2,PERF
42479415040000,PI,IP,001,39,12280,12282,6159,2,PERF
42479415040000,PI,IP,001,40,12372,12374,6159,2,PERF
42479415040000,PI,IP,001,41,12463,12465,6159,2,PERF
42479415040000,PI,IP,001,42,12554,12556,6159,2,PERF
42479415040000,PI,IP,001,43,12645,12647,6159,2,PERF
42479415040000,PI,IP,001,44,12736,12738,6159,2,PERF
42479415040000,PI,IP,001,45,12827,12829,6159,2,PERF
42479415040000,PI,IP,001,46,12918,12920,6159,2,PERF
42479415040000,PI,IP,001,47,13009,13011,6159,2,PERF
42479415040000,PI,IP,001,48,13100,13102,6159,2,PERF
42479415040000,PI,IP,001,49,13191,13193,6159,2,PERF
42479415040000,PI,IP,001,50,13282,13284,6159,2,PERF
42479415040000,PI,IP,001,51,13373,13375,6159,2,PERF
42479415040000,PI,IP,001,52,13465,13467,6159,2,PERF
42479415040000,PI,IP,001,53,13556,13558,6159,2,PERF
42479415040000,PI,IP,001,54,13674,13676,6159,2,PERF
42479415040000,PI,IP,001,55,13738,13740,6159,2,PERF
42479415040000,PI,IP,001,56,13829,13831,6159,2,PERF
42479415040000,PI,IP,001,57,13920,13922,6159,2,PERF
42479415040000,PI,IP,001,58,14000,14004,6159,4,PERF
42479415040000,PI,IP,001,59,14080,14082,6159,2,PERF
42479415040000,PI,IP,001,60,14160,14162,6159,2,PERF
42479415050000,PI,IP,001,1,8883,8885,6351,2,PERF
42479415050000,PI,IP,001,2,9008,9010,6351,2,PERF
42479415050000,PI,IP,001,3,9090,9098,6351,8,PERF
42479415050000,PI,IP,001,4,9190,9192,6351,2,PERF
42479415050000,PI,IP,001,5,9280,9282,6351,2,PERF
42479415050000,PI,IP,001,6,9377,9379,6351,2,PERF
42479415050000,PI,IP,001,7,9469,9471,6351,2,PERF
42479415050000,PI,IP,001,8,9561,9563,6351,2,PERF
42479415050000,PI,IP,001,9,9652,9654,6351,2,PERF
42479415050000,PI,IP,001,10,9744,9746,6351,2,PERF
42479415050000,PI,IP,001,11,9836,9838,6351,2,PERF
42479415050000,PI,IP,001,12,9928,9930,6351,2,PERF
42479415050000,PI,IP,001,13,10112,10114,6351,2,PERF
42479415050000,PI,IP,001,14,10204,10206,6351,2,PERF
42479415050000,PI,IP,001,15,10296,10298,6351,2,PERF
42479415050000,PI,IP,001,16,10387,10389,6351,2,PERF
42479415050000,PI,IP,001,17,10479,10481,6351,2,PERF
42479415050000,PI,IP,001,18,10571,10573,6351,2,PERF
42479415050000,PI,IP,001,19,10663,10665,6351,2,PERF
42479415050000,PI,IP,001,20,10754,10756,6351,2,PERF
42479415050000,PI,IP,001,21,10846,10848,6351,2,PERF
42479415050000,PI,IP,001,22,10936,10938,6351,2,PERF
42479415050000,PI,IP,001,23,11028,11030,6351,2,PERF
42479415050000,PI,IP,001,24,11118,11120,6351,2,PERF
42479415050000,PI,IP,001,25,11208,11210,6351,2,PERF
42479415050000,PI,IP,001,26,11300,11302,6351,2,PERF
42479415050000,PI,IP,001,27,11401,11403,6351,2,PERF
42479415050000,PI,IP,001,28,11492,11494,6351,2,PERF
42479415050000,PI,IP,001,29,11582,11584,6351,2,PERF
42479415050000,PI,IP,001,30,11674,11676,6351,2,PERF
42479415050000,PI,IP,001,31,11765,11767,6351,2,PERF
42479415050000,PI,IP,001,32,11857,11859,6351,2,PERF
42479415050000,PI,IP,001,33,11949,11951,6351,2,PERF
42479415050000,PI,IP,001,34,12041,12043,6351,2,PERF
42479415050000,PI,IP,001,35,12133,12135,6351,2,PERF
42479415050000,PI,IP,001,36,12225,12227,6351,2,PERF
42479415050000,PI,IP,001,37,12317,12319,6351,2,PERF
42479415050000,PI,IP,001,38,12408,12410,6351,2,PERF
42479415050000,PI,IP,001,39,12500,12502,6351,2,PERF
42479415050000,PI,IP,001,40,12592,12594,6351,2,PERF
42479415050000,PI,IP,001,41,12684,12686,6351,2,PERF
42479415050000,PI,IP,001,42,12776,12778,6351,2,PERF
42479415050000,PI,IP,001,43,12868,12870,6351,2,PERF
42479415050000,PI,IP,001,44,12960,12962,6351,2,PERF
42479415050000,PI,IP,001,45,13051,13053,6351,2,PERF
42479415050000,PI,IP,001,46,13143,13145,6351,2,PERF
42479415050000,PI,IP,001,47,13235,13237,6351,2,PERF
42479415050000,PI,IP,001,48,13327,13329,6351,2,PERF
42479415050000,PI,IP,001,49,13419,13421,6351,2,PERF
42479415050000,PI,IP,001,50,13511,13513,6351,2,PERF
42479415050000,PI,IP,001,51,13603,13605,6351,2,PERF
42479415050000,PI,IP,001,52,13695,13697,6351,2,PERF
42479415050000,PI,IP,001,53,13786,13788,6351,2,PERF
42479415050000,PI,IP,001,54,13878,13880,6351,2,PERF
42479415050000,PI,IP,001,55,13970,13972,6351,2,PERF
42479415050000,PI,IP,001,56,14062,14064,6351,2,PERF
42479415050000,PI,IP,001,57,14142,14144,6351,2,PERF
42479415050000,PI,IP,001,58,14222,14224,6351,2,PERF
42479415050000,PI,IP,001,59,14302,14304,6351,2,PERF
42479415060000,PI,IP,001,1,8650,14138,6296,5488,PERF
42479415080000,PI,IP,001,1,9585,13277,5330,3692,PERF
42479415090200,PI,IP,001,1,9642,14527,6001,4885,PERF
42479415100000,PI,IP,001,1,9723,14675,6115,4952,PERF
42479415110000,PI,IP,001,1,9723,14575,5934,4852,PERF
42479415140000,PI,IP,001,1,8988,13750,5294,4762,PERF
42479415150000,PI,IP,001,1,9096,12441,4489,3345,PERF
42479415190000,PI,IP,001,1,8600,13920,5887,5320,PERF
42479415220000,PI,IP,001,1,7744,12351,5336,4607,PERF
42479415230000,PI,IP,001,1,7809,12707,5618,4898,PERF
42479415250000,PI,IP,001,1,7777,12825,5752,5048,PERF
42479415270000,PI,IP,001,1,7604,12987,6302,5383,PERF
42479415310000,PI,IP,001,1,8793,8795,6203,2,PERF
42479415310000,PI,IP,001,2,8928,8930,6203,2,PERF
42479415310000,PI,IP,001,3,9019,9021,6203,2,PERF
42479415310000,PI,IP,001,4,9110,9112,6203,2,PERF
42479415310000,PI,IP,001,5,9201,9203,6203,2,PERF
42479415310000,PI,IP,001,6,9293,9295,6203,2,PERF
42479415310000,PI,IP,001,7,9384,9386,6203,2,PERF
42479415310000,PI,IP,001,8,9475,9477,6203,2,PERF
42479415310000,PI,IP,001,9,9566,9568,6203,2,PERF
42479415310000,PI,IP,001,10,9657,9659,6203,2,PERF
42479415310000,PI,IP,001,11,9749,9751,6203,2,PERF
42479415310000,PI,IP,001,12,9840,9842,6203,2,PERF
42479415310000,PI,IP,001,13,9931,9933,6203,2,PERF
42479415310000,PI,IP,001,14,10022,10024,6203,2,PERF
42479415310000,PI,IP,001,15,10113,10115,6203,2,PERF
42479415310000,PI,IP,001,16,10205,10207,6203,2,PERF
42479415310000,PI,IP,001,17,10296,10298,6203,2,PERF
42479415310000,PI,IP,001,18,10387,10389,6203,2,PERF
42479415310000,PI,IP,001,19,10478,10480,6203,2,PERF
42479415310000,PI,IP,001,20,10569,10571,6203,2,PERF
42479415310000,PI,IP,001,21,10661,10663,6203,2,PERF
42479415310000,PI,IP,001,22,10752,10754,6203,2,PERF
42479415310000,PI,IP,001,23,10843,10845,6203,2,PERF
42479415310000,PI,IP,001,24,10934,10936,6203,2,PERF
42479415310000,PI,IP,001,25,11025,11027,6203,2,PERF
42479415310000,PI,IP,001,26,11117,11119,6203,2,PERF
42479415310000,PI,IP,001,27,11208,11210,6203,2,PERF
42479415310000,PI,IP,001,28,11299,11301,6203,2,PERF
42479415310000,PI,IP,001,29,11390,11392,6203,2,PERF
42479415310000,PI,IP,001,30,11481,11483,6203,2,PERF
42479415310000,PI,IP,001,31,11573,11575,6203,2,PERF
42479415310000,PI,IP,001,32,11664,11666,6203,2,PERF
42479415310000,PI,IP,001,33,11755,11757,6203,2,PERF
42479415310000,PI,IP,001,34,11846,11848,6203,2,PERF
42479415310000,PI,IP,001,35,11938,11940,6203,2,PERF
42479415310000,PI,IP,001,36,12029,12031,6203,2,PERF
42479415310000,PI,IP,001,37,12120,12122,6203,2,PERF
42479415310000,PI,IP,001,38,12211,12213,6203,2,PERF
42479415310000,PI,IP,001,39,12302,12304,6203,2,PERF
42479415310000,PI,IP,001,40,12394,12396,6203,2,PERF
42479415310000,PI,IP,001,41,12485,12487,6203,2,PERF
42479415310000,PI,IP,001,42,12576,12578,6203,2,PERF
42479415310000,PI,IP,001,43,12667,12669,6203,2,PERF
42479415310000,PI,IP,001,44,12758,12760,6203,2,PERF
42479415310000,PI,IP,001,45,12850,12852,6203,2,PERF
42479415310000,PI,IP,001,46,12941,12943,6203,2,PERF
42479415310000,PI,IP,001,47,13032,13034,6203,2,PERF
42479415310000,PI,IP,001,48,13123,13125,6203,2,PERF
42479415310000,PI,IP,001,49,13214,13216,6203,2,PERF
42479415310000,PI,IP,001,50,13306,13308,6203,2,PERF
42479415310000,PI,IP,001,51,13397,13399,6203,2,PERF
42479415310000,PI,IP,001,52,13488,13490,6203,2,PERF
42479415310000,PI,IP,001,53,13579,13581,6203,2,PERF
42479415310000,PI,IP,001,54,13670,13672,6203,2,PERF
42479415310000,PI,IP,001,55,13762,13764,6203,2,PERF
42479415310000,PI,IP,001,56,13853,13855,6203,2,PERF
42479415310000,PI,IP,001,57,13944,13946,6203,2,PERF
42479415310000,PI,IP,001,58,14021,14023,6203,2,PERF
42479415310000,PI,IP,001,59,14098,14100,6203,2,PERF
42479415310000,PI,IP,001,60,14175,14177,6203,2,PERF
42479415320000,PI,IP,001,1,8883,8885,6161,2,PERF
42479415320000,PI,IP,001,2,9004,9006,6161,2,PERF
42479415320000,PI,IP,001,3,9092,9094,6161,2,PERF
42479415320000,PI,IP,001,4,9179,9181,6161,2,PERF
42479415320000,PI,IP,001,5,9267,9269,6161,2,PERF
42479415320000,PI,IP,001,6,9355,9357,6161,2,PERF
42479415320000,PI,IP,001,7,9443,9445,6161,2,PERF
42479415320000,PI,IP,001,8,9531,9533,6161,2,PERF
42479415320000,PI,IP,001,9,9619,9621,6161,2,PERF
42479415320000,PI,IP,001,10,9707,9709,6161,2,PERF
42479415320000,PI,IP,001,11,9795,9797,6161,2,PERF
42479415320000,PI,IP,001,12,9883,9885,6161,2,PERF
42479415320000,PI,IP,001,13,9971,9973,6161,2,PERF
42479415320000,PI,IP,001,14,10059,10061,6161,2,PERF
42479415320000,PI,IP,001,15,10147,10149,6161,2,PERF
42479415320000,PI,IP,001,16,10235,10237,6161,2,PERF
42479415320000,PI,IP,001,17,10323,10325,6161,2,PERF
42479415320000,PI,IP,001,18,10411,10413,6161,2,PERF
42479415320000,PI,IP,001,19,10498,10500,6161,2,PERF
42479415320000,PI,IP,001,20,10586,10588,6161,2,PERF
42479415320000,PI,IP,001,21,10674,10676,6161,2,PERF
42479415320000,PI,IP,001,22,10762,10764,6161,2,PERF
42479415320000,PI,IP,001,23,10850,10852,6161,2,PERF
42479415320000,PI,IP,001,24,10938,10940,6161,2,PERF
42479415320000,PI,IP,001,25,11026,11028,6161,2,PERF
42479415320000,PI,IP,001,26,11114,11116,6161,2,PERF
42479415320000,PI,IP,001,27,11202,11204,6161,2,PERF
42479415320000,PI,IP,001,28,11290,11292,6161,2,PERF
42479415320000,PI,IP,001,29,11378,11380,6161,2,PERF
42479415320000,PI,IP,001,30,11466,11468,6161,2,PERF
42479415320000,PI,IP,001,31,11554,11556,6161,2,PERF
42479415320000,PI,IP,001,32,11642,11644,6161,2,PERF
42479415320000,PI,IP,001,33,11730,11732,6161,2,PERF
42479415320000,PI,IP,001,34,11817,11819,6161,2,PERF
42479415320000,PI,IP,001,35,11905,11907,6161,2,PERF
42479415320000,PI,IP,001,36,11993,11995,6161,2,PERF
42479415320000,PI,IP,001,37,12081,12083,6161,2,PERF
42479415320000,PI,IP,001,38,12169,12171,6161,2,PERF
42479415320000,PI,IP,001,39,12257,12259,6161,2,PERF
42479415320000,PI,IP,001,40,12345,12347,6161,2,PERF
42479415320000,PI,IP,001,41,12433,12435,6161,2,PERF
42479415320000,PI,IP,001,42,12521,12523,6161,2,PERF
42479415320000,PI,IP,001,43,12609,12611,6161,2,PERF
42479415320000,PI,IP,001,44,12697,12699,6161,2,PERF
42479415320000,PI,IP,001,45,12785,12787,6161,2,PERF
42479415320000,PI,IP,001,46,12873,12875,6161,2,PERF
42479415320000,PI,IP,001,47,12961,12963,6161,2,PERF
42479415320000,PI,IP,001,48,13049,13051,6161,2,PERF
42479415320000,PI,IP,001,49,13137,13139,6161,2,PERF
42479415320000,PI,IP,001,50,13224,13226,6161,2,PERF
42479415320000,PI,IP,001,51,13312,13314,6161,2,PERF
42479415320000,PI,IP,001,52,13400,13402,6161,2,PERF
42479415320000,PI,IP,001,53,13488,13490,6161,2,PERF
42479415320000,PI,IP,001,54,13576,13578,6161,2,PERF
42479415320000,PI,IP,001,55,13664,13666,6161,2,PERF
42479415320000,PI,IP,001,56,13752,13754,6161,2,PERF
42479415320000,PI,IP,001,57,13840,13842,6161,2,PERF
42479415320000,PI,IP,001,58,13917,13919,6161,2,PERF
42479415320000,PI,IP,001,59,13994,13996,6161,2,PERF
42479415320000,PI,IP,001,60,14072,14074,6161,2,PERF
42479415330000,PI,IP,001,1,8887,8889,6145,2,PERF
42479415330000,PI,IP,001,2,9019,9021,6145,2,PERF
42479415330000,PI,IP,001,3,9108,9110,6145,2,PERF
42479415330000,PI,IP,001,4,9197,9199,6145,2,PERF
42479415330000,PI,IP,001,5,9286,9288,6145,2,PERF
42479415330000,PI,IP,001,6,9375,9377,6145,2,PERF
42479415330000,PI,IP,001,7,9464,9466,6145,2,PERF
42479415330000,PI,IP,001,8,9553,9555,6145,2,PERF
42479415330000,PI,IP,001,9,9642,9644,6145,2,PERF
42479415330000,PI,IP,001,10,9731,9733,6145,2,PERF
42479415330000,PI,IP,001,11,9820,9822,6145,2,PERF
42479415330000,PI,IP,001,12,9909,9911,6145,2,PERF
42479415330000,PI,IP,001,13,9998,10000,6145,2,PERF
42479415330000,PI,IP,001,14,10087,10089,6145,2,PERF
42479415330000,PI,IP,001,15,10176,10178,6145,2,PERF
42479415330000,PI,IP,001,16,10265,10267,6145,2,PERF
42479415330000,PI,IP,001,17,10354,10356,6145,2,PERF
42479415330000,PI,IP,001,18,10443,10445,6145,2,PERF
42479415330000,PI,IP,001,19,10532,10534,6145,2,PERF
42479415330000,PI,IP,001,20,10621,10623,6145,2,PERF
42479415330000,PI,IP,001,21,10710,10712,6145,2,PERF
42479415330000,PI,IP,001,22,10799,10801,6145,2,PERF
42479415330000,PI,IP,001,23,10888,10890,6145,2,PERF
42479415330000,PI,IP,001,24,10977,10979,6145,2,PERF
42479415330000,PI,IP,001,25,11066,11068,6145,2,PERF
42479415330000,PI,IP,001,26,11155,11157,6145,2,PERF
42479415330000,PI,IP,001,27,11244,11246,6145,2,PERF
42479415330000,PI,IP,001,28,11333,11335,6145,2,PERF
42479415330000,PI,IP,001,29,11422,11424,6145,2,PERF
42479415330000,PI,IP,001,30,11511,11513,6145,2,PERF
42479415330000,PI,IP,001,31,11601,11603,6145,2,PERF
42479415330000,PI,IP,001,32,11690,11692,6145,2,PERF
42479415330000,PI,IP,001,33,11779,11781,6145,2,PERF
42479415330000,PI,IP,001,34,11868,11870,6145,2,PERF
42479415330000,PI,IP,001,35,11957,11959,6145,2,PERF
42479415330000,PI,IP,001,36,12046,12048,6145,2,PERF
42479415330000,PI,IP,001,37,12135,12137,6145,2,PERF
42479415330000,PI,IP,001,38,12224,12226,6145,2,PERF
42479415330000,PI,IP,001,39,12313,12315,6145,2,PERF
42479415330000,PI,IP,001,40,12402,12404,6145,2,PERF
42479415330000,PI,IP,001,41,12491,12493,6145,2,PERF
42479415330000,PI,IP,001,42,12580,12582,6145,2,PERF
42479415330000,PI,IP,001,43,12669,12671,6145,2,PERF
42479415330000,PI,IP,001,44,12758,12760,6145,2,PERF
42479415330000,PI,IP,001,45,12847,12849,6145,2,PERF
42479415330000,PI,IP,001,46,12936,12938,6145,2,PERF
42479415330000,PI,IP,001,47,13025,13027,6145,2,PERF
42479415330000,PI,IP,001,48,13114,13116,6145,2,PERF
42479415330000,PI,IP,001,49,13203,13205,6145,2,PERF
42479415330000,PI,IP,001,50,13292,13294,6145,2,PERF
42479415330000,PI,IP,001,51,13381,13383,6145,2,PERF
42479415330000,PI,IP,001,52,13470,13472,6145,2,PERF
42479415330000,PI,IP,001,53,13559,13561,6145,2,PERF
42479415330000,PI,IP,001,54,13648,13650,6145,2,PERF
42479415330000,PI,IP,001,55,13737,13739,6145,2,PERF
42479415330000,PI,IP,001,56,13826,13828,6145,2,PERF
42479415330000,PI,IP,001,57,13915,13917,6145,2,PERF
42479415330000,PI,IP,001,58,13990,13992,6145,2,PERF
42479415330000,PI,IP,001,59,14065,14067,6145,2,PERF
42479415330000,PI,IP,001,60,14140,14142,6145,2,PERF
42479415340000,PI,IP,001,1,8802,8804,6533,2,PERF
42479415340000,PI,IP,001,2,8937,8939,6533,2,PERF
42479415340000,PI,IP,001,3,9030,9032,6533,2,PERF
42479415340000,PI,IP,001,4,9124,9126,6533,2,PERF
42479415340000,PI,IP,001,5,9217,9219,6533,2,PERF
42479415340000,PI,IP,001,6,9310,9312,6533,2,PERF
42479415340000,PI,IP,001,7,9404,9406,6533,2,PERF
42479415340000,PI,IP,001,8,9497,9499,6533,2,PERF
42479415340000,PI,IP,001,9,9591,9593,6533,2,PERF
42479415340000,PI,IP,001,10,9684,9686,6533,2,PERF
42479415340000,PI,IP,001,11,9778,9780,6533,2,PERF
42479415340000,PI,IP,001,12,9871,9873,6533,2,PERF
42479415340000,PI,IP,001,13,9964,9966,6533,2,PERF
42479415340000,PI,IP,001,14,10058,10060,6533,2,PERF
42479415340000,PI,IP,001,15,10151,10153,6533,2,PERF
42479415340000,PI,IP,001,16,10245,10247,6533,2,PERF
42479415340000,PI,IP,001,17,10338,10340,6533,2,PERF
42479415340000,PI,IP,001,18,10431,10433,6533,2,PERF
42479415340000,PI,IP,001,19,10525,10527,6533,2,PERF
42479415340000,PI,IP,001,20,10618,10620,6533,2,PERF
42479415340000,PI,IP,001,21,10712,10714,6533,2,PERF
42479415340000,PI,IP,001,22,10805,10807,6533,2,PERF
42479415340000,PI,IP,001,23,10899,10901,6533,2,PERF
42479415340000,PI,IP,001,24,10992,10994,6533,2,PERF
42479415340000,PI,IP,001,25,11085,11087,6533,2,PERF
42479415340000,PI,IP,001,26,11179,11181,6533,2,PERF
42479415340000,PI,IP,001,27,11272,11274,6533,2,PERF
42479415340000,PI,IP,001,28,11366,11368,6533,2,PERF
42479415340000,PI,IP,001,29,11459,11461,6533,2,PERF
42479415340000,PI,IP,001,30,11553,11555,6533,2,PERF
42479415340000,PI,IP,001,31,11646,11648,6533,2,PERF
42479415340000,PI,IP,001,32,11739,11741,6533,2,PERF
42479415340000,PI,IP,001,33,11833,11835,6533,2,PERF
42479415340000,PI,IP,001,34,11926,11928,6533,2,PERF
42479415340000,PI,IP,001,35,12020,12022,6533,2,PERF
42479415340000,PI,IP,001,36,12113,12115,6533,2,PERF
42479415340000,PI,IP,001,37,12207,12209,6533,2,PERF
42479415340000,PI,IP,001,38,12300,12302,6533,2,PERF
42479415340000,PI,IP,001,39,12393,12395,6533,2,PERF
42479415340000,PI,IP,001,40,12487,12489,6533,2,PERF
42479415340000,PI,IP,001,41,12580,12582,6533,2,PERF
42479415340000,PI,IP,001,42,12674,12676,6533,2,PERF
42479415340000,PI,IP,001,43,12767,12769,6533,2,PERF
42479415340000,PI,IP,001,44,12860,12862,6533,2,PERF
42479415340000,PI,IP,001,45,12954,12956,6533,2,PERF
42479415340000,PI,IP,001,46,13047,13049,6533,2,PERF
42479415340000,PI,IP,001,47,13141,13143,6533,2,PERF
42479415340000,PI,IP,001,48,13234,13236,6533,2,PERF
42479415340000,PI,IP,001,49,13328,13330,6533,2,PERF
42479415340000,PI,IP,001,50,13421,13423,6533,2,PERF
42479415340000,PI,IP,001,51,13514,13516,6533,2,PERF
42479415340000,PI,IP,001,52,13608,13610,6533,2,PERF
42479415340000,PI,IP,001,53,13701,13703,6533,2,PERF
42479415340000,PI,IP,001,54,13795,13797,6533,2,PERF
42479415340000,PI,IP,001,55,13888,13890,6533,2,PERF
42479415340000,PI,IP,001,56,13982,13984,6533,2,PERF
42479415340000,PI,IP,001,57,14075,14077,6533,2,PERF
42479415340000,PI,IP,001,58,14155,14157,6533,2,PERF
42479415340000,PI,IP,001,59,14235,14237,6533,2,PERF
42479415340000,PI,IP,001,60,14315,14317,6533,2,PERF
42479415350000,PI,IP,001,1,8792,8794,6414,2,PERF
42479415350000,PI,IP,001,2,8916,8918,6414,2,PERF
42479415350000,PI,IP,001,3,9006,9008,6414,2,PERF
42479415350000,PI,IP,001,4,9096,9098,6414,2,PERF
42479415350000,PI,IP,001,5,9186,9188,6414,2,PERF
42479415350000,PI,IP,001,6,9276,9278,6414,2,PERF
42479415350000,PI,IP,001,7,9365,9367,6414,2,PERF
42479415350000,PI,IP,001,8,9455,9457,6414,2,PERF
42479415350000,PI,IP,001,9,9545,9547,6414,2,PERF
42479415350000,PI,IP,001,10,9635,9637,6414,2,PERF
42479415350000,PI,IP,001,11,9725,9727,6414,2,PERF
42479415350000,PI,IP,001,12,9815,9817,6414,2,PERF
42479415350000,PI,IP,001,13,9905,9907,6414,2,PERF
42479415350000,PI,IP,001,14,9995,9997,6414,2,PERF
42479415350000,PI,IP,001,15,10085,10087,6414,2,PERF
42479415350000,PI,IP,001,16,10175,10177,6414,2,PERF
42479415350000,PI,IP,001,17,10265,10267,6414,2,PERF
42479415350000,PI,IP,001,18,10355,10357,6414,2,PERF
42479415350000,PI,IP,001,19,10445,10447,6414,2,PERF
42479415350000,PI,IP,001,20,10535,10537,6414,2,PERF
42479415350000,PI,IP,001,21,10625,10627,6414,2,PERF
42479415350000,PI,IP,001,22,10715,10717,6414,2,PERF
42479415350000,PI,IP,001,23,10805,10807,6414,2,PERF
42479415350000,PI,IP,001,24,10895,10897,6414,2,PERF
42479415350000,PI,IP,001,25,10985,10987,6414,2,PERF
42479415350000,PI,IP,001,26,11075,11077,6414,2,PERF
42479415350000,PI,IP,001,27,11164,11166,6414,2,PERF
42479415350000,PI,IP,001,28,11254,11256,6414,2,PERF
42479415350000,PI,IP,001,29,11344,11346,6414,2,PERF
42479415350000,PI,IP,001,30,11434,11436,6414,2,PERF
42479415350000,PI,IP,001,31,11524,11526,6414,2,PERF
42479415350000,PI,IP,001,32,11614,11616,6414,2,PERF
42479415350000,PI,IP,001,33,11704,11706,6414,2,PERF
42479415350000,PI,IP,001,34,11794,11796,6414,2,PERF
42479415350000,PI,IP,001,35,11884,11886,6414,2,PERF
42479415350000,PI,IP,001,36,11974,11976,6414,2,PERF
42479415350000,PI,IP,001,37,12064,12066,6414,2,PERF
42479415350000,PI,IP,001,38,12154,12156,6414,2,PERF
42479415350000,PI,IP,001,39,12244,12246,6414,2,PERF
42479415350000,PI,IP,001,40,12334,12336,6414,2,PERF
42479415350000,PI,IP,001,41,12424,12426,6414,2,PERF
42479415350000,PI,IP,001,42,12514,12516,6414,2,PERF
42479415350000,PI,IP,001,43,12604,12606,6414,2,PERF
42479415350000,PI,IP,001,44,12694,12696,6414,2,PERF
42479415350000,PI,IP,001,45,12784,12786,6414,2,PERF
42479415350000,PI,IP,001,46,12874,12876,6414,2,PERF
42479415350000,PI,IP,001,47,12963,12965,6414,2,PERF
42479415350000,PI,IP,001,48,13053,13055,6414,2,PERF
42479415350000,PI,IP,001,49,13143,13145,6414,2,PERF
42479415350000,PI,IP,001,50,13233,13235,6414,2,PERF
42479415350000,PI,IP,001,51,13323,13325,6414,2,PERF
42479415350000,PI,IP,001,52,13413,13415,6414,2,PERF
42479415350000,PI,IP,001,53,13503,13505,6414,2,PERF
42479415350000,PI,IP,001,54,13593,13595,6414,2,PERF
42479415350000,PI,IP,001,55,13683,13685,6414,2,PERF
42479415350000,PI,IP,001,56,13773,13775,6414,2,PERF
42479415350000,PI,IP,001,57,13863,13865,6414,2,PERF
42479415350000,PI,IP,001,58,13963,13965,6414,2,PERF
42479415350000,PI,IP,001,59,14023,14025,6414,2,PERF
42479415350000,PI,IP,001,60,14103,14105,6414,2,PERF
42479415370000,PI,IP,001,1,8809,8811,6579,2,PERF
42479415370000,PI,IP,001,2,8934,8936,6579,2,PERF
42479415370000,PI,IP,001,3,9025,9027,6579,2,PERF
42479415370000,PI,IP,001,4,9117,9119,6579,2,PERF
42479415370000,PI,IP,001,5,9208,9210,6579,2,PERF
42479415370000,PI,IP,001,6,9299,9301,6579,2,PERF
42479415370000,PI,IP,001,7,9390,9392,6579,2,PERF
42479415370000,PI,IP,001,8,9481,9483,6579,2,PERF
42479415370000,PI,IP,001,9,9572,9574,6579,2,PERF
42479415370000,PI,IP,001,10,9663,9665,6579,2,PERF
42479415370000,PI,IP,001,11,9754,9756,6579,2,PERF
42479415370000,PI,IP,001,12,9845,9847,6579,2,PERF
42479415370000,PI,IP,001,13,9936,9938,6579,2,PERF
42479415370000,PI,IP,001,14,10028,10030,6579,2,PERF
42479415370000,PI,IP,001,15,10119,10121,6579,2,PERF
42479415370000,PI,IP,001,16,10210,10212,6579,2,PERF
42479415370000,PI,IP,001,17,10301,10303,6579,2,PERF
42479415370000,PI,IP,001,18,10392,10394,6579,2,PERF
42479415370000,PI,IP,001,19,10483,10485,6579,2,PERF
42479415370000,PI,IP,001,20,10574,10576,6579,2,PERF
42479415370000,PI,IP,001,21,10665,10667,6579,2,PERF
42479415370000,PI,IP,001,22,10756,10758,6579,2,PERF
42479415370000,PI,IP,001,23,10848,10850,6579,2,PERF
42479415370000,PI,IP,001,24,10939,10941,6579,2,PERF
42479415370000,PI,IP,001,25,11030,11032,6579,2,PERF
42479415370000,PI,IP,001,26,11121,11123,6579,2,PERF
42479415370000,PI,IP,001,27,11212,11214,6579,2,PERF
42479415370000,PI,IP,001,28,11303,11305,6579,2,PERF
42479415370000,PI,IP,001,29,11394,11396,6579,2,PERF
42479415370000,PI,IP,001,30,11485,11487,6579,2,PERF
42479415370000,PI,IP,001,31,11576,11578,6579,2,PERF
42479415370000,PI,IP,001,32,11667,11669,6579,2,PERF
42479415370000,PI,IP,001,33,11759,11761,6579,2,PERF
42479415370000,PI,IP,001,34,11850,11852,6579,2,PERF
42479415370000,PI,IP,001,35,11941,11943,6579,2,PERF
42479415370000,PI,IP,001,36,12032,12034,6579,2,PERF
42479415370000,PI,IP,001,37,12123,12125,6579,2,PERF
42479415370000,PI,IP,001,38,12214,12216,6579,2,PERF
42479415370000,PI,IP,001,39,12305,12307,6579,2,PERF
42479415370000,PI,IP,001,40,12396,12398,6579,2,PERF
42479415370000,PI,IP,001,41,12487,12489,6579,2,PERF
42479415370000,PI,IP,001,42,12578,12580,6579,2,PERF
42479415370000,PI,IP,001,43,12670,12672,6579,2,PERF
42479415370000,PI,IP,001,44,12761,12763,6579,2,PERF
42479415370000,PI,IP,001,45,12852,12854,6579,2,PERF
42479415370000,PI,IP,001,46,12943,12945,6579,2,PERF
42479415370000,PI,IP,001,47,13034,13036,6579,2,PERF
42479415370000,PI,IP,001,48,13125,13127,6579,2,PERF
42479415370000,PI,IP,001,49,13216,13218,6579,2,PERF
42479415370000,PI,IP,001,50,13307,13309,6579,2,PERF
42479415370000,PI,IP,001,51,13398,13400,6579,2,PERF
42479415370000,PI,IP,001,52,13489,13491,6579,2,PERF
42479415370000,PI,IP,001,53,13581,13583,6579,2,PERF
42479415370000,PI,IP,001,54,13672,13674,6579,2,PERF
42479415370000,PI,IP,001,55,13763,13765,6579,2,PERF
42479415370000,PI,IP,001,56,13854,13856,6579,2,PERF
42479415370000,PI,IP,001,57,13945,13947,6579,2,PERF
42479415370000,PI,IP,001,58,14025,14027,6579,2,PERF
42479415370000,PI,IP,001,59,14115,14117,6579,2,PERF
42479415370000,PI,IP,001,60,14195,14197,6579,2,PERF
42479415380000,PI,IP,001,1,11410,14920,3637,3510,PERF
42479415410000,PI,IP,001,1,11710,17276,5500,5566,PERF
42479415420000,PI,IP,001,1,8900,8902,6106,2,PERF
42479415420000,PI,IP,001,2,8982,8984,6106,2,PERF
42479415420000,PI,IP,001,3,9064,9066,6106,2,PERF
42479415420000,PI,IP,001,4,9146,9148,6106,2,PERF
42479415420000,PI,IP,001,5,9228,9230,6106,2,PERF
42479415420000,PI,IP,001,6,9310,9312,6106,2,PERF
42479415420000,PI,IP,001,7,9392,9394,6106,2,PERF
42479415420000,PI,IP,001,8,9474,9476,6106,2,PERF
42479415420000,PI,IP,001,9,9556,9558,6106,2,PERF
42479415420000,PI,IP,001,10,9638,9640,6106,2,PERF
42479415420000,PI,IP,001,11,9720,9722,6106,2,PERF
42479415420000,PI,IP,001,12,9802,9804,6106,2,PERF
42479415420000,PI,IP,001,13,9884,9886,6106,2,PERF
42479415420000,PI,IP,001,14,9966,9968,6106,2,PERF
42479415420000,PI,IP,001,15,10048,10050,6106,2,PERF
42479415420000,PI,IP,001,16,10130,10132,6106,2,PERF
42479415420000,PI,IP,001,17,10212,10214,6106,2,PERF
42479415420000,PI,IP,001,18,10294,10296,6106,2,PERF
42479415420000,PI,IP,001,19,10376,10378,6106,2,PERF
42479415420000,PI,IP,001,20,10458,10460,6106,2,PERF
42479415420000,PI,IP,001,21,10540,10542,6106,2,PERF
42479415420000,PI,IP,001,22,10622,10624,6106,2,PERF
42479415420000,PI,IP,001,23,10704,10706,6106,2,PERF
42479415420000,PI,IP,001,24,10786,10788,6106,2,PERF
42479415420000,PI,IP,001,25,10868,10870,6106,2,PERF
42479415420000,PI,IP,001,26,10950,10952,6106,2,PERF
42479415420000,PI,IP,001,27,11032,11034,6106,2,PERF
42479415420000,PI,IP,001,28,11114,11116,6106,2,PERF
42479415420000,PI,IP,001,29,11196,11198,6106,2,PERF
42479415420000,PI,IP,001,30,11278,11280,6106,2,PERF
42479415420000,PI,IP,001,31,11360,11362,6106,2,PERF
42479415420000,PI,IP,001,32,11442,11444,6106,2,PERF
42479415420000,PI,IP,001,33,11524,11526,6106,2,PERF
42479415420000,PI,IP,001,34,11606,11608,6106,2,PERF
42479415420000,PI,IP,001,35,11688,11690,6106,2,PERF
42479415420000,PI,IP,001,36,11770,11772,6106,2,PERF
42479415420000,PI,IP,001,37,11852,11854,6106,2,PERF
42479415420000,PI,IP,001,38,11934,11936,6106,2,PERF
42479415420000,PI,IP,001,39,12016,12018,6106,2,PERF
42479415420000,PI,IP,001,40,12098,12100,6106,2,PERF
42479415420000,PI,IP,001,41,12180,12182,6106,2,PERF
42479415420000,PI,IP,001,42,12262,12264,6106,2,PERF
42479415420000,PI,IP,001,43,12344,12346,6106,2,PERF
42479415420000,PI,IP,001,44,12426,12428,6106,2,PERF
42479415420000,PI,IP,001,45,12508,12510,6106,2,PERF
42479415420000,PI,IP,001,46,12590,12592,6106,2,PERF
42479415420000,PI,IP,001,47,12672,12674,6106,2,PERF
42479415420000,PI,IP,001,48,12754,12756,6106,2,PERF
42479415420000,PI,IP,001,49,12836,12838,6106,2,PERF
42479415420000,PI,IP,001,50,12918,12920,6106,2,PERF
42479415420000,PI,IP,001,51,13000,13002,6106,2,PERF
42479415420000,PI,IP,001,52,13082,13084,6106,2,PERF
42479415420000,PI,IP,001,53,13164,13166,6106,2,PERF
42479415420000,PI,IP,001,54,13246,13248,6106,2,PERF
42479415420000,PI,IP,001,55,13328,13330,6106,2,PERF
42479415420000,PI,IP,001,56,13410,13412,6106,2,PERF
42479415420000,PI,IP,001,57,13492,13494,6106,2,PERF
42479415420000,PI,IP,001,58,13574,13576,6106,2,PERF
42479415420000,PI,IP,001,59,13656,13658,6106,2,PERF
42479415420000,PI,IP,001,60,13738,13740,6106,2,PERF
42479415420000,PI,IP,001,61,13820,13822,6106,2,PERF
42479415420000,PI,IP,001,62,13900,13902,6106,2,PERF
42479415420000,PI,IP,001,63,13980,13982,6106,2,PERF
42479415420000,PI,IP,001,64,14060,14062,6106,2,PERF
42479415430000,PI,IP,001,1,9116,9118,6016,2,PERF
42479415430000,PI,IP,001,2,9192,9194,6016,2,PERF
42479415430000,PI,IP,001,3,9274,9276,6016,2,PERF
42479415430000,PI,IP,001,4,9353,9355,6016,2,PERF
42479415430000,PI,IP,001,5,9432,9434,6016,2,PERF
42479415430000,PI,IP,001,6,9506,9508,6016,2,PERF
42479415430000,PI,IP,001,7,9590,9592,6016,2,PERF
42479415430000,PI,IP,001,8,9669,9671,6016,2,PERF
42479415430000,PI,IP,001,9,9748,9750,6016,2,PERF
42479415430000,PI,IP,001,10,9823,9825,6016,2,PERF
42479415430000,PI,IP,001,11,9906,9908,6016,2,PERF
42479415430000,PI,IP,001,12,9985,9987,6016,2,PERF
42479415430000,PI,IP,001,13,10064,10066,6016,2,PERF
42479415430000,PI,IP,001,14,10141,10143,6016,2,PERF
42479415430000,PI,IP,001,15,10222,10224,6016,2,PERF
42479415430000,PI,IP,001,16,10301,10303,6016,2,PERF
42479415430000,PI,IP,001,17,10380,10382,6016,2,PERF
42479415430000,PI,IP,001,18,10456,10458,6016,2,PERF
42479415430000,PI,IP,001,19,10538,10540,6016,2,PERF
42479415430000,PI,IP,001,20,10617,10619,6016,2,PERF
42479415430000,PI,IP,001,21,10696,10698,6016,2,PERF
42479415430000,PI,IP,001,22,10773,10775,6016,2,PERF
42479415430000,PI,IP,001,23,10854,10856,6016,2,PERF
42479415430000,PI,IP,001,24,10933,10935,6016,2,PERF
42479415430000,PI,IP,001,25,11012,11014,6016,2,PERF
42479415430000,PI,IP,001,26,11091,11093,6016,2,PERF
42479415430000,PI,IP,001,27,11170,11172,6016,2,PERF
42479415430000,PI,IP,001,28,11249,11251,6016,2,PERF
42479415430000,PI,IP,001,29,11328,11330,6016,2,PERF
42479415430000,PI,IP,001,30,11407,11409,6016,2,PERF
42479415430000,PI,IP,001,31,11486,11488,6016,2,PERF
42479415430000,PI,IP,001,32,11565,11567,6016,2,PERF
42479415430000,PI,IP,001,33,11644,11646,6016,2,PERF
42479415430000,PI,IP,001,34,11723,11725,6016,2,PERF
42479415430000,PI,IP,001,35,11802,11804,6016,2,PERF
42479415430000,PI,IP,001,36,11881,11883,6016,2,PERF
42479415430000,PI,IP,001,37,11960,11962,6016,2,PERF
42479415430000,PI,IP,001,38,12039,12041,6016,2,PERF
42479415430000,PI,IP,001,39,12118,12120,6016,2,PERF
42479415430000,PI,IP,001,40,12197,12199,6016,2,PERF
42479415430000,PI,IP,001,41,12276,12278,6016,2,PERF
42479415430000,PI,IP,001,42,12355,12357,6016,2,PERF
42479415430000,PI,IP,001,43,12434,12435,6016,1,PERF
42479415430000,PI,IP,001,44,12513,12515,6016,2,PERF
42479415430000,PI,IP,001,45,12671,12673,6016,2,PERF
42479415430000,PI,IP,001,46,12750,12752,6016,2,PERF
42479415430000,PI,IP,001,47,12829,12831,6016,2,PERF
42479415430000,PI,IP,001,48,12912,12914,6016,2,PERF
42479415430000,PI,IP,001,49,12987,12989,6016,2,PERF
42479415430000,PI,IP,001,50,13066,13068,6016,2,PERF
42479415430000,PI,IP,001,51,13082,13084,6016,2,PERF
42479415430000,PI,IP,001,52,13145,13147,6016,2,PERF
42479415430000,PI,IP,001,53,13224,13226,6016,2,PERF
42479415430000,PI,IP,001,54,13303,13305,6016,2,PERF
42479415430000,PI,IP,001,55,13382,13384,6016,2,PERF
42479415430000,PI,IP,001,56,13461,13463,6016,2,PERF
42479415430000,PI,IP,001,57,13539,13541,6016,2,PERF
42479415430000,PI,IP,001,58,13619,13621,6016,2,PERF
42479415430000,PI,IP,001,59,13699,13701,6016,2,PERF
42479415430000,PI,IP,001,60,13779,13781,6016,2,PERF
42479415440000,PI,IP,001,1,8825,8827,5972,2,PERF
42479415440000,PI,IP,001,2,8908,8910,5972,2,PERF
42479415440000,PI,IP,001,3,8991,8993,5972,2,PERF
42479415440000,PI,IP,001,4,9074,9076,5972,2,PERF
42479415440000,PI,IP,001,5,9157,9159,5972,2,PERF
42479415440000,PI,IP,001,6,9240,9242,5972,2,PERF
42479415440000,PI,IP,001,7,9323,9325,5972,2,PERF
42479415440000,PI,IP,001,8,9406,9408,5972,2,PERF
42479415440000,PI,IP,001,9,9489,9491,5972,2,PERF
42479415440000,PI,IP,001,10,9572,9574,5972,2,PERF
42479415440000,PI,IP,001,11,9655,9657,5972,2,PERF
42479415440000,PI,IP,001,12,9738,9740,5972,2,PERF
42479415440000,PI,IP,001,13,9821,9823,5972,2,PERF
42479415440000,PI,IP,001,14,9904,9906,5972,2,PERF
42479415440000,PI,IP,001,15,9987,9989,5972,2,PERF
42479415440000,PI,IP,001,16,10070,10072,5972,2,PERF
42479415440000,PI,IP,001,17,10153,10155,5972,2,PERF
42479415440000,PI,IP,001,18,10236,10238,5972,2,PERF
42479415440000,PI,IP,001,19,10319,10321,5972,2,PERF
42479415440000,PI,IP,001,20,10402,10404,5972,2,PERF
42479415440000,PI,IP,001,21,10485,10487,5972,2,PERF
42479415440000,PI,IP,001,22,10568,10570,5972,2,PERF
42479415440000,PI,IP,001,23,10651,10653,5972,2,PERF
42479415440000,PI,IP,001,24,10734,10736,5972,2,PERF
42479415440000,PI,IP,001,25,10817,10819,5972,2,PERF
42479415440000,PI,IP,001,26,10900,10902,5972,2,PERF
42479415440000,PI,IP,001,27,10983,10985,5972,2,PERF
42479415440000,PI,IP,001,28,11066,11068,5972,2,PERF
42479415440000,PI,IP,001,29,11149,11151,5972,2,PERF
42479415440000,PI,IP,001,30,11232,11234,5972,2,PERF
42479415440000,PI,IP,001,31,11315,11317,5972,2,PERF
42479415440000,PI,IP,001,32,11398,11400,5972,2,PERF
42479415440000,PI,IP,001,33,11481,11483,5972,2,PERF
42479415440000,PI,IP,001,34,11564,11566,5972,2,PERF
42479415440000,PI,IP,001,35,11647,11649,5972,2,PERF
42479415440000,PI,IP,001,36,11730,11732,5972,2,PERF
42479415440000,PI,IP,001,37,11813,11815,5972,2,PERF
42479415440000,PI,IP,001,38,11896,11898,5972,2,PERF
42479415440000,PI,IP,001,39,11979,11981,5972,2,PERF
42479415440000,PI,IP,001,40,12062,12064,5972,2,PERF
42479415440000,PI,IP,001,41,12145,12147,5972,2,PERF
42479415440000,PI,IP,001,42,12228,12230,5972,2,PERF
42479415440000,PI,IP,001,43,12311,12313,5972,2,PERF
42479415440000,PI,IP,001,44,12394,12396,5972,2,PERF
42479415440000,PI,IP,001,45,12477,12479,5972,2,PERF
42479415440000,PI,IP,001,46,12560,12562,5972,2,PERF
42479415440000,PI,IP,001,47,12643,12645,5972,2,PERF
42479415440000,PI,IP,001,48,12726,12728,5972,2,PERF
42479415440000,PI,IP,001,49,12809,12811,5972,2,PERF
42479415440000,PI,IP,001,50,12892,12894,5972,2,PERF
42479415440000,PI,IP,001,51,12975,12977,5972,2,PERF
42479415440000,PI,IP,001,52,13058,13060,5972,2,PERF
42479415440000,PI,IP,001,53,13141,13143,5972,2,PERF
42479415440000,PI,IP,001,54,13224,13226,5972,2,PERF
42479415440000,PI,IP,001,55,13307,13309,5972,2,PERF
42479415440000,PI,IP,001,56,13390,13392,5972,2,PERF
42479415440000,PI,IP,001,57,13473,13475,5972,2,PERF
42479415440000,PI,IP,001,58,13556,13558,5972,2,PERF
42479415440000,PI,IP,001,59,13639,13641,5972,2,PERF
42479415440000,PI,IP,001,60,13722,13724,5972,2,PERF
42479415440000,PI,IP,001,61,13804,13806,5972,2,PERF
42479415440000,PI,IP,001,62,13884,13886,5972,2,PERF
42479415440000,PI,IP,001,63,13964,13966,5972,2,PERF
42479415440000,PI,IP,001,64,14044,14046,5972,2,PERF
42479415470000,PI,IP,001,1,8473,13378,5496,4905,PERF
42479415490000,PI,IP,001,1,8775,14284,6920,5509,PERF
42479415580000,PI,IP,001,1,9524,16136,7834,6612,PERF
42479415590000,PI,IP,001,1,7661,13447,6648,5786,PERF
42479415600000,PI,IP,001,1,7943,13798,6896,5855,PERF
42479415610000,PI,IP,001,1,7837,14268,7368,6431,PERF
42479415640000,PI,IP,001,1,9631,14399,5947,4768,PERF
42479415650000,PI,IP,001,1,10029,14880,5915,4851,PERF
42479415660000,PI,IP,001,1,9938,15089,5976,5151,PERF
42479415670000,PI,IP,001,1,9998,14949,5832,4951,PERF
42479415680000,PI,IP,001,1,10048,14969,5977,4921,PERF
42479415690000,PI,IP,001,1,10165,15086,6188,4921,PERF
42479415700100,PI,IP,001,1,9905,14931,6197,5026,PERF
42479415720000,PI,IP,001,1,10090,15011,6152,4921,PERF
42479415760000,PI,IP,001,1,10191,15143,6250,4952,PERF
42479415770000,PI,IP,001,1,10400,10650,7210,250,PERF
42479415770000,PI,IP,001,2,10700,10950,7210,250,PERF
42479415770000,PI,IP,001,3,11000,11250,7210,250,PERF
42479415770000,PI,IP,001,4,11300,11550,7210,250,PERF
42479415770000,PI,IP,001,5,11600,11850,7210,250,PERF
42479415770000,PI,IP,001,6,11900,12150,7210,250,PERF
42479415770000,PI,IP,001,7,12200,12450,7210,250,PERF
42479415770000,PI,IP,001,8,12500,12750,7210,250,PERF
42479415770000,PI,IP,001,9,12800,13050,7210,250,PERF
42479415770000,PI,IP,001,10,13100,13350,7210,250,PERF
42479415770000,PI,IP,001,11,13400,13650,7210,250,PERF
42479415770000,PI,IP,001,12,13700,13950,7210,250,PERF
42479415770000,PI,IP,001,13,14000,14250,7210,250,PERF
42479415770000,PI,IP,001,14,14300,14550,7210,250,PERF
42479415770000,PI,IP,001,15,14600,14850,7210,250,PERF
42479415770000,PI,IP,001,16,14900,15150,7210,250,PERF
42479415770000,PI,IP,001,17,15200,15450,7210,250,PERF
42479415770000,PI,IP,001,18,15500,15750,7210,250,PERF
42479415770000,PI,IP,001,19,15800,16050,7210,250,PERF
42479415820000,PI,IP,001,1,9507,16361,7560,6854,PERF
42479415850000,PI,IP,001,1,9319,14387,5940,5068,PERF
42479415860000,PI,IP,001,1,9410,14729,6184,5319,PERF
42479415870000,PI,IP,001,1,9725,14388,5785,4663,PERF
42479415960000,PI,IP,001,1,8978,13903,6132,4925,PERF
42479415970000,PI,IP,001,1,9102,13822,6075,4720,PERF
42479415980000,PI,IP,001,1,8964,13885,6082,4921,PERF
42479415990000,PI,IP,001,1,8904,13828,6118,4924,PERF
42479416000000,PI,IP,001,1,8972,13893,6103,4921,PERF
42479416030000,PI,IP,001,1,10626,15216,6702,4590,PERF
42479416040000,PI,IP,001,1,10375,15295,6420,4920,PERF
42479416050000,PI,IP,001,1,10422,15448,6278,5026,PERF
42479416060000,PI,IP,001,1,10314,15235,6097,4921,PERF
42479416110000,PI,IP,001,1,8806,14380,6410,5574,PERF
42479416130000,PI,IP,001,1,9579,14180,6839,4601,PERF
42479416140000,PI,IP,001,1,9637,16407,8791,6770,PERF
42479416170000,PI,IP,001,1,9473,15596,7782,6123,PERF
42479416180000,PI,IP,001,1,9594,13916,6240,4322,PERF
42479416320000,PI,IP,001,1,8461,12962,5522,4501,PERF
42479416330000,PI,IP,001,1,10600,10850,7373,250,PERF
42479416330000,PI,IP,001,2,10900,11150,7373,250,PERF
42479416330000,PI,IP,001,3,11200,11450,7373,250,PERF
42479416330000,PI,IP,001,4,11500,11750,7373,250,PERF
42479416330000,PI,IP,001,5,11800,12050,7373,250,PERF
42479416330000,PI,IP,001,6,12100,12350,7373,250,PERF
42479416330000,PI,IP,001,7,12400,12650,7373,250,PERF
42479416330000,PI,IP,001,8,12700,12950,7373,250,PERF
42479416330000,PI,IP,001,9,13000,13250,7373,250,PERF
42479416330000,PI,IP,001,10,13300,13550,7373,250,PERF
42479416330000,PI,IP,001,11,13600,13850,7373,250,PERF
42479416330000,PI,IP,001,12,13900,14150,7373,250,PERF
42479416330000,PI,IP,001,13,14200,14450,7373,250,PERF
42479416330000,PI,IP,001,14,14500,14750,7373,250,PERF
42479416330000,PI,IP,001,15,14800,15050,7373,250,PERF
42479416330000,PI,IP,001,16,15100,15350,7373,250,PERF
42479416330000,PI,IP,001,17,15400,15650,7373,250,PERF
42479416330000,PI,IP,001,18,15700,15950,7373,250,PERF
42479416330000,PI,IP,001,19,16000,16250,7373,250,PERF
42479416330000,PI,IP,001,20,16300,16550,7373,250,PERF
42479416370000,PI,IP,001,1,10250,10500,6995,250,PERF
42479416370000,PI,IP,001,2,10550,10800,6995,250,PERF
42479416370000,PI,IP,001,3,10850,11100,6995,250,PERF
42479416370000,PI,IP,001,4,11150,11400,6995,250,PERF
42479416370000,PI,IP,001,5,11450,11700,6995,250,PERF
42479416370000,PI,IP,001,6,11750,12000,6995,250,PERF
42479416370000,PI,IP,001,7,12050,12300,6995,250,PERF
42479416370000,PI,IP,001,8,12350,12600,6995,250,PERF
42479416370000,PI,IP,001,9,12650,12900,6995,250,PERF
42479416370000,PI,IP,001,10,12950,13200,6995,250,PERF
42479416370000,PI,IP,001,11,13250,13500,6995,250,PERF
42479416370000,PI,IP,001,12,13550,13800,6995,250,PERF
42479416370000,PI,IP,001,13,13850,14100,6995,250,PERF
42479416370000,PI,IP,001,14,14150,14400,6995,250,PERF
42479416370000,PI,IP,001,15,14450,14700,6995,250,PERF
42479416370000,PI,IP,001,16,14750,15000,6995,250,PERF
42479416370000,PI,IP,001,17,15050,15300,6995,250,PERF
42479416370000,PI,IP,001,18,15350,15600,6995,250,PERF
42479416370000,PI,IP,001,19,15650,15900,6995,250,PERF
42479416370000,PI,IP,001,20,15950,16200,6995,250,PERF
42479416370000,PI,IP,001,21,16250,16500,6995,250,PERF
42479416380100,PI,PT,001,1,8618,13613,,4995,PERF
42479416410000,PI,IP,001,1,8415,12023,4720,3608,PERF
42479416420000,PI,IP,001,1,8486,11699,4011,3213,OPENHOLE
42479416550000,PI,IP,001,1,8594,8595,4248,1,PERF
42479416550000,PI,IP,001,2,8652,8653,4248,1,PERF
42479416550000,PI,IP,001,3,8710,8711,4248,1,PERF
42479416550000,PI,IP,001,4,8767,8768,4248,1,PERF
42479416550000,PI,IP,001,5,8825,8826,4248,1,PERF
42479416550000,PI,IP,001,6,8882,8883,4248,1,PERF
42479416550000,PI,IP,001,7,8940,8941,4248,1,PERF
42479416550000,PI,IP,001,8,8998,8999,4248,1,PERF
42479416550000,PI,IP,001,9,9055,9056,4248,1,PERF
42479416550000,PI,IP,001,10,9113,9114,4248,1,PERF
42479416550000,PI,IP,001,11,9170,9171,4248,1,PERF
42479416550000,PI,IP,001,12,9228,9229,4248,1,PERF
42479416550000,PI,IP,001,13,9286,9287,4248,1,PERF
42479416550000,PI,IP,001,14,9343,9344,4248,1,PERF
42479416550000,PI,IP,001,15,9401,9402,4248,1,PERF
42479416550000,PI,IP,001,16,9458,9459,4248,1,PERF
42479416550000,PI,IP,001,17,9516,9517,4248,1,PERF
42479416550000,PI,IP,001,18,9574,9575,4248,1,PERF
42479416550000,PI,IP,001,19,9631,9632,4248,1,PERF
42479416550000,PI,IP,001,20,9689,9690,4248,1,PERF
42479416550000,PI,IP,001,21,9746,9747,4248,1,PERF
42479416550000,PI,IP,001,22,9804,9805,4248,1,PERF
42479416550000,PI,IP,001,23,9862,9863,4248,1,PERF
42479416550000,PI,IP,001,24,9919,9920,4248,1,PERF
42479416550000,PI,IP,001,25,9977,9978,4248,1,PERF
42479416550000,PI,IP,001,26,10034,10035,4248,1,PERF
42479416550000,PI,IP,001,27,10092,10093,4248,1,PERF
42479416550000,PI,IP,001,28,10150,10151,4248,1,PERF
42479416550000,PI,IP,001,29,10207,10208,4248,1,PERF
42479416550000,PI,IP,001,30,10265,10266,4248,1,PERF
42479416550000,PI,IP,001,31,10322,10323,4248,1,PERF
42479416550000,PI,IP,001,32,10380,10381,4248,1,PERF
42479416550000,PI,IP,001,33,10438,10439,4248,1,PERF
42479416550000,PI,IP,001,34,10495,10496,4248,1,PERF
42479416550000,PI,IP,001,35,10553,10554,4248,1,PERF
42479416550000,PI,IP,001,36,10610,10611,4248,1,PERF
42479416550000,PI,IP,001,37,10668,10669,4248,1,PERF
42479416550000,PI,IP,001,38,10726,10727,4248,1,PERF
42479416550000,PI,IP,001,39,10783,10784,4248,1,PERF
42479416550000,PI,IP,001,40,10841,10842,4248,1,PERF
42479416550000,PI,IP,001,41,10898,10899,4248,1,PERF
42479416550000,PI,IP,001,42,10956,10957,4248,1,PERF
42479416550000,PI,IP,001,43,11014,11015,4248,1,PERF
42479416550000,PI,IP,001,44,11071,11072,4248,1,PERF
42479416550000,PI,IP,001,45,11129,11130,4248,1,PERF
42479416550000,PI,IP,001,46,11186,11187,4248,1,PERF
42479416550000,PI,IP,001,47,11244,11245,4248,1,PERF
42479416550000,PI,IP,001,48,11302,11303,4248,1,PERF
42479416550000,PI,IP,001,49,11359,11360,4248,1,PERF
42479416550000,PI,IP,001,50,11417,11418,4248,1,PERF
42479416550000,PI,IP,001,51,11474,11475,4248,1,PERF
42479416550000,PI,IP,001,52,11532,11533,4248,1,PERF
42479416550000,PI,IP,001,53,11590,11591,4248,1,PERF
42479416550000,PI,IP,001,54,11647,11648,4248,1,PERF
42479416550000,PI,IP,001,55,11705,11706,4248,1,PERF
42479416550000,PI,IP,001,56,11762,11763,4248,1,PERF
42479416550000,PI,IP,001,57,11820,11821,4248,1,PERF
42479416550000,PI,IP,001,58,11878,11879,4248,1,PERF
42479416550000,PI,IP,001,59,11935,11936,4248,1,PERF
42479416550000,PI,IP,001,60,11993,11994,4248,1,PERF
42479416550000,PI,IP,001,61,12055,12057,4248,2,PERF
42479416550000,PI,IP,001,62,12123,12125,4248,2,PERF
42479416550000,PI,IP,001,63,12191,12193,4248,2,PERF
42479416550000,PI,IP,001,64,12259,12261,4248,2,PERF
42479416550000,PI,IP,001,65,12327,12329,4248,2,PERF
42479416620000,PI,IP,001,1,8635,13231,5490,4596,PERF
42479416640000,PI,IP,001,1,8583,15004,7060,6421,PERF
42479416660000,PI,IP,001,1,8781,12424,4457,3643,PERF
42479416670000,PI,IP,001,1,8772,8774,6300,2,PERF
42479416670000,PI,IP,001,2,8861,8863,6300,2,PERF
42479416670000,PI,IP,001,3,8950,8952,6300,2,PERF
42479416670000,PI,IP,001,4,9039,9041,6300,2,PERF
42479416670000,PI,IP,001,5,9133,9135,6300,2,PERF
42479416670000,PI,IP,001,6,9222,9224,6300,2,PERF
42479416670000,PI,IP,001,7,9311,9313,6300,2,PERF
42479416670000,PI,IP,001,8,9400,9402,6300,2,PERF
42479416670000,PI,IP,001,9,9494,9496,6300,2,PERF
42479416670000,PI,IP,001,10,9583,9585,6300,2,PERF
42479416670000,PI,IP,001,11,9672,9674,6300,2,PERF
42479416670000,PI,IP,001,12,9761,9763,6300,2,PERF
42479416670000,PI,IP,001,13,9855,9857,6300,2,PERF
42479416670000,PI,IP,001,14,9944,9946,6300,2,PERF
42479416670000,PI,IP,001,15,10033,10035,6300,2,PERF
42479416670000,PI,IP,001,16,10122,10124,6300,2,PERF
42479416670000,PI,IP,001,17,10216,10218,6300,2,PERF
42479416670000,PI,IP,001,18,10305,10307,6300,2,PERF
42479416670000,PI,IP,001,19,10394,10396,6300,2,PERF
42479416670000,PI,IP,001,20,10483,10485,6300,2,PERF
42479416670000,PI,IP,001,21,10577,10579,6300,2,PERF
42479416670000,PI,IP,001,22,10666,10668,6300,2,PERF
42479416670000,PI,IP,001,23,10755,10757,6300,2,PERF
42479416670000,PI,IP,001,24,10844,10846,6300,2,PERF
42479416670000,PI,IP,001,25,10938,10940,6300,2,PERF
42479416670000,PI,IP,001,26,11027,11029,6300,2,PERF
42479416670000,PI,IP,001,27,11116,11118,6300,2,PERF
42479416670000,PI,IP,001,28,11205,11207,6300,2,PERF
42479416670000,PI,IP,001,29,11299,11301,6300,2,PERF
42479416670000,PI,IP,001,30,11388,11390,6300,2,PERF
42479416670000,PI,IP,001,31,11477,11479,6300,2,PERF
42479416670000,PI,IP,001,32,11566,11568,6300,2,PERF
42479416670000,PI,IP,001,33,11660,11662,6300,2,PERF
42479416670000,PI,IP,001,34,11749,11751,6300,2,PERF
42479416670000,PI,IP,001,35,11838,11840,6300,2,PERF
42479416670000,PI,IP,001,36,11927,11929,6300,2,PERF
42479416670000,PI,IP,001,37,12021,12023,6300,2,PERF
42479416670000,PI,IP,001,38,12110,12112,6300,2,PERF
42479416670000,PI,IP,001,39,12199,12201,6300,2,PERF
42479416670000,PI,IP,001,40,12288,12290,6300,2,PERF
42479416670000,PI,IP,001,41,12382,12384,6300,2,PERF
42479416670000,PI,IP,001,42,12471,12473,6300,2,PERF
42479416670000,PI,IP,001,43,12560,12562,6300,2,PERF
42479416670000,PI,IP,001,44,12649,12651,6300,2,PERF
42479416670000,PI,IP,001,45,12743,12745,6300,2,PERF
42479416670000,PI,IP,001,46,12832,12834,6300,2,PERF
42479416670000,PI,IP,001,47,12921,12923,6300,2,PERF
42479416670000,PI,IP,001,48,13010,13012,6300,2,PERF
42479416670000,PI,IP,001,49,13104,13106,6300,2,PERF
42479416670000,PI,IP,001,50,13193,13195,6300,2,PERF
42479416670000,PI,IP,001,51,13282,13284,6300,2,PERF
42479416670000,PI,IP,001,52,13371,13373,6300,2,PERF
42479416670000,PI,IP,001,53,13465,13467,6300,2,PERF
42479416670000,PI,IP,001,54,13554,13556,6300,2,PERF
42479416670000,PI,IP,001,55,13643,13645,6300,2,PERF
42479416670000,PI,IP,001,56,13732,13734,6300,2,PERF
42479416670000,PI,IP,001,57,13826,13828,6300,2,PERF
42479416670000,PI,IP,001,58,13906,13908,6300,2,PERF
42479416670000,PI,IP,001,59,13986,13988,6300,2,PERF
42479416670000,PI,IP,001,60,14066,14068,6300,2,PERF
42479416680000,PI,IP,001,1,8881,8883,5988,2,PERF
42479416680000,PI,IP,001,2,8964,8966,5988,2,PERF
42479416680000,PI,IP,001,3,9047,9049,5988,2,PERF
42479416680000,PI,IP,001,4,9130,9132,5988,2,PERF
42479416680000,PI,IP,001,5,9215,9217,5988,2,PERF
42479416680000,PI,IP,001,6,9298,9300,5988,2,PERF
42479416680000,PI,IP,001,7,9381,9383,5988,2,PERF
42479416680000,PI,IP,001,8,9464,9466,5988,2,PERF
42479416680000,PI,IP,001,9,9549,9551,5988,2,PERF
42479416680000,PI,IP,001,10,9632,9634,5988,2,PERF
42479416680000,PI,IP,001,11,9715,9717,5988,2,PERF
42479416680000,PI,IP,001,12,9798,9800,5988,2,PERF
42479416680000,PI,IP,001,13,9883,9885,5988,2,PERF
42479416680000,PI,IP,001,14,9966,9968,5988,2,PERF
42479416680000,PI,IP,001,15,10049,10051,5988,2,PERF
42479416680000,PI,IP,001,16,10132,10134,5988,2,PERF
42479416680000,PI,IP,001,17,10217,10219,5988,2,PERF
42479416680000,PI,IP,001,18,10300,10302,5988,2,PERF
42479416680000,PI,IP,001,19,10383,10385,5988,2,PERF
42479416680000,PI,IP,001,20,10466,10468,5988,2,PERF
42479416680000,PI,IP,001,21,10551,10553,5988,2,PERF
42479416680000,PI,IP,001,22,10634,10636,5988,2,PERF
42479416680000,PI,IP,001,23,10717,10719,5988,2,PERF
42479416680000,PI,IP,001,24,10800,10802,5988,2,PERF
42479416680000,PI,IP,001,25,10885,10887,5988,2,PERF
42479416680000,PI,IP,001,26,10968,10970,5988,2,PERF
42479416680000,PI,IP,001,27,11051,11053,5988,2,PERF
42479416680000,PI,IP,001,28,11134,11136,5988,2,PERF
42479416680000,PI,IP,001,29,11219,11221,5988,2,PERF
42479416680000,PI,IP,001,30,11302,11304,5988,2,PERF
42479416680000,PI,IP,001,31,11385,11387,5988,2,PERF
42479416680000,PI,IP,001,32,11468,11470,5988,2,PERF
42479416680000,PI,IP,001,33,11553,11555,5988,2,PERF
42479416680000,PI,IP,001,34,11636,11638,5988,2,PERF
42479416680000,PI,IP,001,35,11719,11721,5988,2,PERF
42479416680000,PI,IP,001,36,11802,11804,5988,2,PERF
42479416680000,PI,IP,001,37,11887,11889,5988,2,PERF
42479416680000,PI,IP,001,38,11970,11972,5988,2,PERF
42479416680000,PI,IP,001,39,12053,12055,5988,2,PERF
42479416680000,PI,IP,001,40,12136,12138,5988,2,PERF
42479416680000,PI,IP,001,41,12221,12223,5988,2,PERF
42479416680000,PI,IP,001,42,12304,12306,5988,2,PERF
42479416680000,PI,IP,001,43,12387,12389,5988,2,PERF
42479416680000,PI,IP,001,44,12470,12472,5988,2,PERF
42479416680000,PI,IP,001,45,12555,12557,5988,2,PERF
42479416680000,PI,IP,001,46,12638,12640,5988,2,PERF
42479416680000,PI,IP,001,47,12721,12723,5988,2,PERF
42479416680000,PI,IP,001,48,12804,12806,5988,2,PERF
42479416680000,PI,IP,001,49,12889,12891,5988,2,PERF
42479416680000,PI,IP,001,50,12972,12974,5988,2,PERF
42479416680000,PI,IP,001,51,13055,13057,5988,2,PERF
42479416680000,PI,IP,001,52,13138,13140,5988,2,PERF
42479416680000,PI,IP,001,53,13223,13225,5988,2,PERF
42479416680000,PI,IP,001,54,13306,13308,5988,2,PERF
42479416680000,PI,IP,001,55,13389,13391,5988,2,PERF
42479416680000,PI,IP,001,56,13472,13474,5988,2,PERF
42479416680000,PI,IP,001,57,13556,13558,5988,2,PERF
42479416680000,PI,IP,001,58,13636,13638,5988,2,PERF
42479416680000,PI,IP,001,59,13716,13718,5988,2,PERF
42479416680000,PI,IP,001,60,13796,13798,5988,2,PERF
42479416690000,PI,IP,001,1,8789,8791,6367,2,PERF
42479416690000,PI,IP,001,2,8882,8884,6367,2,PERF
42479416690000,PI,IP,001,3,8975,8977,6367,2,PERF
42479416690000,PI,IP,001,4,9068,9070,6367,2,PERF
42479416690000,PI,IP,001,5,9168,9170,6367,2,PERF
42479416690000,PI,IP,001,6,9261,9263,6367,2,PERF
42479416690000,PI,IP,001,7,9354,9356,6367,2,PERF
42479416690000,PI,IP,001,8,9447,9449,6367,2,PERF
42479416690000,PI,IP,001,9,9547,9549,6367,2,PERF
42479416690000,PI,IP,001,10,9640,9642,6367,2,PERF
42479416690000,PI,IP,001,11,9733,9735,6367,2,PERF
42479416690000,PI,IP,001,12,9826,9828,6367,2,PERF
42479416690000,PI,IP,001,13,9926,9928,6367,2,PERF
42479416690000,PI,IP,001,14,10019,10021,6367,2,PERF
42479416690000,PI,IP,001,15,10112,10114,6367,2,PERF
42479416690000,PI,IP,001,16,10205,10207,6367,2,PERF
42479416690000,PI,IP,001,17,10305,10307,6367,2,PERF
42479416690000,PI,IP,001,18,10398,10400,6367,2,PERF
42479416690000,PI,IP,001,19,10491,10493,6367,2,PERF
42479416690000,PI,IP,001,20,10584,10586,6367,2,PERF
42479416690000,PI,IP,001,21,10684,10686,6367,2,PERF
42479416690000,PI,IP,001,22,10777,10779,6367,2,PERF
42479416690000,PI,IP,001,23,10870,10872,6367,2,PERF
42479416690000,PI,IP,001,24,10963,10965,6367,2,PERF
42479416690000,PI,IP,001,25,11063,11065,6367,2,PERF
42479416690000,PI,IP,001,26,11156,11158,6367,2,PERF
42479416690000,PI,IP,001,27,11249,11251,6367,2,PERF
42479416690000,PI,IP,001,28,11342,11344,6367,2,PERF
42479416690000,PI,IP,001,29,11442,11444,6367,2,PERF
42479416690000,PI,IP,001,30,11535,11537,6367,2,PERF
42479416690000,PI,IP,001,31,11628,11630,6367,2,PERF
42479416690000,PI,IP,001,32,11721,11723,6367,2,PERF
42479416690000,PI,IP,001,33,11821,11823,6367,2,PERF
42479416690000,PI,IP,001,34,11914,11916,6367,2,PERF
42479416690000,PI,IP,001,35,12007,12009,6367,2,PERF
42479416690000,PI,IP,001,36,12100,12102,6367,2,PERF
42479416690000,PI,IP,001,37,12200,12202,6367,2,PERF
42479416690000,PI,IP,001,38,12293,12295,6367,2,PERF
42479416690000,PI,IP,001,39,12386,12388,6367,2,PERF
42479416690000,PI,IP,001,40,12479,12481,6367,2,PERF
42479416690000,PI,IP,001,41,12579,12581,6367,2,PERF
42479416690000,PI,IP,001,42,12672,12674,6367,2,PERF
42479416690000,PI,IP,001,43,12765,12767,6367,2,PERF
42479416690000,PI,IP,001,44,12858,12860,6367,2,PERF
42479416690000,PI,IP,001,45,12958,12960,6367,2,PERF
42479416690000,PI,IP,001,46,13051,13053,6367,2,PERF
42479416690000,PI,IP,001,47,13144,13146,6367,2,PERF
42479416690000,PI,IP,001,48,13237,13239,6367,2,PERF
42479416690000,PI,IP,001,49,13337,13339,6367,2,PERF
42479416690000,PI,IP,001,50,13430,13432,6367,2,PERF
42479416690000,PI,IP,001,51,13523,13525,6367,2,PERF
42479416690000,PI,IP,001,52,13616,13618,6367,2,PERF
42479416690000,PI,IP,001,53,13716,13718,6367,2,PERF
42479416690000,PI,IP,001,54,13809,13811,6367,2,PERF
42479416690000,PI,IP,001,55,13902,13904,6367,2,PERF
42479416690000,PI,IP,001,56,13995,13997,6367,2,PERF
42479416690000,PI,IP,001,57,14095,14097,6367,2,PERF
42479416690000,PI,IP,001,58,14175,14177,6367,2,PERF
42479416690000,PI,IP,001,59,14255,14257,6367,2,PERF
42479416690000,PI,IP,001,60,14335,14337,6367,2,PERF
42479416700000,PI,IP,001,1,7828,13386,6351,5558,PERF
42479416710000,PI,IP,001,1,7843,13273,6368,5430,PERF
42479416720000,PI,IP,001,1,8731,13387,,4656,PERF
42479416730000,PI,IP,001,1,8714,13506,4957,4792,PERF
42479416740000,PI,IP,001,1,8710,13134,4616,4424,PERF
42479416750000,PI,IP,001,1,8724,12983,4381,4259,PERF
42479416760000,PI,IP,001,1,8630,12457,4310,3827,PERF
42479416770000,PI,IP,001,1,7914,13244,6348,5330,PERF
42479416820000,PI,IP,001,1,9394,14669,5409,5275,PERF
42479416870000,PI,IP,001,1,9232,15304,6696,6072,PERF
42479416880000,PI,IP,001,1,9330,16094,8009,6764,PERF
42479416900000,PI,IP,001,1,8777,8779,5509,2,PERF
42479416900000,PI,IP,001,2,8858,8860,5509,2,PERF
42479416900000,PI,IP,001,3,8939,8941,5509,2,PERF
42479416900000,PI,IP,001,4,9020,9022,5509,2,PERF
42479416900000,PI,IP,001,5,9105,9107,5509,2,PERF
42479416900000,PI,IP,001,6,9186,9188,5509,2,PERF
42479416900000,PI,IP,001,7,9267,9269,5509,2,PERF
42479416900000,PI,IP,001,8,9348,9350,5509,2,PERF
42479416900000,PI,IP,001,9,9433,9435,5509,2,PERF
42479416900000,PI,IP,001,10,9514,9516,5509,2,PERF
42479416900000,PI,IP,001,11,9595,9597,5509,2,PERF
42479416900000,PI,IP,001,12,9676,9678,5509,2,PERF
42479416900000,PI,IP,001,13,9761,9763,5509,2,PERF
42479416900000,PI,IP,001,14,9842,9844,5509,2,PERF
42479416900000,PI,IP,001,15,9923,9925,5509,2,PERF
42479416900000,PI,IP,001,16,10004,10006,5509,2,PERF
42479416900000,PI,IP,001,17,10089,10091,5509,2,PERF
42479416900000,PI,IP,001,18,10170,10172,5509,2,PERF
42479416900000,PI,IP,001,19,10251,10253,5509,2,PERF
42479416900000,PI,IP,001,20,10332,10334,5509,2,PERF
42479416900000,PI,IP,001,21,10417,10419,5509,2,PERF
42479416900000,PI,IP,001,22,10498,10500,5509,2,PERF
42479416900000,PI,IP,001,23,10579,10581,5509,2,PERF
42479416900000,PI,IP,001,24,10660,10662,5509,2,PERF
42479416900000,PI,IP,001,25,10745,10747,5509,2,PERF
42479416900000,PI,IP,001,26,10826,10828,5509,2,PERF
42479416900000,PI,IP,001,27,10907,10909,5509,2,PERF
42479416900000,PI,IP,001,28,10988,10990,5509,2,PERF
42479416900000,PI,IP,001,29,11073,11075,5509,2,PERF
42479416900000,PI,IP,001,30,11154,11156,5509,2,PERF
42479416900000,PI,IP,001,31,11235,11237,5509,2,PERF
42479416900000,PI,IP,001,32,11316,11318,5509,2,PERF
42479416900000,PI,IP,001,33,11401,11403,5509,2,PERF
42479416900000,PI,IP,001,34,11482,11484,5509,2,PERF
42479416900000,PI,IP,001,35,11563,11565,5509,2,PERF
42479416900000,PI,IP,001,36,11644,11646,5509,2,PERF
42479416900000,PI,IP,001,37,11729,11731,5509,2,PERF
42479416900000,PI,IP,001,38,11810,11812,5509,2,PERF
42479416900000,PI,IP,001,39,11891,11893,5509,2,PERF
42479416900000,PI,IP,001,40,11972,11974,5509,2,PERF
42479416900000,PI,IP,001,41,12057,12059,5509,2,PERF
42479416900000,PI,IP,001,42,12138,12140,5509,2,PERF
42479416900000,PI,IP,001,43,12219,12221,5509,2,PERF
42479416900000,PI,IP,001,44,12300,12302,5509,2,PERF
42479416900000,PI,IP,001,45,12385,12387,5509,2,PERF
42479416900000,PI,IP,001,46,12466,12468,5509,2,PERF
42479416900000,PI,IP,001,47,12547,12549,5509,2,PERF
42479416900000,PI,IP,001,48,12628,12630,5509,2,PERF
42479416900000,PI,IP,001,49,12713,12715,5509,2,PERF
42479416900000,PI,IP,001,50,12794,12796,5509,2,PERF
42479416900000,PI,IP,001,51,12875,12877,5509,2,PERF
42479416900000,PI,IP,001,52,12956,12958,5509,2,PERF
42479416900000,PI,IP,001,53,13041,13043,5509,2,PERF
42479416900000,PI,IP,001,54,13122,13124,5509,2,PERF
42479416900000,PI,IP,001,55,13203,13205,5509,2,PERF
42479416900000,PI,IP,001,56,13284,13286,5509,2,PERF
42479416900000,PI,IP,001,57,13368,13370,5509,2,PERF
42479416900000,PI,IP,001,58,13448,13450,5509,2,PERF
42479416900000,PI,IP,001,59,13528,13530,5509,2,PERF
42479416900000,PI,IP,001,60,13608,13610,5509,2,PERF
42479416910000,PI,IP,001,1,8892,8894,5791,2,PERF
42479416910000,PI,IP,001,2,8973,8975,5791,2,PERF
42479416910000,PI,IP,001,3,9054,9056,5791,2,PERF
42479416910000,PI,IP,001,4,9135,9137,5791,2,PERF
42479416910000,PI,IP,001,5,9220,9222,5791,2,PERF
42479416910000,PI,IP,001,6,9301,9303,5791,2,PERF
42479416910000,PI,IP,001,7,9382,9384,5791,2,PERF
42479416910000,PI,IP,001,8,9463,9465,5791,2,PERF
42479416910000,PI,IP,001,9,9548,9550,5791,2,PERF
42479416910000,PI,IP,001,10,9629,9631,5791,2,PERF
42479416910000,PI,IP,001,11,9710,9712,5791,2,PERF
42479416910000,PI,IP,001,12,9791,9793,5791,2,PERF
42479416910000,PI,IP,001,13,9876,9878,5791,2,PERF
42479416910000,PI,IP,001,14,9957,9959,5791,2,PERF
42479416910000,PI,IP,001,15,10038,10040,5791,2,PERF
42479416910000,PI,IP,001,16,10119,10121,5791,2,PERF
42479416910000,PI,IP,001,17,10204,10206,5791,2,PERF
42479416910000,PI,IP,001,18,10285,10287,5791,2,PERF
42479416910000,PI,IP,001,19,10366,10368,5791,2,PERF
42479416910000,PI,IP,001,20,10447,10449,5791,2,PERF
42479416910000,PI,IP,001,21,10532,10534,5791,2,PERF
42479416910000,PI,IP,001,22,10613,10615,5791,2,PERF
42479416910000,PI,IP,001,23,10694,10696,5791,2,PERF
42479416910000,PI,IP,001,24,10775,10777,5791,2,PERF
42479416910000,PI,IP,001,25,10860,10862,5791,2,PERF
42479416910000,PI,IP,001,26,10941,10943,5791,2,PERF
42479416910000,PI,IP,001,27,11022,11024,5791,2,PERF
42479416910000,PI,IP,001,28,11103,11105,5791,2,PERF
42479416910000,PI,IP,001,29,11188,11190,5791,2,PERF
42479416910000,PI,IP,001,30,11269,11271,5791,2,PERF
42479416910000,PI,IP,001,31,11350,11352,5791,2,PERF
42479416910000,PI,IP,001,32,11431,11433,5791,2,PERF
42479416910000,PI,IP,001,33,11516,11518,5791,2,PERF
42479416910000,PI,IP,001,34,11597,11599,5791,2,PERF
42479416910000,PI,IP,001,35,11678,11680,5791,2,PERF
42479416910000,PI,IP,001,36,11759,11761,5791,2,PERF
42479416910000,PI,IP,001,37,11844,11846,5791,2,PERF
42479416910000,PI,IP,001,38,11925,11927,5791,2,PERF
42479416910000,PI,IP,001,39,12006,12008,5791,2,PERF
42479416910000,PI,IP,001,40,12087,12089,5791,2,PERF
42479416910000,PI,IP,001,41,12172,12174,5791,2,PERF
42479416910000,PI,IP,001,42,12253,12255,5791,2,PERF
42479416910000,PI,IP,001,43,12334,12336,5791,2,PERF
42479416910000,PI,IP,001,44,12415,12417,5791,2,PERF
42479416910000,PI,IP,001,45,12500,12502,5791,2,PERF
42479416910000,PI,IP,001,46,12581,12583,5791,2,PERF
42479416910000,PI,IP,001,47,12662,12664,5791,2,PERF
42479416910000,PI,IP,001,48,12743,12745,5791,2,PERF
42479416910000,PI,IP,001,49,12828,12830,5791,2,PERF
42479416910000,PI,IP,001,50,12909,12911,5791,2,PERF
42479416910000,PI,IP,001,51,12990,12992,5791,2,PERF
42479416910000,PI,IP,001,52,13071,13073,5791,2,PERF
42479416910000,PI,IP,001,53,13156,13158,5791,2,PERF
42479416910000,PI,IP,001,54,13237,13239,5791,2,PERF
42479416910000,PI,IP,001,55,13318,13320,5791,2,PERF
42479416910000,PI,IP,001,56,13399,13401,5791,2,PERF
42479416910000,PI,IP,001,57,13483,13485,5791,2,PERF
42479416910000,PI,IP,001,58,13563,13565,5791,2,PERF
42479416910000,PI,IP,001,59,13643,13645,5791,2,PERF
42479416910000,PI,IP,001,60,13723,13725,5791,2,PERF
42479416940000,PI,IP,001,1,8845,8847,5614,2,PERF
42479416940000,PI,IP,001,2,8925,8927,5614,2,PERF
42479416940000,PI,IP,001,3,9005,9007,5614,2,PERF
42479416940000,PI,IP,001,4,9085,9087,5614,2,PERF
42479416940000,PI,IP,001,5,9169,9171,5614,2,PERF
42479416940000,PI,IP,001,6,9249,9251,5614,2,PERF
42479416940000,PI,IP,001,7,9329,9331,5614,2,PERF
42479416940000,PI,IP,001,8,9409,9411,5614,2,PERF
42479416940000,PI,IP,001,9,9493,9495,5614,2,PERF
42479416940000,PI,IP,001,10,9573,9575,5614,2,PERF
42479416940000,PI,IP,001,11,9653,9655,5614,2,PERF
42479416940000,PI,IP,001,12,9733,9735,5614,2,PERF
42479416940000,PI,IP,001,13,9817,9819,5614,2,PERF
42479416940000,PI,IP,001,14,9897,9899,5614,2,PERF
42479416940000,PI,IP,001,15,9977,9979,5614,2,PERF
42479416940000,PI,IP,001,16,10057,10059,5614,2,PERF
42479416940000,PI,IP,001,17,10141,10143,5614,2,PERF
42479416940000,PI,IP,001,18,10221,10223,5614,2,PERF
42479416940000,PI,IP,001,19,10301,10303,5614,2,PERF
42479416940000,PI,IP,001,20,10381,10383,5614,2,PERF
42479416940000,PI,IP,001,21,10465,10467,5614,2,PERF
42479416940000,PI,IP,001,22,10545,10547,5614,2,PERF
42479416940000,PI,IP,001,23,10625,10627,5614,2,PERF
42479416940000,PI,IP,001,24,10705,10707,5614,2,PERF
42479416940000,PI,IP,001,25,10789,10791,5614,2,PERF
42479416940000,PI,IP,001,26,10869,10871,5614,2,PERF
42479416940000,PI,IP,001,27,10949,10951,5614,2,PERF
42479416940000,PI,IP,001,28,11029,11031,5614,2,PERF
42479416940000,PI,IP,001,29,11113,11115,5614,2,PERF
42479416940000,PI,IP,001,30,11193,11195,5614,2,PERF
42479416940000,PI,IP,001,31,11273,11275,5614,2,PERF
42479416940000,PI,IP,001,32,11353,11355,5614,2,PERF
42479416940000,PI,IP,001,33,11437,11439,5614,2,PERF
42479416940000,PI,IP,001,34,11517,11519,5614,2,PERF
42479416940000,PI,IP,001,35,11597,11599,5614,2,PERF
42479416940000,PI,IP,001,36,11677,11679,5614,2,PERF
42479416940000,PI,IP,001,37,11761,11763,5614,2,PERF
42479416940000,PI,IP,001,38,11841,11843,5614,2,PERF
42479416940000,PI,IP,001,39,11921,11923,5614,2,PERF
42479416940000,PI,IP,001,40,12001,12003,5614,2,PERF
42479416940000,PI,IP,001,41,12085,12087,5614,2,PERF
42479416940000,PI,IP,001,42,12165,12167,5614,2,PERF
42479416940000,PI,IP,001,43,12245,12247,5614,2,PERF
42479416940000,PI,IP,001,44,12325,12327,5614,2,PERF
42479416940000,PI,IP,001,45,12409,12411,5614,2,PERF
42479416940000,PI,IP,001,46,12489,12491,5614,2,PERF
42479416940000,PI,IP,001,47,12569,12571,5614,2,PERF
42479416940000,PI,IP,001,48,12649,12651,5614,2,PERF
42479416940000,PI,IP,001,49,12733,12735,5614,2,PERF
42479416940000,PI,IP,001,50,12813,12815,5614,2,PERF
42479416940000,PI,IP,001,51,12893,12895,5614,2,PERF
42479416940000,PI,IP,001,52,12973,12975,5614,2,PERF
42479416940000,PI,IP,001,53,13057,13059,5614,2,PERF
42479416940000,PI,IP,001,54,13137,13139,5614,2,PERF
42479416940000,PI,IP,001,55,13217,13219,5614,2,PERF
42479416940000,PI,IP,001,56,13297,13299,5614,2,PERF
42479416940000,PI,IP,001,57,13381,13383,5614,2,PERF
42479416940000,PI,IP,001,58,13461,13463,5614,2,PERF
42479416940000,PI,IP,001,59,13541,13543,5614,2,PERF
42479416940000,PI,IP,001,60,13621,13626,5614,5,PERF
42479416980000,PI,IP,001,1,9097,13595,5060,4498,PERF
42479416990000,PI,IP,001,1,8890,13888,5396,4998,PERF
42479417000000,PI,IP,001,1,8919,13919,5868,5000,PERF
42479417010000,PI,IP,001,1,9020,13733,6299,4713,PERF
42479417150000,PI,IP,001,1,10000,10250,,250,PERF
42479417150000,PI,IP,001,2,10300,10550,,250,PERF
42479417150000,PI,IP,001,3,10600,10850,,250,PERF
42479417150000,PI,IP,001,4,10900,11150,,250,PERF
42479417150000,PI,IP,001,5,11200,11450,,250,PERF
42479417150000,PI,IP,001,6,11500,11750,,250,PERF
42479417150000,PI,IP,001,7,11800,12050,,250,PERF
42479417150000,PI,IP,001,8,12100,12350,,250,PERF
42479417150000,PI,IP,001,9,12400,12650,,250,PERF
42479417150000,PI,IP,001,10,12700,12950,,250,PERF
42479417150000,PI,IP,001,11,13000,13250,,250,PERF
42479417150000,PI,IP,001,12,13300,13550,,250,PERF
42479417150000,PI,IP,001,13,13600,13850,,250,PERF
42479417150000,PI,IP,001,14,13900,14150,,250,PERF
42479417150000,PI,IP,001,15,14200,14450,,250,PERF
42479417150000,PI,IP,001,16,14500,14750,,250,PERF
42479417150000,PI,IP,001,17,14800,15050,,250,PERF
42479417150000,PI,IP,001,18,15100,15350,,250,PERF
42479417150000,PI,IP,001,19,15400,15650,,250,PERF
42479417150000,PI,IP,001,20,15700,15950,,250,PERF
42479417150000,PI,IP,001,21,16000,16250,,250,PERF
42479417160000,PI,IP,001,1,9898,14620,5517,4722,PERF
42479417180000,PI,IP,001,1,8696,12151,4321,3455,OPENHOLE
42479417250000,PI,IP,001,1,7392,12855,6446,5463,PERF
42479417260000,PI,IP,001,1,7342,12957,6309,5615,PERF
42479417310000,PI,IP,001,1,8820,12620,4356,3800,OPENHOLE
42479417320000,PI,IP,001,1,9352,14979,7047,5627,PERF
42479417330000,PI,IP,001,1,9326,14053,6076,4727,PERF
42479417440000,PI,IP,001,1,8737,13196,,4459,PERF
42479417450000,PI,IP,001,1,8347,12856,4351,4509,PERF
42479417480000,PI,IP,001,1,8889,13437,,4548,PERF
42479417490000,PI,IP,001,1,8343,12960,,4617,PERF
42479417530000,PI,IP,001,1,8238,12968,5679,4730,PERF
42479417540000,PI,IP,001,1,8654,14819,7074,6165,PERF
42479417590000,PI,IP,001,1,10050,10300,,250,PERF
42479417590000,PI,IP,001,2,10350,10600,,250,PERF
42479417590000,PI,IP,001,3,10650,10900,,250,PERF
42479417590000,PI,IP,001,4,10950,11200,,250,PERF
42479417590000,PI,IP,001,5,11250,11500,,250,PERF
42479417590000,PI,IP,001,6,11550,11800,,250,PERF
42479417590000,PI,IP,001,7,11850,12100,,250,PERF
42479417590000,PI,IP,001,8,12150,12400,,250,PERF
42479417590000,PI,IP,001,9,12450,12700,,250,PERF
42479417590000,PI,IP,001,10,12750,13000,,250,PERF
42479417590000,PI,IP,001,11,13050,13300,,250,PERF
42479417590000,PI,IP,001,12,13350,13600,,250,PERF
42479417590000,PI,IP,001,13,13650,13900,,250,PERF
42479417590000,PI,IP,001,14,13950,14200,,250,PERF
42479417590000,PI,IP,001,15,14250,14500,,250,PERF
42479417590000,PI,IP,001,16,14550,14800,,250,PERF
42479417590000,PI,IP,001,17,14850,15100,,250,PERF
42479417590000,PI,IP,001,18,15150,15400,,250,PERF
42479417590000,PI,IP,001,19,15450,15700,,250,PERF
42479417590000,PI,IP,001,20,15750,16000,,250,PERF
42479417630000,PI,PT,001,1,,,,,PERF
42479417650000,PI,IP,001,1,9102,9104,5570,2,PERF
42479417650000,PI,IP,001,2,9179,9181,5570,2,PERF
42479417650000,PI,IP,001,3,9256,9258,5570,2,PERF
42479417650000,PI,IP,001,4,9333,9335,5570,2,PERF
42479417650000,PI,IP,001,5,9415,9417,5570,2,PERF
42479417650000,PI,IP,001,6,9492,9494,5570,2,PERF
42479417650000,PI,IP,001,7,9569,9571,5570,2,PERF
42479417650000,PI,IP,001,8,9646,9648,5570,2,PERF
42479417650000,PI,IP,001,9,9728,9730,5570,2,PERF
42479417650000,PI,IP,001,10,9805,9807,5570,2,PERF
42479417650000,PI,IP,001,11,9882,9884,5570,2,PERF
42479417650000,PI,IP,001,12,9959,9961,5570,2,PERF
42479417650000,PI,IP,001,13,10041,10043,5570,2,PERF
42479417650000,PI,IP,001,14,10118,10120,5570,2,PERF
42479417650000,PI,IP,001,15,10195,10197,5570,2,PERF
42479417650000,PI,IP,001,16,10272,10274,5570,2,PERF
42479417650000,PI,IP,001,17,10354,10356,5570,2,PERF
42479417650000,PI,IP,001,18,10431,10433,5570,2,PERF
42479417650000,PI,IP,001,19,10508,10510,5570,2,PERF
42479417650000,PI,IP,001,20,10585,10587,5570,2,PERF
42479417650000,PI,IP,001,21,10667,10669,5570,2,PERF
42479417650000,PI,IP,001,22,10744,10746,5570,2,PERF
42479417650000,PI,IP,001,23,10821,10823,5570,2,PERF
42479417650000,PI,IP,001,24,10898,10900,5570,2,PERF
42479417650000,PI,IP,001,25,10980,10982,5570,2,PERF
42479417650000,PI,IP,001,26,11057,11059,5570,2,PERF
42479417650000,PI,IP,001,27,11134,11136,5570,2,PERF
42479417650000,PI,IP,001,28,11211,11213,5570,2,PERF
42479417650000,PI,IP,001,29,11293,11295,5570,2,PERF
42479417650000,PI,IP,001,30,11370,11372,5570,2,PERF
42479417650000,PI,IP,001,31,11447,11449,5570,2,PERF
42479417650000,PI,IP,001,32,11524,11526,5570,2,PERF
42479417650000,PI,IP,001,33,11606,11608,5570,2,PERF
42479417650000,PI,IP,001,34,11683,11685,5570,2,PERF
42479417650000,PI,IP,001,35,11760,11762,5570,2,PERF
42479417650000,PI,IP,001,36,11837,11839,5570,2,PERF
42479417650000,PI,IP,001,37,11919,11921,5570,2,PERF
42479417650000,PI,IP,001,38,11996,11998,5570,2,PERF
42479417650000,PI,IP,001,39,12073,12075,5570,2,PERF
42479417650000,PI,IP,001,40,12150,12152,5570,2,PERF
42479417650000,PI,IP,001,41,12232,12234,5570,2,PERF
42479417650000,PI,IP,001,42,12309,12311,5570,2,PERF
42479417650000,PI,IP,001,43,12386,12388,5570,2,PERF
42479417650000,PI,IP,001,44,12463,12465,5570,2,PERF
42479417650000,PI,IP,001,45,12545,12547,5570,2,PERF
42479417650000,PI,IP,001,46,12622,12624,5570,2,PERF
42479417650000,PI,IP,001,47,12699,12701,5570,2,PERF
42479417650000,PI,IP,001,48,12776,12778,5570,2,PERF
42479417650000,PI,IP,001,49,12858,12860,5570,2,PERF
42479417650000,PI,IP,001,50,12935,12937,5570,2,PERF
42479417650000,PI,IP,001,51,13012,13014,5570,2,PERF
42479417650000,PI,IP,001,52,13089,13091,5570,2,PERF
42479417650000,PI,IP,001,53,13171,13173,5570,2,PERF
42479417650000,PI,IP,001,54,13248,13250,5570,2,PERF
42479417650000,PI,IP,001,55,13325,13327,5570,2,PERF
42479417650000,PI,IP,001,56,13402,13404,5570,2,PERF
42479417650000,PI,IP,001,57,13484,13486,5570,2,PERF
42479417650000,PI,IP,001,58,13561,13563,5570,2,PERF
42479417650000,PI,IP,001,59,13638,13640,5570,2,PERF
42479417650000,PI,IP,001,60,13715,13717,5570,2,PERF
42479417660000,PI,IP,001,1,7955,12515,5364,4560,PERF
42479417670000,PI,IP,001,1,7865,12737,5284,4872,PERF
42479417680000,PI,PT,001,1,,,,,PERF
42479417690000,PI,PT,001,1,,,,,PERF
42479417700000,PI,PT,001,1,,,,,PERF
42479417720000,PI,IP,001,1,9578,14741,6067,5163,PERF
42479417730000,PI,IP,001,1,9554,14762,6395,5208,PERF
42479417770000,PI,PT,001,1,8208,14518,,6310,PERF
42479417890000,PI,IP,001,1,9607,14592,6075,4985,PERF
42479417920000,PI,IP,001,1,8293,14570,,6277,PERF
42479417940000,PI,IP,001,1,8779,14325,6237,5546,PERF
42479417950000,PI,IP,001,1,8312,13385,5669,5073,PERF
42479417960000,PI,IP,001,1,8312,13162,5308,4850,PERF
42479417970000,PI,IP,001,1,8251,13170,5338,4919,PERF
42479417980000,PI,IP,001,1,8286,13093,5228,4807,PERF
42479418060000,PI,IP,001,1,8428,12835,5085,4407,COMB
42479418090000,PI,IP,001,1,8229,14131,6299,5902,PERF
42479418100000,PI,IP,001,1,8281,10896,,2615,PERF
42479418110000,PI,IP,001,1,8236,14040,5927,5804,PERF
42479418160000,PI,IP,001,1,8552,13543,5523,4991,PERF
42479418190000,PI,IP,001,1,9363,15016,6761,5653,PERF
42479418220000,PI,IP,001,1,8700,12744,4862,4044,PERF
42479418240000,PI,IP,001,1,9443,14072,5795,4629,PERF
42479418260000,PI,IP,001,1,9372,14468,5766,5096,PERF
42479418280000,PI,IP,001,1,7984,13045,6528,5061,PERF
42479418350000,PI,IP,001,1,8949,14184,6855,5235,PERF
42479418360000,PI,IP,001,1,8973,8975,6948,2,PERF
42479418360000,PI,IP,001,2,9055,9057,6948,2,PERF
42479418360000,PI,IP,001,3,9137,9139,6948,2,PERF
42479418360000,PI,IP,001,4,9219,9221,6948,2,PERF
42479418360000,PI,IP,001,5,9305,9307,6948,2,PERF
42479418360000,PI,IP,001,6,9387,9389,6948,2,PERF
42479418360000,PI,IP,001,7,9469,9471,6948,2,PERF
42479418360000,PI,IP,001,8,9551,9553,6948,2,PERF
42479418360000,PI,IP,001,9,9637,9639,6948,2,PERF
42479418360000,PI,IP,001,10,9719,9721,6948,2,PERF
42479418360000,PI,IP,001,11,9801,9803,6948,2,PERF
42479418360000,PI,IP,001,12,9883,9885,6948,2,PERF
42479418360000,PI,IP,001,13,9969,9971,6948,2,PERF
42479418360000,PI,IP,001,14,10051,10053,6948,2,PERF
42479418360000,PI,IP,001,15,10133,10135,6948,2,PERF
42479418360000,PI,IP,001,16,10215,10217,6948,2,PERF
42479418360000,PI,IP,001,17,10301,10303,6948,2,PERF
42479418360000,PI,IP,001,18,10383,10385,6948,2,PERF
42479418360000,PI,IP,001,19,10465,10467,6948,2,PERF
42479418360000,PI,IP,001,20,10547,10549,6948,2,PERF
42479418360000,PI,IP,001,21,10633,10635,6948,2,PERF
42479418360000,PI,IP,001,22,10715,10717,6948,2,PERF
42479418360000,PI,IP,001,23,10797,10799,6948,2,PERF
42479418360000,PI,IP,001,24,10879,10881,6948,2,PERF
42479418360000,PI,IP,001,25,10965,10967,6948,2,PERF
42479418360000,PI,IP,001,26,11047,11049,6948,2,PERF
42479418360000,PI,IP,001,27,11129,11131,6948,2,PERF
42479418360000,PI,IP,001,28,11211,11213,6948,2,PERF
42479418360000,PI,IP,001,29,11297,11299,6948,2,PERF
42479418360000,PI,IP,001,30,11379,11381,6948,2,PERF
42479418360000,PI,IP,001,31,11461,11463,6948,2,PERF
42479418360000,PI,IP,001,32,11543,11545,6948,2,PERF
42479418360000,PI,IP,001,33,11629,11631,6948,2,PERF
42479418360000,PI,IP,001,34,11711,11713,6948,2,PERF
42479418360000,PI,IP,001,35,11793,11795,6948,2,PERF
42479418360000,PI,IP,001,36,11875,11877,6948,2,PERF
42479418360000,PI,IP,001,37,11961,11963,6948,2,PERF
42479418360000,PI,IP,001,38,12043,12045,6948,2,PERF
42479418360000,PI,IP,001,39,12125,12127,6948,2,PERF
42479418360000,PI,IP,001,40,12207,12209,6948,2,PERF
42479418360000,PI,IP,001,41,12293,12295,6948,2,PERF
42479418360000,PI,IP,001,42,12375,12377,6948,2,PERF
42479418360000,PI,IP,001,43,12457,12459,6948,2,PERF
42479418360000,PI,IP,001,44,12539,12541,6948,2,PERF
42479418360000,PI,IP,001,45,12625,12627,6948,2,PERF
42479418360000,PI,IP,001,46,12707,12709,6948,2,PERF
42479418360000,PI,IP,001,47,12789,12791,6948,2,PERF
42479418360000,PI,IP,001,48,12871,12873,6948,2,PERF
42479418360000,PI,IP,001,49,12957,12959,6948,2,PERF
42479418360000,PI,IP,001,50,13039,13041,6948,2,PERF
42479418360000,PI,IP,001,51,13121,13123,6948,2,PERF
42479418360000,PI,IP,001,52,13203,13205,6948,2,PERF
42479418360000,PI,IP,001,53,13289,13291,6948,2,PERF
42479418360000,PI,IP,001,54,13371,13373,6948,2,PERF
42479418360000,PI,IP,001,55,13453,13455,6948,2,PERF
42479418360000,PI,IP,001,56,13535,13537,6948,2,PERF
42479418360000,PI,IP,001,57,13621,13623,6948,2,PERF
42479418360000,PI,IP,001,58,13709,13711,6948,2,PERF
42479418360000,PI,IP,001,59,13797,13799,6948,2,PERF
42479418360000,PI,IP,001,60,13885,13887,6948,2,PERF
42479418380000,PI,IP,001,1,8791,13218,5317,4427,PERF
42479418400000,PI,IP,001,1,9004,9006,6925,2,PERF
42479418400000,PI,IP,001,2,9091,9093,6925,2,PERF
42479418400000,PI,IP,001,3,9178,9180,6925,2,PERF
42479418400000,PI,IP,001,4,9265,9267,6925,2,PERF
42479418400000,PI,IP,001,5,9355,9357,6925,2,PERF
42479418400000,PI,IP,001,6,9442,9444,6925,2,PERF
42479418400000,PI,IP,001,7,9529,9531,6925,2,PERF
42479418400000,PI,IP,001,8,9616,9618,6925,2,PERF
42479418400000,PI,IP,001,9,9706,9708,6925,2,PERF
42479418400000,PI,IP,001,10,9793,9795,6925,2,PERF
42479418400000,PI,IP,001,11,9880,9882,6925,2,PERF
42479418400000,PI,IP,001,12,9967,9969,6925,2,PERF
42479418400000,PI,IP,001,13,10057,10059,6925,2,PERF
42479418400000,PI,IP,001,14,10144,10146,6925,2,PERF
42479418400000,PI,IP,001,15,10231,10233,6925,2,PERF
42479418400000,PI,IP,001,16,10318,10320,6925,2,PERF
42479418400000,PI,IP,001,17,10408,10410,6925,2,PERF
42479418400000,PI,IP,001,18,10495,10497,6925,2,PERF
42479418400000,PI,IP,001,19,10582,10584,6925,2,PERF
42479418400000,PI,IP,001,20,10669,10671,6925,2,PERF
42479418400000,PI,IP,001,21,10759,10761,6925,2,PERF
42479418400000,PI,IP,001,22,10846,10848,6925,2,PERF
42479418400000,PI,IP,001,23,10933,10935,6925,2,PERF
42479418400000,PI,IP,001,24,11020,11022,6925,2,PERF
42479418400000,PI,IP,001,25,11110,11112,6925,2,PERF
42479418400000,PI,IP,001,26,11197,11199,6925,2,PERF
42479418400000,PI,IP,001,27,11284,11286,6925,2,PERF
42479418400000,PI,IP,001,28,11371,11373,6925,2,PERF
42479418400000,PI,IP,001,29,11461,11463,6925,2,PERF
42479418400000,PI,IP,001,30,11548,11550,6925,2,PERF
42479418400000,PI,IP,001,31,11635,11637,6925,2,PERF
42479418400000,PI,IP,001,32,11722,11724,6925,2,PERF
42479418400000,PI,IP,001,33,11812,11814,6925,2,PERF
42479418400000,PI,IP,001,34,11899,11901,6925,2,PERF
42479418400000,PI,IP,001,35,11986,11988,6925,2,PERF
42479418400000,PI,IP,001,36,12076,12078,6925,2,PERF
42479418400000,PI,IP,001,37,12163,12165,6925,2,PERF
42479418400000,PI,IP,001,38,12250,12252,6925,2,PERF
42479418400000,PI,IP,001,39,12337,12339,6925,2,PERF
42479418400000,PI,IP,001,40,12424,12426,6925,2,PERF
42479418400000,PI,IP,001,41,12514,12516,6925,2,PERF
42479418400000,PI,IP,001,42,12601,12603,6925,2,PERF
42479418400000,PI,IP,001,43,12688,12690,6925,2,PERF
42479418400000,PI,IP,001,44,12775,12777,6925,2,PERF
42479418400000,PI,IP,001,45,12865,12867,6925,2,PERF
42479418400000,PI,IP,001,46,12952,12954,6925,2,PERF
42479418400000,PI,IP,001,47,13039,13041,6925,2,PERF
42479418400000,PI,IP,001,48,13126,13128,6925,2,PERF
42479418400000,PI,IP,001,49,13216,13218,6925,2,PERF
42479418400000,PI,IP,001,50,13303,13305,6925,2,PERF
42479418400000,PI,IP,001,51,13390,13392,6925,2,PERF
42479418400000,PI,IP,001,52,13477,13479,6925,2,PERF
42479418400000,PI,IP,001,53,13567,13569,6925,2,PERF
42479418400000,PI,IP,001,54,13654,13656,6925,2,PERF
42479418400000,PI,IP,001,55,13741,13743,6925,2,PERF
42479418400000,PI,IP,001,56,13828,13830,6925,2,PERF
42479418400000,PI,IP,001,57,13918,13920,6925,2,PERF
42479418400000,PI,IP,001,58,14005,14007,6925,2,PERF
42479418400000,PI,IP,001,59,14092,14094,6925,2,PERF
42479418400000,PI,IP,001,60,14179,14181,6925,2,PERF
42479418410000,PI,IP,001,1,9936,14865,5776,4929,PERF
42479418420000,PI,IP,001,1,8828,13067,5048,4239,PERF
42479418440000,PI,IP,001,1,9551,14932,6875,5381,PERF
42479418480000,PI,IP,001,1,10192,14432,5020,4240,PERF
42479418520000,PI,IP,001,1,10013,15129,5846,5116,PERF
42479418530000,PI,IP,001,1,9270,14729,6264,5459,PERF
42479418610000,PI,IP,001,1,7988,13849,6798,5861,PERF
42479418640000,PI,IP,001,1,9366,14085,5369,4719,PERF
42479418680000,PI,IP,001,1,8912,8914,6240,2,PERF
42479418680000,PI,IP,001,2,9000,9002,6240,2,PERF
42479418680000,PI,IP,001,3,9088,9090,6240,2,PERF
42479418680000,PI,IP,001,4,9176,9178,6240,2,PERF
42479418680000,PI,IP,001,5,9269,9271,6240,2,PERF
42479418680000,PI,IP,001,6,9357,9359,6240,2,PERF
42479418680000,PI,IP,001,7,9445,9447,6240,2,PERF
42479418680000,PI,IP,001,8,9533,9535,6240,2,PERF
42479418680000,PI,IP,001,9,9626,9628,6240,2,PERF
42479418680000,PI,IP,001,10,9714,9716,6240,2,PERF
42479418680000,PI,IP,001,11,9802,9804,6240,2,PERF
42479418680000,PI,IP,001,12,9890,9892,6240,2,PERF
42479418680000,PI,IP,001,13,9983,9985,6240,2,PERF
42479418680000,PI,IP,001,14,10071,10073,6240,2,PERF
42479418680000,PI,IP,001,15,10159,10161,6240,2,PERF
42479418680000,PI,IP,001,16,10247,10249,6240,2,PERF
42479418680000,PI,IP,001,17,10340,10342,6240,2,PERF
42479418680000,PI,IP,001,18,10428,10430,6240,2,PERF
42479418680000,PI,IP,001,19,10516,10518,6240,2,PERF
42479418680000,PI,IP,001,20,10604,10606,6240,2,PERF
42479418680000,PI,IP,001,21,10697,10699,6240,2,PERF
42479418680000,PI,IP,001,22,10785,10787,6240,2,PERF
42479418680000,PI,IP,001,23,10873,10875,6240,2,PERF
42479418680000,PI,IP,001,24,10961,10963,6240,2,PERF
42479418680000,PI,IP,001,25,11054,11056,6240,2,PERF
42479418680000,PI,IP,001,26,11142,11144,6240,2,PERF
42479418680000,PI,IP,001,27,11230,11232,6240,2,PERF
42479418680000,PI,IP,001,28,11318,11320,6240,2,PERF
42479418680000,PI,IP,001,29,11411,11413,6240,2,PERF
42479418680000,PI,IP,001,30,11499,11501,6240,2,PERF
42479418680000,PI,IP,001,31,11587,11589,6240,2,PERF
42479418680000,PI,IP,001,32,11675,11677,6240,2,PERF
42479418680000,PI,IP,001,33,11768,11770,6240,2,PERF
42479418680000,PI,IP,001,34,11856,11858,6240,2,PERF
42479418680000,PI,IP,001,35,11944,11946,6240,2,PERF
42479418680000,PI,IP,001,36,12032,12034,6240,2,PERF
42479418680000,PI,IP,001,37,12125,12127,6240,2,PERF
42479418680000,PI,IP,001,38,12213,12215,6240,2,PERF
42479418680000,PI,IP,001,39,12301,12303,6240,2,PERF
42479418680000,PI,IP,001,40,12389,12391,6240,2,PERF
42479418680000,PI,IP,001,41,12482,12484,6240,2,PERF
42479418680000,PI,IP,001,42,12570,12572,6240,2,PERF
42479418680000,PI,IP,001,43,12658,12660,6240,2,PERF
42479418680000,PI,IP,001,44,12746,12748,6240,2,PERF
42479418680000,PI,IP,001,45,12839,12841,6240,2,PERF
42479418680000,PI,IP,001,46,12927,12929,6240,2,PERF
42479418680000,PI,IP,001,47,13015,13017,6240,2,PERF
42479418680000,PI,IP,001,48,13103,13105,6240,2,PERF
42479418680000,PI,IP,001,49,13196,13198,6240,2,PERF
42479418680000,PI,IP,001,50,13284,13286,6240,2,PERF
42479418680000,PI,IP,001,51,13372,13374,6240,2,PERF
42479418680000,PI,IP,001,52,13460,13462,6240,2,PERF
42479418680000,PI,IP,001,53,13553,13555,6240,2,PERF
42479418680000,PI,IP,001,54,13641,13643,6240,2,PERF
42479418680000,PI,IP,001,55,13729,13731,6240,2,PERF
42479418680000,PI,IP,001,56,13817,13819,6240,2,PERF
42479418680000,PI,IP,001,57,13909,13911,6240,2,PERF
42479418680000,PI,IP,001,58,13989,13991,6240,2,PERF
42479418680000,PI,IP,001,59,14069,14071,6240,2,PERF
42479418680000,PI,IP,001,60,14149,14151,6240,2,PERF
42479418690000,PI,IP,001,1,8874,8876,6134,2,PERF
42479418690000,PI,IP,001,2,8962,8964,6134,2,PERF
42479418690000,PI,IP,001,3,9050,9052,6134,2,PERF
42479418690000,PI,IP,001,4,9138,9140,6134,2,PERF
42479418690000,PI,IP,001,5,9232,9234,6134,2,PERF
42479418690000,PI,IP,001,6,9320,9322,6134,2,PERF
42479418690000,PI,IP,001,7,9408,9410,6134,2,PERF
42479418690000,PI,IP,001,8,9496,9498,6134,2,PERF
42479418690000,PI,IP,001,9,9590,9592,6134,2,PERF
42479418690000,PI,IP,001,10,9678,9680,6134,2,PERF
42479418690000,PI,IP,001,11,9766,9768,6134,2,PERF
42479418690000,PI,IP,001,12,9854,9856,6134,2,PERF
42479418690000,PI,IP,001,13,9948,9950,6134,2,PERF
42479418690000,PI,IP,001,14,10036,10038,6134,2,PERF
42479418690000,PI,IP,001,15,10124,10126,6134,2,PERF
42479418690000,PI,IP,001,16,10212,10214,6134,2,PERF
42479418690000,PI,IP,001,17,10306,10308,6134,2,PERF
42479418690000,PI,IP,001,18,10394,10396,6134,2,PERF
42479418690000,PI,IP,001,19,10482,10484,6134,2,PERF
42479418690000,PI,IP,001,20,10570,10572,6134,2,PERF
42479418690000,PI,IP,001,21,10664,10666,6134,2,PERF
42479418690000,PI,IP,001,22,10752,10754,6134,2,PERF
42479418690000,PI,IP,001,23,10840,10842,6134,2,PERF
42479418690000,PI,IP,001,24,10928,10930,6134,2,PERF
42479418690000,PI,IP,001,25,11022,11024,6134,2,PERF
42479418690000,PI,IP,001,26,11110,11112,6134,2,PERF
42479418690000,PI,IP,001,27,11198,11200,6134,2,PERF
42479418690000,PI,IP,001,28,11286,11288,6134,2,PERF
42479418690000,PI,IP,001,29,11380,11382,6134,2,PERF
42479418690000,PI,IP,001,30,11468,11470,6134,2,PERF
42479418690000,PI,IP,001,31,11556,11558,6134,2,PERF
42479418690000,PI,IP,001,32,11644,11646,6134,2,PERF
42479418690000,PI,IP,001,33,11738,11740,6134,2,PERF
42479418690000,PI,IP,001,34,11826,11828,6134,2,PERF
42479418690000,PI,IP,001,35,11914,11916,6134,2,PERF
42479418690000,PI,IP,001,36,12002,12004,6134,2,PERF
42479418690000,PI,IP,001,37,12096,12098,6134,2,PERF
42479418690000,PI,IP,001,38,12184,12186,6134,2,PERF
42479418690000,PI,IP,001,39,12272,12274,6134,2,PERF
42479418690000,PI,IP,001,40,12360,12362,6134,2,PERF
42479418690000,PI,IP,001,41,12454,12456,6134,2,PERF
42479418690000,PI,IP,001,42,12542,12544,6134,2,PERF
42479418690000,PI,IP,001,43,12630,12632,6134,2,PERF
42479418690000,PI,IP,001,44,12718,12720,6134,2,PERF
42479418690000,PI,IP,001,45,12812,12814,6134,2,PERF
42479418690000,PI,IP,001,46,12900,12902,6134,2,PERF
42479418690000,PI,IP,001,47,12988,12990,6134,2,PERF
42479418690000,PI,IP,001,48,13076,13078,6134,2,PERF
42479418690000,PI,IP,001,49,13170,13172,6134,2,PERF
42479418690000,PI,IP,001,50,13258,13260,6134,2,PERF
42479418690000,PI,IP,001,51,13346,13348,6134,2,PERF
42479418690000,PI,IP,001,52,13434,13436,6134,2,PERF
42479418690000,PI,IP,001,53,13528,13530,6134,2,PERF
42479418690000,PI,IP,001,54,13616,13618,6134,2,PERF
42479418690000,PI,IP,001,55,13704,13706,6134,2,PERF
42479418690000,PI,IP,001,56,13792,13794,6134,2,PERF
42479418690000,PI,IP,001,57,13886,13888,6134,2,PERF
42479418690000,PI,IP,001,58,13966,13968,6134,2,PERF
42479418690000,PI,IP,001,59,14046,14048,6134,2,PERF
42479418690000,PI,IP,001,60,14126,14128,6134,2,PERF
42479418700000,PI,PT,001,1,,,,,PERF
42479418710000,PI,IP,001,1,8795,14932,6929,6137,PERF
42479418720000,PI,IP,001,1,8587,12888,5085,4301,PERF
42479418730000,PI,IP,001,1,8326,14055,,5729,PERF
42479418740000,PI,IP,001,1,8883,8885,6061,2,PERF
42479418740000,PI,IP,001,2,8971,8973,6061,2,PERF
42479418740000,PI,IP,001,3,9059,9061,6061,2,PERF
42479418740000,PI,IP,001,4,9147,9149,6061,2,PERF
42479418740000,PI,IP,001,5,9241,9243,6061,2,PERF
42479418740000,PI,IP,001,6,9329,9331,6061,2,PERF
42479418740000,PI,IP,001,7,9417,9419,6061,2,PERF
42479418740000,PI,IP,001,8,9505,9507,6061,2,PERF
42479418740000,PI,IP,001,9,9599,9601,6061,2,PERF
42479418740000,PI,IP,001,10,9687,9689,6061,2,PERF
42479418740000,PI,IP,001,11,9775,9777,6061,2,PERF
42479418740000,PI,IP,001,12,9863,9865,6061,2,PERF
42479418740000,PI,IP,001,13,9957,9959,6061,2,PERF
42479418740000,PI,IP,001,14,10045,10047,6061,2,PERF
42479418740000,PI,IP,001,15,10133,10135,6061,2,PERF
42479418740000,PI,IP,001,16,10221,10223,6061,2,PERF
42479418740000,PI,IP,001,17,10315,10317,6061,2,PERF
42479418740000,PI,IP,001,18,10403,10405,6061,2,PERF
42479418740000,PI,IP,001,19,10491,10493,6061,2,PERF
42479418740000,PI,IP,001,20,10579,10581,6061,2,PERF
42479418740000,PI,IP,001,21,10673,10675,6061,2,PERF
42479418740000,PI,IP,001,22,10761,10763,6061,2,PERF
42479418740000,PI,IP,001,23,10849,10851,6061,2,PERF
42479418740000,PI,IP,001,24,10937,10939,6061,2,PERF
42479418740000,PI,IP,001,25,11031,11033,6061,2,PERF
42479418740000,PI,IP,001,26,11119,11121,6061,2,PERF
42479418740000,PI,IP,001,27,11207,11209,6061,2,PERF
42479418740000,PI,IP,001,28,11295,11297,6061,2,PERF
42479418740000,PI,IP,001,29,11389,11391,6061,2,PERF
42479418740000,PI,IP,001,30,11477,11479,6061,2,PERF
42479418740000,PI,IP,001,31,11565,11567,6061,2,PERF
42479418740000,PI,IP,001,32,11653,11655,6061,2,PERF
42479418740000,PI,IP,001,33,11747,11749,6061,2,PERF
42479418740000,PI,IP,001,34,11835,11837,6061,2,PERF
42479418740000,PI,IP,001,35,11923,11925,6061,2,PERF
42479418740000,PI,IP,001,36,12011,12013,6061,2,PERF
42479418740000,PI,IP,001,37,12105,12107,6061,2,PERF
42479418740000,PI,IP,001,38,12193,12195,6061,2,PERF
42479418740000,PI,IP,001,39,12281,12283,6061,2,PERF
42479418740000,PI,IP,001,40,12369,12371,6061,2,PERF
42479418740000,PI,IP,001,41,12463,12465,6061,2,PERF
42479418740000,PI,IP,001,42,12551,12553,6061,2,PERF
42479418740000,PI,IP,001,43,12639,12641,6061,2,PERF
42479418740000,PI,IP,001,44,12727,12729,6061,2,PERF
42479418740000,PI,IP,001,45,12821,12823,6061,2,PERF
42479418740000,PI,IP,001,46,12909,12911,6061,2,PERF
42479418740000,PI,IP,001,47,12997,12999,6061,2,PERF
42479418740000,PI,IP,001,48,13085,13087,6061,2,PERF
42479418740000,PI,IP,001,49,13179,13181,6061,2,PERF
42479418740000,PI,IP,001,50,13267,13269,6061,2,PERF
42479418740000,PI,IP,001,51,13355,13357,6061,2,PERF
42479418740000,PI,IP,001,52,13443,13445,6061,2,PERF
42479418740000,PI,IP,001,53,13537,13539,6061,2,PERF
42479418740000,PI,IP,001,54,13625,13627,6061,2,PERF
42479418740000,PI,IP,001,55,13713,13715,6061,2,PERF
42479418740000,PI,IP,001,56,13801,13803,6061,2,PERF
42479418740000,PI,IP,001,57,13895,13897,6061,2,PERF
42479418740000,PI,IP,001,58,13975,13977,6061,2,PERF
42479418740000,PI,IP,001,59,14055,14057,6061,2,PERF
42479418740000,PI,IP,001,60,14135,14137,6061,2,PERF
42479418760000,PI,IP,001,1,8908,8910,6297,2,PERF
42479418760000,PI,IP,001,2,8996,8998,6297,2,PERF
42479418760000,PI,IP,001,3,9084,9086,6297,2,PERF
42479418760000,PI,IP,001,4,9172,9174,6297,2,PERF
42479418760000,PI,IP,001,5,9265,9267,6297,2,PERF
42479418760000,PI,IP,001,6,9353,9355,6297,2,PERF
42479418760000,PI,IP,001,7,9441,9443,6297,2,PERF
42479418760000,PI,IP,001,8,9529,9531,6297,2,PERF
42479418760000,PI,IP,001,9,9622,9624,6297,2,PERF
42479418760000,PI,IP,001,10,9710,9712,6297,2,PERF
42479418760000,PI,IP,001,11,9798,9800,6297,2,PERF
42479418760000,PI,IP,001,12,9886,9888,6297,2,PERF
42479418760000,PI,IP,001,13,9979,9981,6297,2,PERF
42479418760000,PI,IP,001,14,10067,10069,6297,2,PERF
42479418760000,PI,IP,001,15,10155,10157,6297,2,PERF
42479418760000,PI,IP,001,16,10243,10245,6297,2,PERF
42479418760000,PI,IP,001,17,10336,10338,6297,2,PERF
42479418760000,PI,IP,001,18,10424,10426,6297,2,PERF
42479418760000,PI,IP,001,19,10512,10514,6297,2,PERF
42479418760000,PI,IP,001,20,10600,10602,6297,2,PERF
42479418760000,PI,IP,001,21,10693,10695,6297,2,PERF
42479418760000,PI,IP,001,22,10781,10783,6297,2,PERF
42479418760000,PI,IP,001,23,10869,10871,6297,2,PERF
42479418760000,PI,IP,001,24,10957,10959,6297,2,PERF
42479418760000,PI,IP,001,25,11050,11052,6297,2,PERF
42479418760000,PI,IP,001,26,11138,11140,6297,2,PERF
42479418760000,PI,IP,001,27,11226,11228,6297,2,PERF
42479418760000,PI,IP,001,28,11314,11316,6297,2,PERF
42479418760000,PI,IP,001,29,11407,11409,6297,2,PERF
42479418760000,PI,IP,001,30,11495,11497,6297,2,PERF
42479418760000,PI,IP,001,31,11583,11585,6297,2,PERF
42479418760000,PI,IP,001,32,11671,11673,6297,2,PERF
42479418760000,PI,IP,001,33,11764,11766,6297,2,PERF
42479418760000,PI,IP,001,34,11852,11854,6297,2,PERF
42479418760000,PI,IP,001,35,11940,11942,6297,2,PERF
42479418760000,PI,IP,001,36,12028,12030,6297,2,PERF
42479418760000,PI,IP,001,37,12121,12123,6297,2,PERF
42479418760000,PI,IP,001,38,12209,12211,6297,2,PERF
42479418760000,PI,IP,001,39,12297,12299,6297,2,PERF
42479418760000,PI,IP,001,40,12385,12387,6297,2,PERF
42479418760000,PI,IP,001,41,12478,12480,6297,2,PERF
42479418760000,PI,IP,001,42,12566,12568,6297,2,PERF
42479418760000,PI,IP,001,43,12654,12656,6297,2,PERF
42479418760000,PI,IP,001,44,12742,12744,6297,2,PERF
42479418760000,PI,IP,001,45,12835,12837,6297,2,PERF
42479418760000,PI,IP,001,46,12923,12925,6297,2,PERF
42479418760000,PI,IP,001,47,13011,13013,6297,2,PERF
42479418760000,PI,IP,001,48,13099,13101,6297,2,PERF
42479418760000,PI,IP,001,49,13192,13194,6297,2,PERF
42479418760000,PI,IP,001,50,13280,13282,6297,2,PERF
42479418760000,PI,IP,001,51,13368,13370,6297,2,PERF
42479418760000,PI,IP,001,52,13456,13458,6297,2,PERF
42479418760000,PI,IP,001,53,13549,13551,6297,2,PERF
42479418760000,PI,IP,001,54,13637,13639,6297,2,PERF
42479418760000,PI,IP,001,55,13725,13727,6297,2,PERF
42479418760000,PI,IP,001,56,13813,13815,6297,2,PERF
42479418760000,PI,IP,001,57,13905,13907,6297,2,PERF
42479418760000,PI,IP,001,58,13985,13987,6297,2,PERF
42479418760000,PI,IP,001,59,14065,14067,6297,2,PERF
42479418760000,PI,IP,001,60,14145,14147,6297,2,PERF
42479418770000,PI,IP,001,1,8943,13917,6317,4974,PERF
42479418800000,PI,IP,001,1,9439,14475,5911,5036,PERF
42479418810000,PI,IP,001,1,9280,14376,5978,5096,PERF
42479418820000,PI,PT,001,1,,,,,PERF
42479418850000,PI,IP,001,1,8906,8908,5988,2,PERF
42479418850000,PI,IP,001,2,8989,8991,5988,2,PERF
42479418850000,PI,IP,001,3,9079,9081,5988,2,PERF
42479418850000,PI,IP,001,4,9169,9171,5988,2,PERF
42479418850000,PI,IP,001,5,9264,9266,5988,2,PERF
42479418850000,PI,IP,001,6,9348,9350,5988,2,PERF
42479418850000,PI,IP,001,7,9444,9446,5988,2,PERF
42479418850000,PI,IP,001,8,9530,9532,5988,2,PERF
42479418850000,PI,IP,001,9,9629,9631,5988,2,PERF
42479418850000,PI,IP,001,10,9719,9721,5988,2,PERF
42479418850000,PI,IP,001,11,9814,9816,5988,2,PERF
42479418850000,PI,IP,001,12,9899,9901,5988,2,PERF
42479418850000,PI,IP,001,13,9988,9990,5988,2,PERF
42479418850000,PI,IP,001,14,10084,10086,5988,2,PERF
42479418850000,PI,IP,001,15,10174,10176,5988,2,PERF
42479418850000,PI,IP,001,16,10270,10272,5988,2,PERF
42479418850000,PI,IP,001,17,10359,10361,5988,2,PERF
42479418850000,PI,IP,001,18,10449,10451,5988,2,PERF
42479418850000,PI,IP,001,19,10539,10541,5988,2,PERF
42479418850000,PI,IP,001,20,10629,10631,5988,2,PERF
42479418850000,PI,IP,001,21,10728,10730,5988,2,PERF
42479418850000,PI,IP,001,22,10814,10816,5988,2,PERF
42479418850000,PI,IP,001,23,10904,10906,5988,2,PERF
42479418850000,PI,IP,001,24,10997,10999,5988,2,PERF
42479418850000,PI,IP,001,25,11089,11091,5988,2,PERF
42479418850000,PI,IP,001,26,11179,11181,5988,2,PERF
42479418850000,PI,IP,001,27,11269,11271,5988,2,PERF
42479418850000,PI,IP,001,28,11359,11361,5988,2,PERF
42479418850000,PI,IP,001,29,11454,11456,5988,2,PERF
42479418850000,PI,IP,001,30,11544,11546,5988,2,PERF
42479418850000,PI,IP,001,31,11630,11632,5988,2,PERF
42479418850000,PI,IP,001,32,11724,11726,5988,2,PERF
42479418850000,PI,IP,001,33,11816,11818,5988,2,PERF
42479418850000,PI,IP,001,34,11909,11911,5988,2,PERF
42479418850000,PI,IP,001,35,11999,12001,5988,2,PERF
42479418850000,PI,IP,001,36,12086,12088,5988,2,PERF
42479418850000,PI,IP,001,37,12184,12186,5988,2,PERF
42479418850000,PI,IP,001,38,12274,12276,5988,2,PERF
42479418850000,PI,IP,001,39,12364,12366,5988,2,PERF
42479418850000,PI,IP,001,40,12454,12456,5988,2,PERF
42479418850000,PI,IP,001,41,12542,12544,5988,2,PERF
42479418850000,PI,IP,001,42,12639,12641,5988,2,PERF
42479418850000,PI,IP,001,43,12729,12731,5988,2,PERF
42479418850000,PI,IP,001,44,12812,12814,5988,2,PERF
42479418850000,PI,IP,001,45,12914,12916,5988,2,PERF
42479418850000,PI,IP,001,46,13004,13006,5988,2,PERF
42479418850000,PI,IP,001,47,13092,13094,5988,2,PERF
42479418850000,PI,IP,001,48,13184,13186,5988,2,PERF
42479418850000,PI,IP,001,49,13274,13276,5988,2,PERF
42479418850000,PI,IP,001,50,13369,13371,5988,2,PERF
42479418850000,PI,IP,001,51,13459,13461,5988,2,PERF
42479418850000,PI,IP,001,52,13542,13544,5988,2,PERF
42479418850000,PI,IP,001,53,13644,13646,5988,2,PERF
42479418850000,PI,IP,001,54,13734,13736,5988,2,PERF
42479418850000,PI,IP,001,55,13824,13826,5988,2,PERF
42479418850000,PI,IP,001,56,13914,13916,5988,2,PERF
42479418850000,PI,IP,001,57,14008,14010,5988,2,PERF
42479418850000,PI,IP,001,58,14088,14090,5988,2,PERF
42479418850000,PI,IP,001,59,14168,14170,5988,2,PERF
42479418850000,PI,IP,001,60,14248,14250,5988,2,PERF
42479418860000,PI,IP,001,1,8950,13687,5481,4737,PERF
42479418880000,PI,IP,001,1,8824,14666,6916,5842,PERF
42479418890000,PI,IP,001,1,8601,14120,6089,5519,PERF
42479418920000,PI,IP,001,1,7896,11900,5044,4004,PERF
42479418930000,PI,IP,001,1,7942,12246,5692,4304,PERF
42479419010000,PI,IP,001,1,9344,14912,6387,5568,PERF
42479419020000,PI,IP,001,1,9455,14603,6312,5148,PERF
42479419030000,PI,IP,001,1,9443,14780,6698,5337,PERF
42479419040000,PI,IP,001,1,9113,9115,6035,2,PERF
42479419040000,PI,IP,001,2,9202,9204,6035,2,PERF
42479419040000,PI,IP,001,3,9281,9283,6035,2,PERF
42479419040000,PI,IP,001,4,9365,9367,6035,2,PERF
42479419040000,PI,IP,001,5,9455,9457,6035,2,PERF
42479419040000,PI,IP,001,6,9539,9541,6035,2,PERF
42479419040000,PI,IP,001,7,9623,9625,6035,2,PERF
42479419040000,PI,IP,001,8,9707,9709,6035,2,PERF
42479419040000,PI,IP,001,9,9797,9799,6035,2,PERF
42479419040000,PI,IP,001,10,9884,9886,6035,2,PERF
42479419040000,PI,IP,001,11,9961,9963,6035,2,PERF
42479419040000,PI,IP,001,12,10049,10051,6035,2,PERF
42479419040000,PI,IP,001,13,10139,10141,6035,2,PERF
42479419040000,PI,IP,001,14,10223,10225,6035,2,PERF
42479419040000,PI,IP,001,15,10307,10309,6035,2,PERF
42479419040000,PI,IP,001,16,10391,10393,6035,2,PERF
42479419040000,PI,IP,001,17,10481,10483,6035,2,PERF
42479419040000,PI,IP,001,18,10565,10567,6035,2,PERF
42479419040000,PI,IP,001,19,10642,10644,6035,2,PERF
42479419040000,PI,IP,001,20,10733,10735,6035,2,PERF
42479419040000,PI,IP,001,21,10823,10825,6035,2,PERF
42479419040000,PI,IP,001,22,10907,10909,6035,2,PERF
42479419040000,PI,IP,001,23,10991,10993,6035,2,PERF
42479419040000,PI,IP,001,24,11075,11077,6035,2,PERF
42479419040000,PI,IP,001,25,11165,11167,6035,2,PERF
42479419040000,PI,IP,001,26,11249,11251,6035,2,PERF
42479419040000,PI,IP,001,27,11334,11336,6035,2,PERF
42479419040000,PI,IP,001,28,11414,11416,6035,2,PERF
42479419040000,PI,IP,001,29,11504,11506,6035,2,PERF
42479419040000,PI,IP,001,30,11591,11593,6035,2,PERF
42479419040000,PI,IP,001,31,11675,11677,6035,2,PERF
42479419040000,PI,IP,001,32,11759,11761,6035,2,PERF
42479419040000,PI,IP,001,33,11849,11851,6035,2,PERF
42479419040000,PI,IP,001,34,11933,11935,6035,2,PERF
42479419040000,PI,IP,001,35,12017,12019,6035,2,PERF
42479419040000,PI,IP,001,36,12108,12110,6035,2,PERF
42479419040000,PI,IP,001,37,12196,12198,6035,2,PERF
42479419040000,PI,IP,001,38,12275,12277,6035,2,PERF
42479419040000,PI,IP,001,39,12359,12361,6035,2,PERF
42479419040000,PI,IP,001,40,12443,12445,6035,2,PERF
42479419040000,PI,IP,001,41,12533,12535,6035,2,PERF
42479419040000,PI,IP,001,42,12617,12619,6035,2,PERF
42479419040000,PI,IP,001,43,12701,12703,6035,2,PERF
42479419040000,PI,IP,001,44,12786,12788,6035,2,PERF
42479419040000,PI,IP,001,45,12877,12879,6035,2,PERF
42479419040000,PI,IP,001,46,12956,12958,6035,2,PERF
42479419040000,PI,IP,001,47,13043,13045,6035,2,PERF
42479419040000,PI,IP,001,48,13127,13129,6035,2,PERF
42479419040000,PI,IP,001,49,13217,13219,6035,2,PERF
42479419040000,PI,IP,001,50,13301,13303,6035,2,PERF
42479419040000,PI,IP,001,51,13385,13387,6035,2,PERF
42479419040000,PI,IP,001,52,13469,13471,6035,2,PERF
42479419040000,PI,IP,001,53,13559,13561,6035,2,PERF
42479419040000,PI,IP,001,54,13643,13645,6035,2,PERF
42479419040000,PI,IP,001,55,13727,13729,6035,2,PERF
42479419040000,PI,IP,001,56,13811,13813,6035,2,PERF
42479419040000,PI,IP,001,57,13901,13903,6035,2,PERF
42479419040000,PI,IP,001,58,13981,13983,6035,2,PERF
42479419040000,PI,IP,001,59,14061,14063,6035,2,PERF
42479419040000,PI,IP,001,60,14141,14143,6035,2,PERF
42479419080000,PI,IP,001,1,8623,13875,6289,5252,PERF
42479419150000,PI,IP,001,1,8878,12979,5483,4101,PERF
42479419230000,PI,IP,001,1,7883,12645,5473,4762,PERF
42479419240000,PI,IP,001,1,7986,11960,4761,3974,PERF
42479419300000,PI,IP,001,1,10078,15393,6069,5315,PERF
42479419340000,PI,IP,001,1,8609,12913,5299,4304,PERF
42479419360000,PI,IP,001,1,9009,9011,5949,2,PERF
42479419360000,PI,IP,001,2,9094,9096,5949,2,PERF
42479419360000,PI,IP,001,3,9179,9181,5949,2,PERF
42479419360000,PI,IP,001,4,9268,9270,5949,2,PERF
42479419360000,PI,IP,001,5,9360,9362,5949,2,PERF
42479419360000,PI,IP,001,6,9437,9439,5949,2,PERF
42479419360000,PI,IP,001,7,9527,9529,5949,2,PERF
42479419360000,PI,IP,001,8,9611,9613,5949,2,PERF
42479419360000,PI,IP,001,9,9703,9705,5949,2,PERF
42479419360000,PI,IP,001,10,9788,9790,5949,2,PERF
42479419360000,PI,IP,001,11,9873,9875,5949,2,PERF
42479419360000,PI,IP,001,12,9958,9960,5949,2,PERF
42479419360000,PI,IP,001,13,10050,10052,5949,2,PERF
42479419360000,PI,IP,001,14,10135,10137,5949,2,PERF
42479419360000,PI,IP,001,15,10220,10222,5949,2,PERF
42479419360000,PI,IP,001,16,10309,10311,5949,2,PERF
42479419360000,PI,IP,001,17,10400,10402,5949,2,PERF
42479419360000,PI,IP,001,18,10482,10484,5949,2,PERF
42479419360000,PI,IP,001,19,10567,10569,5949,2,PERF
42479419360000,PI,IP,001,20,10652,10654,5949,2,PERF
42479419360000,PI,IP,001,21,10744,10746,5949,2,PERF
42479419360000,PI,IP,001,22,10829,10831,5949,2,PERF
42479419360000,PI,IP,001,23,10914,10916,5949,2,PERF
42479419360000,PI,IP,001,24,10999,11001,5949,2,PERF
42479419360000,PI,IP,001,25,11091,11093,5949,2,PERF
42479419360000,PI,IP,001,26,11176,11178,5949,2,PERF
42479419360000,PI,IP,001,27,11261,11263,5949,2,PERF
42479419360000,PI,IP,001,28,11350,11352,5949,2,PERF
42479419360000,PI,IP,001,29,11440,11442,5949,2,PERF
42479419360000,PI,IP,001,30,11520,11522,5949,2,PERF
42479419360000,PI,IP,001,31,11608,11610,5949,2,PERF
42479419360000,PI,IP,001,32,11693,11695,5949,2,PERF
42479419360000,PI,IP,001,33,11785,11787,5949,2,PERF
42479419360000,PI,IP,001,34,11870,11872,5949,2,PERF
42479419360000,PI,IP,001,35,11955,11957,5949,2,PERF
42479419360000,PI,IP,001,36,12040,12042,5949,2,PERF
42479419360000,PI,IP,001,37,12132,12134,5949,2,PERF
42479419360000,PI,IP,001,38,12217,12219,5949,2,PERF
42479419360000,PI,IP,001,39,12302,12304,5949,2,PERF
42479419360000,PI,IP,001,40,12392,12394,5949,2,PERF
42479419360000,PI,IP,001,41,12482,12484,5949,2,PERF
42479419360000,PI,IP,001,42,12562,12564,5949,2,PERF
42479419360000,PI,IP,001,43,12649,12651,5949,2,PERF
42479419360000,PI,IP,001,44,12734,12736,5949,2,PERF
42479419360000,PI,IP,001,45,12826,12828,5949,2,PERF
42479419360000,PI,IP,001,46,12911,12913,5949,2,PERF
42479419360000,PI,IP,001,47,12996,12998,5949,2,PERF
42479419360000,PI,IP,001,48,13081,13083,5949,2,PERF
42479419360000,PI,IP,001,49,13173,13175,5949,2,PERF
42479419360000,PI,IP,001,50,13258,13260,5949,2,PERF
42479419360000,PI,IP,001,51,13343,13345,5949,2,PERF
42479419360000,PI,IP,001,52,13430,13432,5949,2,PERF
42479419360000,PI,IP,001,53,13520,13522,5949,2,PERF
42479419360000,PI,IP,001,54,13605,13607,5949,2,PERF
42479419360000,PI,IP,001,55,13690,13692,5949,2,PERF
42479419360000,PI,IP,001,56,13775,13777,5949,2,PERF
42479419360000,PI,IP,001,57,13867,13869,5949,2,PERF
42479419360000,PI,IP,001,58,13947,13949,5949,2,PERF
42479419360000,PI,IP,001,59,14027,14029,5949,2,PERF
42479419360000,PI,IP,001,60,14107,14109,5949,2,PERF
42479419370000,PI,IP,001,1,9258,14011,5572,4753,PERF
42479419380000,PI,IP,001,1,9205,14014,5741,4809,PERF
42479419420000,PI,IP,001,1,9804,16245,7696,6441,PERF
42479419460000,PI,IP,001,1,9829,16361,7967,6532,PERF
42479419470000,PI,IP,001,1,9216,14074,6065,4858,PERF
42479419480000,PI,IP,001,1,9854,13942,5116,4088,PERF
42479419580000,PI,IP,001,1,9228,15107,6701,5879,PERF
42479419590000,PI,IP,001,1,9644,15016,6517,5372,PERF
42479419640000,PI,IP,001,1,8910,14890,6989,5980,PERF
42479419650000,PI,IP,001,1,9544,14558,,5014,PERF
42479419660000,PI,IP,001,1,9290,15259,6995,5969,PERF
42479419670000,PI,IP,001,1,9642,9870,6119,228,PERF
42479419670000,PI,IP,001,2,9952,10182,6119,230,PERF
42479419670000,PI,IP,001,3,10260,10490,6119,230,PERF
42479419670000,PI,IP,001,4,10568,10798,6119,230,PERF
42479419670000,PI,IP,001,5,10876,11106,6119,230,PERF
42479419670000,PI,IP,001,6,11184,11412,6119,228,PERF
42479419670000,PI,IP,001,7,11488,11716,6119,228,PERF
42479419670000,PI,IP,001,8,11800,12030,6119,230,PERF
42479419670000,PI,IP,001,9,12108,12338,6119,230,PERF
42479419670000,PI,IP,001,10,12416,12646,6119,230,PERF
42479419670000,PI,IP,001,11,12724,12954,6119,230,PERF
42479419670000,PI,IP,001,12,13030,13258,6119,228,PERF
42479419670000,PI,IP,001,13,13340,13570,6119,230,PERF
42479419670000,PI,IP,001,14,13648,13878,6119,230,PERF
42479419670000,PI,IP,001,15,13956,14106,6119,150,PERF
42479419680000,PI,IP,001,1,9954,10184,6029,230,PERF
42479419680000,PI,IP,001,2,10264,10494,6029,230,PERF
42479419680000,PI,IP,001,3,10568,10808,6029,240,PERF
42479419680000,PI,IP,001,4,10884,11114,6029,230,PERF
42479419680000,PI,IP,001,5,11194,11424,6029,230,PERF
42479419680000,PI,IP,001,6,11504,11734,6029,230,PERF
42479419680000,PI,IP,001,7,11814,12042,6029,228,PERF
42479419680000,PI,IP,001,8,12124,12354,6029,230,PERF
42479419680000,PI,IP,001,9,12434,12670,6029,236,PERF
42479419680000,PI,IP,001,10,12744,12974,6029,230,PERF
42479419680000,PI,IP,001,11,13054,13284,6029,230,PERF
42479419680000,PI,IP,001,12,13364,13594,6029,230,PERF
42479419680000,PI,IP,001,13,13674,13904,6029,230,PERF
42479419680000,PI,IP,001,14,13984,14136,6029,152,PERF
42479419690000,PI,IP,001,1,9951,10184,6024,233,PERF
42479419690000,PI,IP,001,2,10263,10496,6024,233,PERF
42479419690000,PI,IP,001,3,10575,10808,6024,233,PERF
42479419690000,PI,IP,001,4,10887,11120,6024,233,PERF
42479419690000,PI,IP,001,5,11194,11432,6024,238,PERF
42479419690000,PI,IP,001,6,11511,11740,6024,229,PERF
42479419690000,PI,IP,001,7,11823,12056,6024,233,PERF
42479419690000,PI,IP,001,8,12136,12368,6024,232,PERF
42479419690000,PI,IP,001,9,12447,12680,6024,233,PERF
42479419690000,PI,IP,001,10,12759,12992,6024,233,PERF
42479419690000,PI,IP,001,11,13071,13304,6024,233,PERF
42479419690000,PI,IP,001,12,13383,13616,6024,233,PERF
42479419690000,PI,IP,001,13,13697,13928,6024,231,PERF
42479419690000,PI,IP,001,14,14006,14158,6024,152,PERF
42479419700000,PI,PT,001,1,,,,,PERF
42479419710000,PI,IP,001,1,9349,14303,6179,4954,PERF
42479419720000,PI,IP,001,1,9027,9296,6050,269,PERF
42479419720000,PI,IP,001,2,9384,9653,6050,269,PERF
42479419720000,PI,IP,001,3,9741,10010,6050,269,PERF
42479419720000,PI,IP,001,4,10098,10365,6050,267,PERF
42479419720000,PI,IP,001,5,10455,10724,6050,269,PERF
42479419720000,PI,IP,001,6,10812,11082,6050,270,PERF
42479419720000,PI,IP,001,7,11170,11438,6050,268,PERF
42479419720000,PI,IP,001,8,11526,11796,6050,270,PERF
42479419720000,PI,IP,001,9,11884,12150,6050,266,PERF
42479419720000,PI,IP,001,10,12236,12509,6050,273,PERF
42479419720000,PI,IP,001,11,12599,12866,6050,267,PERF
42479419720000,PI,IP,001,12,12956,13223,6050,267,PERF
42479419720000,PI,IP,001,13,13311,13580,6050,269,PERF
42479419720000,PI,IP,001,14,13668,13937,6050,269,PERF
42479419720000,PI,IP,001,15,14025,14205,6050,180,PERF
42479419730000,PI,IP,001,1,9026,9298,6037,272,PERF
42479419730000,PI,IP,001,2,9389,9658,6037,269,PERF
42479419730000,PI,IP,001,3,9746,10018,6037,272,PERF
42479419730000,PI,IP,001,4,10106,10378,6037,272,PERF
42479419730000,PI,IP,001,5,10466,10738,6037,272,PERF
42479419730000,PI,IP,001,6,10828,11098,6037,270,PERF
42479419730000,PI,IP,001,7,11186,11458,6037,272,PERF
42479419730000,PI,IP,001,8,11546,11818,6037,272,PERF
42479419730000,PI,IP,001,9,11908,12180,6037,272,PERF
42479419730000,PI,IP,001,10,12270,12534,6037,264,PERF
42479419730000,PI,IP,001,11,12634,12898,6037,264,PERF
42479419730000,PI,IP,001,12,12988,13258,6037,270,PERF
42479419730000,PI,IP,001,13,13346,13618,6037,272,PERF
42479419730000,PI,IP,001,14,13706,13978,6037,272,PERF
42479419730000,PI,IP,001,15,14066,14246,6037,180,PERF
42479419960000,PI,IP,001,1,8478,12851,5348,4373,PERF
42479420040000,PI,IP,001,1,8569,12961,5196,4392,PERF
42479420070000,PI,IP,001,1,8203,12383,5401,4180,PERF
42479420140000,PI,IP,001,1,9586,9587,6211,1,PERF
42479420140000,PI,IP,001,2,9661,9662,6211,1,PERF
42479420140000,PI,IP,001,3,9736,9737,6211,1,PERF
42479420140000,PI,IP,001,4,9811,9812,6211,1,PERF
42479420140000,PI,IP,001,5,9887,9888,6211,1,PERF
42479420140000,PI,IP,001,6,9962,9963,6211,1,PERF
42479420140000,PI,IP,001,7,10037,10038,6211,1,PERF
42479420140000,PI,IP,001,8,10112,10113,6211,1,PERF
42479420140000,PI,IP,001,9,10187,10188,6211,1,PERF
42479420140000,PI,IP,001,10,10262,10263,6211,1,PERF
42479420140000,PI,IP,001,11,10337,10338,6211,1,PERF
42479420140000,PI,IP,001,12,10412,10413,6211,1,PERF
42479420140000,PI,IP,001,13,10488,10489,6211,1,PERF
42479420140000,PI,IP,001,14,10556,10557,6211,1,PERF
42479420140000,PI,IP,001,15,10638,10639,6211,1,PERF
42479420140000,PI,IP,001,16,10713,10714,6211,1,PERF
42479420140000,PI,IP,001,17,10788,10789,6211,1,PERF
42479420140000,PI,IP,001,18,10863,10864,6211,1,PERF
42479420140000,PI,IP,001,19,10938,10939,6211,1,PERF
42479420140000,PI,IP,001,20,11013,11014,6211,1,PERF
42479420140000,PI,IP,001,21,11089,11090,6211,1,PERF
42479420140000,PI,IP,001,22,11164,11165,6211,1,PERF
42479420140000,PI,IP,001,23,11239,11240,6211,1,PERF
42479420140000,PI,IP,001,24,11314,11315,6211,1,PERF
42479420140000,PI,IP,001,25,11389,11390,6211,1,PERF
42479420140000,PI,IP,001,26,11464,11465,6211,1,PERF
42479420140000,PI,IP,001,27,11539,11540,6211,1,PERF
42479420140000,PI,IP,001,28,11614,11615,6211,1,PERF
42479420140000,PI,IP,001,29,11690,11691,6211,1,PERF
42479420140000,PI,IP,001,30,11755,11756,6211,1,PERF
42479420140000,PI,IP,001,31,11840,11841,6211,1,PERF
42479420140000,PI,IP,001,32,11910,11911,6211,1,PERF
42479420140000,PI,IP,001,33,11990,11991,6211,1,PERF
42479420140000,PI,IP,001,34,12065,12066,6211,1,PERF
42479420140000,PI,IP,001,35,12140,12141,6211,1,PERF
42479420140000,PI,IP,001,36,12215,12216,6211,1,PERF
42479420140000,PI,IP,001,37,12291,12292,6211,1,PERF
42479420140000,PI,IP,001,38,12366,12367,6211,1,PERF
42479420140000,PI,IP,001,39,12441,12442,6211,1,PERF
42479420140000,PI,IP,001,40,12516,12517,6211,1,PERF
42479420140000,PI,IP,001,41,12591,12592,6211,1,PERF
42479420140000,PI,IP,001,42,12666,12667,6211,1,PERF
42479420140000,PI,IP,001,43,12741,12742,6211,1,PERF
42479420140000,PI,IP,001,44,12790,12791,6211,1,PERF
42479420140000,PI,IP,001,45,12892,12893,6211,1,PERF
42479420140000,PI,IP,001,46,12967,12968,6211,1,PERF
42479420140000,PI,IP,001,47,13042,13043,6211,1,PERF
42479420140000,PI,IP,001,48,13117,13118,6211,1,PERF
42479420140000,PI,IP,001,49,13192,13193,6211,1,PERF
42479420140000,PI,IP,001,50,13267,13268,6211,1,PERF
42479420140000,PI,IP,001,51,13342,13343,6211,1,PERF
42479420140000,PI,IP,001,52,13417,13418,6211,1,PERF
42479420140000,PI,IP,001,53,13493,13494,6211,1,PERF
42479420140000,PI,IP,001,54,13568,13569,6211,1,PERF
42479420140000,PI,IP,001,55,13643,13644,6211,1,PERF
42479420140000,PI,IP,001,56,13718,13719,6211,1,PERF
42479420140000,PI,IP,001,57,13793,13794,6211,1,PERF
42479420140000,PI,IP,001,58,13861,13862,6211,1,PERF
42479420140000,PI,IP,001,59,13940,13941,6211,1,PERF
42479420140000,PI,IP,001,60,14018,14082,6211,64,PERF
42479420140000,PI,IP,001,61,14094,14095,6211,1,PERF
42479420140000,PI,IP,001,62,14169,14170,6211,1,PERF
42479420140000,PI,IP,001,63,14244,14245,6211,1,PERF
42479420140000,PI,IP,001,64,14319,14320,6211,1,PERF
42479420150000,PI,IP,001,1,9021,9284,6037,263,PERF
42479420150000,PI,IP,001,2,9375,9638,6037,263,PERF
42479420150000,PI,IP,001,3,9729,9994,6037,265,PERF
42479420150000,PI,IP,001,4,10083,10346,6037,263,PERF
42479420150000,PI,IP,001,5,10432,10700,6037,268,PERF
42479420150000,PI,IP,001,6,10791,11054,6037,263,PERF
42479420150000,PI,IP,001,7,11145,11408,6037,263,PERF
42479420150000,PI,IP,001,8,11499,11762,6037,263,PERF
42479420150000,PI,IP,001,9,11853,12116,6037,263,PERF
42479420150000,PI,IP,001,10,12204,12470,6037,266,PERF
42479420150000,PI,IP,001,11,12561,12824,6037,263,PERF
42479420150000,PI,IP,001,12,12915,13178,6037,263,PERF
42479420150000,PI,IP,001,13,13310,13516,6037,206,PERF
42479420150000,PI,IP,001,14,13623,13886,6037,263,PERF
42479420150000,PI,IP,001,15,13976,14203,6037,227,PERF
42479420170000,PI,IP,001,1,9009,9275,6037,266,PERF
42479420170000,PI,IP,001,2,9366,9632,6037,266,PERF
42479420170000,PI,IP,001,3,9723,9989,6037,266,PERF
42479420170000,PI,IP,001,4,10080,10348,6037,268,PERF
42479420170000,PI,IP,001,5,10437,10698,6037,261,PERF
42479420170000,PI,IP,001,6,10788,11058,6037,270,PERF
42479420170000,PI,IP,001,7,11151,11417,6037,266,PERF
42479420170000,PI,IP,001,8,11508,11774,6037,266,PERF
42479420170000,PI,IP,001,9,11865,12131,6037,266,PERF
42479420170000,PI,IP,001,10,12222,12488,6037,266,PERF
42479420170000,PI,IP,001,11,12579,12845,6037,266,PERF
42479420170000,PI,IP,001,12,12936,13208,6037,272,PERF
42479420170000,PI,IP,001,13,13298,13559,6037,261,PERF
42479420170000,PI,IP,001,14,13650,13916,6037,266,PERF
42479420170000,PI,IP,001,15,14006,14231,6037,225,PERF
42479420200000,PI,IP,001,1,8925,9191,6031,266,PERF
42479420200000,PI,IP,001,2,9283,9549,6031,266,PERF
42479420200000,PI,IP,001,3,9641,9907,6031,266,PERF
42479420200000,PI,IP,001,4,10087,10265,6031,178,PERF
42479420200000,PI,IP,001,5,10354,10623,6031,269,PERF
42479420200000,PI,IP,001,6,10714,10981,6031,267,PERF
42479420200000,PI,IP,001,7,11073,11339,6031,266,PERF
42479420200000,PI,IP,001,8,11431,11697,6031,266,PERF
42479420200000,PI,IP,001,9,11789,12055,6031,266,PERF
42479420200000,PI,IP,001,10,12147,12411,6031,264,PERF
42479420200000,PI,IP,001,11,12505,12772,6031,267,PERF
42479420200000,PI,IP,001,12,12863,13127,6031,264,PERF
42479420200000,PI,IP,001,13,13226,13487,6031,261,PERF
42479420200000,PI,IP,001,14,13579,13845,6031,266,PERF
42479420200000,PI,IP,001,15,13937,14164,6031,227,PERF
42479420230000,PI,IP,001,1,9076,9342,6040,266,PERF
42479420230000,PI,IP,001,2,9427,9693,6040,266,PERF
42479420230000,PI,IP,001,3,9778,10044,6040,266,PERF
42479420230000,PI,IP,001,4,10129,10400,6040,271,PERF
42479420230000,PI,IP,001,5,10478,10746,6040,268,PERF
42479420230000,PI,IP,001,6,10831,11097,6040,266,PERF
42479420230000,PI,IP,001,7,11182,11448,6040,266,PERF
42479420230000,PI,IP,001,8,11533,11796,6040,263,PERF
42479420230000,PI,IP,001,9,11884,12062,6040,178,PERF
42479420230000,PI,IP,001,10,12237,12501,6040,264,PERF
42479420230000,PI,IP,001,11,12586,12852,6040,266,PERF
42479420230000,PI,IP,001,12,12940,13202,6040,262,PERF
42479420230000,PI,IP,001,13,13288,13554,6040,266,PERF
42479420230000,PI,IP,001,14,13639,13905,6040,266,PERF
42479420230000,PI,IP,001,15,13989,14231,6040,242,PERF
42479420240000,PI,PT,001,1,,,,,PERF
42479420260000,PI,IP,001,1,9098,9357,6312,259,PERF
42479420260000,PI,IP,001,2,9438,9706,6312,268,PERF
42479420260000,PI,IP,001,3,9792,10055,6312,263,PERF
42479420260000,PI,IP,001,4,10141,10404,6312,263,PERF
42479420260000,PI,IP,001,5,10490,10666,6312,176,PERF
42479420260000,PI,IP,001,6,10841,11102,6312,261,PERF
42479420260000,PI,IP,001,7,11188,11451,6312,263,PERF
42479420260000,PI,IP,001,8,11537,11800,6312,263,PERF
42479420260000,PI,IP,001,9,11886,12146,6312,260,PERF
42479420260000,PI,IP,001,10,12235,12498,6312,263,PERF
42479420260000,PI,IP,001,11,12584,12847,6312,263,PERF
42479420260000,PI,IP,001,12,12933,13202,6312,269,PERF
42479420260000,PI,IP,001,13,13280,13545,6312,265,PERF
42479420260000,PI,IP,001,14,13631,13894,6312,263,PERF
42479420260000,PI,IP,001,15,13980,14222,6312,242,PERF
42493325460000,PI,IP,001,1,9818,9821,4811,3,PERF
42493325460000,PI,IP,001,2,9934,9937,4811,3,PERF
42493325460000,PI,IP,001,3,10020,10023,4811,3,PERF
42493325460000,PI,IP,001,4,10130,10133,4811,3,PERF
42493325460000,PI,IP,001,5,10210,10213,4811,3,PERF
42493325460000,PI,IP,001,6,10310,10316,4811,6,PERF
42493325460000,PI,IP,001,7,10450,10453,4811,3,PERF
42493325460000,PI,IP,001,8,10540,10543,4811,3,PERF
42493325460000,PI,IP,001,9,10634,10637,4811,3,PERF
42493325460000,PI,IP,001,10,10736,10739,4811,3,PERF
42493325460000,PI,IP,001,11,10834,10837,4811,3,PERF
42493325460000,PI,IP,001,12,10950,10956,4811,6,PERF
42493325460000,PI,IP,001,13,11024,11027,4811,3,PERF
42493325460000,PI,IP,001,14,11144,11147,4811,3,PERF
42493325460000,PI,IP,001,15,11246,11249,4811,3,PERF
42493325460000,PI,IP,001,16,11347,11350,4811,3,PERF
42493325460000,PI,IP,001,17,11446,11449,4811,3,PERF
42493325460000,PI,IP,001,18,11556,11562,4811,6,PERF
42493325460000,PI,IP,001,19,11654,11657,4811,3,PERF
42493325460000,PI,IP,001,20,11756,11759,4811,3,PERF
42493325460000,PI,IP,001,21,11858,11861,4811,3,PERF
42493325460000,PI,IP,001,22,11950,11953,4811,3,PERF
42493325460000,PI,IP,001,23,12067,12070,4811,3,PERF
42493325460000,PI,IP,001,24,12175,12181,4811,6,PERF
42493325460000,PI,IP,001,25,12266,12269,4811,3,PERF
42493325460000,PI,IP,001,26,12368,12371,4811,3,PERF
42493325460000,PI,IP,001,27,12467,12470,4811,3,PERF
42493325460000,PI,IP,001,28,12578,12581,4811,3,PERF
42493325460000,PI,IP,001,29,12674,12677,4811,3,PERF
42493325460000,PI,IP,001,30,12776,12782,4811,6,PERF
42493325460000,PI,IP,001,31,12878,12881,4811,3,PERF
42493325460000,PI,IP,001,32,12970,12973,4811,3,PERF
42493325460000,PI,IP,001,33,13090,13093,4811,3,PERF
42493325460000,PI,IP,001,34,13184,13184,4811,0,PERF
42493325460000,PI,IP,001,35,13286,13289,4811,3,PERF
42493325460000,PI,IP,001,36,13388,13394,4811,6,PERF
42493325460000,PI,IP,001,37,13490,13493,4811,3,PERF
42493325460000,PI,IP,001,38,13592,13598,4811,6,PERF
42493325460000,PI,IP,001,39,13715,13721,4811,6,PERF
42493325460000,PI,IP,001,40,13815,13818,4811,3,PERF
42493325460000,PI,IP,001,41,13915,13918,4811,3,PERF
42493325460000,PI,IP,001,42,14015,14021,4811,6,PERF
42493325470000,PI,IP,001,1,9745,9748,4448,3,PERF
42493325470000,PI,IP,001,2,9860,9863,4448,3,PERF
42493325470000,PI,IP,001,3,9980,9986,4448,6,PERF
42493325470000,PI,IP,001,4,10100,10103,4448,3,PERF
42493325470000,PI,IP,001,5,10188,10191,4448,3,PERF
42493325470000,PI,IP,001,6,10288,10294,4448,6,PERF
42493325470000,PI,IP,001,7,10388,10391,4448,3,PERF
42493325470000,PI,IP,001,8,10488,10491,4448,3,PERF
42493325470000,PI,IP,001,9,10574,10580,4448,6,PERF
42493325470000,PI,IP,001,10,10650,10653,4448,3,PERF
42493325470000,PI,IP,001,11,10715,10718,4448,3,PERF
42493325470000,PI,IP,001,12,10806,10812,4448,6,PERF
42493325470000,PI,IP,001,13,10960,10963,4448,3,PERF
42493325470000,PI,IP,001,14,11070,11073,4448,3,PERF
42493325470000,PI,IP,001,15,11218,11224,4448,6,PERF
42493325470000,PI,IP,001,16,11334,11337,4448,3,PERF
42493325470000,PI,IP,001,17,11420,11423,4448,3,PERF
42493325470000,PI,IP,001,18,11500,11506,4448,6,PERF
42493325470000,PI,IP,001,19,11620,11623,4448,3,PERF
42493325470000,PI,IP,001,20,11688,11691,4448,3,PERF
42493325470000,PI,IP,001,21,11762,11768,4448,6,PERF
42493325470000,PI,IP,001,22,11888,11891,4448,3,PERF
42493325470000,PI,IP,001,23,12000,12003,4448,3,PERF
42493325470000,PI,IP,001,24,12080,12086,4448,6,PERF
42493325470000,PI,IP,001,25,12188,12191,4448,3,PERF
42493325470000,PI,IP,001,26,12304,12307,4448,3,PERF
42493325470000,PI,IP,001,27,12388,12394,4448,6,PERF
42493325470000,PI,IP,001,28,12480,12483,4448,3,PERF
42493325470000,PI,IP,001,29,12588,12591,4448,3,PERF
42493325470000,PI,IP,001,30,12660,12663,4448,3,PERF
42493325470000,PI,IP,001,31,12815,12818,4448,3,PERF
42493325470000,PI,IP,001,32,12888,12891,4448,3,PERF
42493325470000,PI,IP,001,33,12940,12946,4448,6,PERF
42493325470000,PI,IP,001,34,13088,13091,4448,3,PERF
42493325470000,PI,IP,001,35,13188,13191,4448,3,PERF
42493325470000,PI,IP,001,36,13304,13307,4448,3,PERF
42493325470000,PI,IP,001,37,13388,13391,4448,3,PERF
42493325470000,PI,IP,001,38,13488,13491,4448,3,PERF
42493325470000,PI,IP,001,39,13588,13594,4448,6,PERF
42493325500000,PI,IP,001,1,8690,8900,5837,210,PERF
42493325500000,PI,IP,001,2,9507,9728,5837,221,PERF
42493325500000,PI,IP,001,3,10226,10458,5837,232,PERF
42493325500000,PI,IP,001,4,10530,10754,5837,224,PERF
42493325500000,PI,IP,001,5,10816,10988,5837,172,PERF
42493325500000,PI,IP,001,6,11048,11268,5837,220,PERF
42493325500000,PI,IP,001,7,11382,11580,5837,198,PERF
42493325500000,PI,IP,001,8,11756,11948,5837,192,PERF
42493325500000,PI,IP,001,9,12074,12270,5837,196,PERF
42493325500000,PI,IP,001,10,12388,12598,5837,210,PERF
42493325500000,PI,IP,001,11,12646,12794,5837,148,PERF
42493325500000,PI,IP,001,12,12860,13036,5837,176,PERF
42493325500000,PI,IP,001,13,13242,13440,5837,198,PERF
42493325520000,PI,IP,001,1,8598,12551,4962,3953,PERF
42493325560000,PI,IP,001,1,8700,8702,4466,2,PERF
42493325560000,PI,IP,001,2,8730,8732,4466,2,PERF
42493325560000,PI,IP,001,3,8780,8782,4466,2,PERF
42493325560000,PI,IP,001,4,8830,8832,4466,2,PERF
42493325560000,PI,IP,001,5,8895,8897,4466,2,PERF
42493325560000,PI,IP,001,6,9015,9017,4466,2,PERF
42493325560000,PI,IP,001,7,9060,9062,4466,2,PERF
42493325560000,PI,IP,001,8,9140,9142,4466,2,PERF
42493325560000,PI,IP,001,9,9200,9202,4466,2,PERF
42493325560000,PI,IP,001,10,9250,9252,4466,2,PERF
42493325560000,PI,IP,001,11,9300,9302,4466,2,PERF
42493325560000,PI,IP,001,12,9375,9377,4466,2,PERF
42493325560000,PI,IP,001,13,9435,9437,4466,2,PERF
42493325560000,PI,IP,001,14,9485,9487,4466,2,PERF
42493325560000,PI,IP,001,15,9550,9552,4466,2,PERF
42493325560000,PI,IP,001,16,9670,9672,4466,2,PERF
42493325560000,PI,IP,001,17,9730,9732,4466,2,PERF
42493325560000,PI,IP,001,18,9775,9777,4466,2,PERF
42493325560000,PI,IP,001,19,9820,9822,4466,2,PERF
42493325560000,PI,IP,001,20,9890,9892,4466,2,PERF
42493325560000,PI,IP,001,21,9980,9982,4466,2,PERF
42493325560000,PI,IP,001,22,10030,10032,4466,2,PERF
42493325560000,PI,IP,001,23,10090,10092,4466,2,PERF
42493325560000,PI,IP,001,24,10710,10712,4466,2,PERF
42493325560000,PI,IP,001,25,10760,10762,4466,2,PERF
42493325560000,PI,IP,001,26,10820,10822,4466,2,PERF
42493325560000,PI,IP,001,27,10960,10962,4466,2,PERF
42493325560000,PI,IP,001,28,11145,11147,4466,2,PERF
42493325560000,PI,IP,001,29,11230,11232,4466,2,PERF
42493325560000,PI,IP,001,30,11290,11292,4466,2,PERF
42493325560000,PI,IP,001,31,11350,11352,4466,2,PERF
42493325560000,PI,IP,001,32,11488,11490,4466,2,PERF
42493325560000,PI,IP,001,33,11530,11532,4466,2,PERF
42493325560000,PI,IP,001,34,11575,11577,4466,2,PERF
42493325560000,PI,IP,001,35,11618,11620,4466,2,PERF
42493325560000,PI,IP,001,36,11718,11720,4466,2,PERF
42493325560000,PI,IP,001,37,11778,11780,4466,2,PERF
42493325560000,PI,IP,001,38,11838,11840,4466,2,PERF
42493325560000,PI,IP,001,39,11915,11917,4466,2,PERF
42493325600000,PI,IP,001,1,10199,13981,4952,3782,PERF
42493325610000,PI,IP,001,1,9884,13894,4512,4010,PERF
42493325630000,PI,IP,001,1,6479,9867,3962,3388,PERF
42493325640000,PI,IP,001,1,9618,16484,7419,6866,PERF
42493325650000,PI,IP,001,1,8532,8804,6904,272,PERF
42493325650000,PI,IP,001,2,8880,9030,6904,150,PERF
42493325650000,PI,IP,001,3,9110,9294,6904,184,PERF
42493325650000,PI,IP,001,4,9400,9582,6904,182,PERF
42493325650000,PI,IP,001,5,9696,9912,6904,216,PERF
42493325650000,PI,IP,001,6,9970,10186,6904,216,PERF
42493325650000,PI,IP,001,7,10270,10446,6904,176,PERF
42493325650000,PI,IP,001,8,10508,10702,6904,194,PERF
42493325650000,PI,IP,001,9,10784,11018,6904,234,PERF
42493325650000,PI,IP,001,10,11116,11286,6904,170,PERF
42493325650000,PI,IP,001,11,12042,12306,6904,264,PERF
42493325650000,PI,IP,001,12,12398,12584,6904,186,PERF
42493325650000,PI,IP,001,13,12678,12894,6904,216,PERF
42493325690000,PI,IP,001,1,10104,15668,6516,5564,PERF
42493325710000,PI,IP,001,1,9910,15720,6556,5810,PERF
42493325720100,PI,IP,001,1,7650,8723,4440,1073,PERF
42493325720100,PI,IP,001,2,9008,9927,4440,919,PERF
42493325720100,PI,IP,001,3,9977,10447,4440,470,PERF
42493325720100,PI,IP,001,4,10561,10621,4440,60,PERF
42493325720100,PI,IP,001,5,10958,11023,4440,65,PERF
42493325730000,PI,IP,001,1,10051,14878,5798,4827,PERF
42493325740000,PI,IP,001,1,8650,10851,3159,2201,PERF
42493325770000,PI,IP,001,1,10014,17319,8175,7305,PERF
42493325780000,PI,IP,001,1,9278,9518,6480,240,PERF
42493325780000,PI,IP,001,2,9626,9900,6480,274,PERF
42493325780000,PI,IP,001,3,9954,10114,6480,160,PERF
42493325780000,PI,IP,001,4,10172,10362,6480,190,PERF
42493325780000,PI,IP,001,5,10476,10560,6480,84,PERF
42493325780000,PI,IP,001,6,10696,10872,6480,176,PERF
42493325780000,PI,IP,001,7,10974,11172,6480,198,PERF
42493325780000,PI,IP,001,8,11252,11408,6480,156,PERF
42493325780000,PI,IP,001,9,11478,11662,6480,184,PERF
42493325780000,PI,IP,001,10,11740,11906,6480,166,PERF
42493325780000,PI,IP,001,11,12046,12230,6480,184,PERF
42493325780000,PI,IP,001,12,12338,12508,6480,170,PERF
42493325780000,PI,IP,001,13,12606,12754,6480,148,PERF
42493325780000,PI,IP,001,14,12824,13036,6480,212,PERF
42493325780000,PI,IP,001,15,13206,13404,6480,198,PERF
42493325780000,PI,IP,001,16,13542,13690,6480,148,PERF
42493325780000,PI,IP,001,17,13778,13986,6480,208,PERF
42493325780000,PI,IP,001,18,14056,14232,6480,176,PERF
42493325780000,PI,IP,001,19,14338,14534,6480,196,PERF
42493325790000,PI,IP,001,1,10001,15828,6524,5827,PERF
42493325800000,PI,IP,001,1,9900,15376,6056,5476,PERF
42493325810000,PI,IP,001,1,9985,15986,6627,6001,PERF
42493325820000,PI,IP,001,1,10267,14059,5531,3792,PERF
42493325830000,PI,IP,001,1,9953,14252,4958,4299,PERF
42493325860000,PI,IP,001,1,9232,9562,6592,330,PERF
42493325860000,PI,IP,001,2,9649,9914,6592,265,PERF
42493325860000,PI,IP,001,3,9986,10210,6592,224,PERF
42493325860000,PI,IP,001,4,10276,10516,6592,240,PERF
42493325860000,PI,IP,001,5,10588,10810,6592,222,PERF
42493325860000,PI,IP,001,6,10914,11112,6592,198,PERF
42493325860000,PI,IP,001,7,11190,11410,6592,220,PERF
42493325860000,PI,IP,001,8,11472,11760,6592,288,PERF
42493325860000,PI,IP,001,9,11842,12058,6592,216,PERF
42493325860000,PI,IP,001,10,12144,12434,6592,290,PERF
42493325860000,PI,IP,001,11,12564,12754,6592,190,PERF
42493325860000,PI,IP,001,12,12842,13092,6592,250,PERF
42493325860000,PI,IP,001,13,13172,13412,6592,240,PERF
42493325860000,PI,IP,001,14,13494,13750,6592,256,PERF
42493325860000,PI,IP,001,15,13822,14022,6592,200,PERF
42493325860000,PI,IP,001,16,14112,14342,6592,230,PERF
42493325860000,PI,IP,001,17,14466,14722,6592,256,PERF
42493325860000,PI,IP,001,18,14784,14992,6592,208,PERF
42493325880000,PI,PT,001,1,7531,8290,,759,PERF
42493325910000,PI,IP,001,1,9992,10206,5541,214,PERF
42493325910000,PI,IP,001,2,10282,10518,5541,236,PERF
42493325910000,PI,IP,001,3,10598,10806,5541,208,PERF
42493325910000,PI,IP,001,4,10892,11120,5541,228,PERF
42493325910000,PI,IP,001,5,11220,11512,5541,292,PERF
42493325910000,PI,IP,001,6,11640,11908,5541,268,PERF
42493325910000,PI,IP,001,7,12014,12204,5541,190,PERF
42493325910000,PI,IP,001,8,12292,12552,5541,260,PERF
42493325910000,PI,IP,001,9,12636,12876,5541,240,PERF
42493325910000,PI,IP,001,10,12966,13180,5541,214,PERF
42493325910000,PI,IP,001,11,13256,13468,5541,212,PERF
42493325910000,PI,IP,001,12,13540,13740,5541,200,PERF
42493325910000,PI,IP,001,13,13806,13952,5541,146,PERF
42493325940000,PI,IP,001,1,8357,12692,5069,4335,PERF
42493325950000,PI,IP,001,1,8496,8888,5609,392,PERF
42493325950000,PI,IP,001,2,9042,9284,5609,242,PERF
42493325950000,PI,IP,001,3,9360,9592,5609,232,PERF
42493325950000,PI,IP,001,4,9658,9880,5609,222,PERF
42493325950000,PI,IP,001,5,9960,10192,5609,232,PERF
42493325950000,PI,IP,001,6,10266,10512,5609,246,PERF
42493325950000,PI,IP,001,7,10588,10862,5609,274,PERF
42493325950000,PI,IP,001,8,10932,11152,5609,220,PERF
42493325950000,PI,IP,001,9,11222,11422,5609,200,PERF
42493325950000,PI,IP,001,10,11488,11730,5609,242,PERF
42493325950000,PI,IP,001,11,11800,12002,5609,202,PERF
42493325950000,PI,IP,001,12,12070,12286,5609,216,PERF
42493325950000,PI,IP,001,13,12358,12560,5609,202,PERF
42493325950000,PI,IP,001,14,12650,12860,5609,210,PERF
42493325950000,PI,IP,001,15,12966,13120,5609,154,PERF
42493325950000,PI,IP,001,16,13256,13476,5609,220,PERF
42493325970000,PI,IP,001,1,9850,15757,6521,5907,PERF
42493325980000,PI,IP,001,1,8694,16049,8060,7355,PERF
42493325990000,PI,IP,001,1,8282,8542,6219,260,PERF
42493325990000,PI,IP,001,2,8618,8856,6219,238,PERF
42493325990000,PI,IP,001,3,8934,9150,6219,216,PERF
42493325990000,PI,IP,001,4,9214,9462,6219,248,PERF
42493325990000,PI,IP,001,5,9528,9750,6219,222,PERF
42493325990000,PI,IP,001,6,9812,10070,6219,258,PERF
42493325990000,PI,IP,001,7,10130,10352,6219,222,PERF
42493325990000,PI,IP,001,8,10410,10632,6219,222,PERF
42493325990000,PI,IP,001,9,10698,10898,6219,200,PERF
42493325990000,PI,IP,001,10,10978,11186,6219,208,PERF
42493325990000,PI,IP,001,11,11248,11460,6219,212,PERF
42493325990000,PI,IP,001,12,11524,11750,6219,226,PERF
42493325990000,PI,IP,001,13,11814,12042,6219,228,PERF
42493325990000,PI,IP,001,14,12128,12350,6219,222,PERF
42493325990000,PI,IP,001,15,12410,12616,6219,206,PERF
42493325990000,PI,IP,001,16,12684,12914,6219,230,PERF
42493325990000,PI,IP,001,17,12968,13122,6219,154,PERF
42493325990000,PI,IP,001,18,13228,13440,6219,212,PERF
42493325990000,PI,IP,001,19,13496,13700,6219,204,PERF
42493326000000,PI,IP,001,1,9054,9293,6656,239,PERF
42493326000000,PI,IP,001,2,9374,9611,6656,237,PERF
42493326000000,PI,IP,001,3,9694,9925,6656,231,PERF
42493326000000,PI,IP,001,4,10014,10257,6656,243,PERF
42493326000000,PI,IP,001,5,10334,10577,6656,243,PERF
42493326000000,PI,IP,001,6,10648,10897,6656,249,PERF
42493326000000,PI,IP,001,7,10980,11217,6656,237,PERF
42493326000000,PI,IP,001,8,11296,11537,6656,241,PERF
42493326000000,PI,IP,001,9,11617,11857,6656,240,PERF
42493326000000,PI,IP,001,10,11940,12177,6656,237,PERF
42493326000000,PI,IP,001,11,12254,12402,6656,148,PERF
42493326000000,PI,IP,001,12,12574,12817,6656,243,PERF
42493326000000,PI,IP,001,13,12894,13137,6656,243,PERF
42493326000000,PI,IP,001,14,13214,13457,6656,243,PERF
42493326000000,PI,IP,001,15,13534,13777,6656,243,PERF
42493326000000,PI,IP,001,16,13854,14097,6656,243,PERF
42493326000000,PI,IP,001,17,14174,14387,6656,213,PERF
42493326010000,PI,IP,001,1,7021,7023,5922,2,PERF
42493326010000,PI,IP,001,2,7359,7361,5922,2,PERF
42493326010000,PI,IP,001,3,7692,7694,5922,2,PERF
42493326010000,PI,IP,001,4,8022,8024,5922,2,PERF
42493326010000,PI,IP,001,5,8362,8364,5922,2,PERF
42493326010000,PI,IP,001,6,8697,8700,5922,3,PERF
42493326010000,PI,IP,001,7,9031,9034,5922,3,PERF
42493326010000,PI,IP,001,8,9367,9370,5922,3,PERF
42493326010000,PI,IP,001,9,9707,9709,5922,2,PERF
42493326010000,PI,IP,001,10,10040,10043,5922,3,PERF
42493326010000,PI,IP,001,11,10380,10382,5922,2,PERF
42493326010000,PI,IP,001,12,10714,10717,5922,3,PERF
42493326010000,PI,IP,001,13,11054,11057,5922,3,PERF
42493326010000,PI,IP,001,14,11383,11385,5922,2,PERF
42493326010000,PI,IP,001,15,11707,11709,5922,2,PERF
42493326010000,PI,IP,001,16,12031,12034,5922,3,PERF
42493326020000,PI,IP,001,1,7607,7609,6291,2,PERF
42493326020000,PI,IP,001,2,7980,7983,6291,3,PERF
42493326020000,PI,IP,001,3,8353,8356,6291,3,PERF
42493326020000,PI,IP,001,4,8593,8595,6291,2,PERF
42493326020000,PI,IP,001,5,8831,8834,6291,3,PERF
42493326020000,PI,IP,001,6,9161,9164,6291,3,PERF
42493326020000,PI,IP,001,7,9445,9448,6291,3,PERF
42493326020000,PI,IP,001,8,9729,9731,6291,2,PERF
42493326020000,PI,IP,001,9,10057,10060,6291,3,PERF
42493326020000,PI,IP,001,10,10341,10344,6291,3,PERF
42493326020000,PI,IP,001,11,10627,10629,6291,2,PERF
42493326020000,PI,IP,001,12,10954,10957,6291,3,PERF
42493326020000,PI,IP,001,13,11282,11284,6291,2,PERF
42493326020000,PI,IP,001,14,11474,11477,6291,3,PERF
42493326020000,PI,IP,001,15,11804,11806,6291,2,PERF
42493326020000,PI,IP,001,16,12133,12135,6291,2,PERF
42493326020000,PI,IP,001,17,12508,12511,6291,3,PERF
42493326030000,PI,IP,001,1,9100,9342,6241,242,PERF
42493326030000,PI,IP,001,2,9410,9652,6241,242,PERF
42493326030000,PI,IP,001,3,9720,9962,6241,242,PERF
42493326030000,PI,IP,001,4,10030,10272,6241,242,PERF
42493326030000,PI,IP,001,5,10340,10582,6241,242,PERF
42493326030000,PI,IP,001,6,10650,10892,6241,242,PERF
42493326030000,PI,IP,001,7,10960,11202,6241,242,PERF
42493326030000,PI,IP,001,8,11270,11512,6241,242,PERF
42493326030000,PI,IP,001,9,11580,11822,6241,242,PERF
42493326030000,PI,IP,001,10,11890,12132,6241,242,PERF
42493326030000,PI,IP,001,11,12200,12442,6241,242,PERF
42493326030000,PI,IP,001,12,12510,12752,6241,242,PERF
42493326030000,PI,IP,001,13,12820,13062,6241,242,PERF
42493326030000,PI,IP,001,14,13130,13372,6241,242,PERF
42493326070000,PI,IP,001,1,8700,8942,6684,242,PERF
42493326070000,PI,IP,001,2,9010,9252,6684,242,PERF
42493326070000,PI,IP,001,3,9320,9562,6684,242,PERF
42493326070000,PI,IP,001,4,9628,9872,6684,244,PERF
42493326070000,PI,IP,001,5,9940,10182,6684,242,PERF
42493326070000,PI,IP,001,6,10250,10490,6684,240,PERF
42493326070000,PI,IP,001,7,10560,10802,6684,242,PERF
42493326070000,PI,IP,001,8,10870,11112,6684,242,PERF
42493326070000,PI,IP,001,9,11180,11422,6684,242,PERF
42493326070000,PI,IP,001,10,11490,11732,6684,242,PERF
42493326070000,PI,IP,001,11,11800,12042,6684,242,PERF
42493326070000,PI,IP,001,12,12110,12352,6684,242,PERF
42493326070000,PI,IP,001,13,12420,12662,6684,242,PERF
42493326070000,PI,IP,001,14,12730,12972,6684,242,PERF
42493326070000,PI,IP,001,15,13040,13282,6684,242,PERF
42493326070000,PI,IP,001,16,13350,13586,6684,236,PERF
42493326070000,PI,IP,001,17,13660,13902,6684,242,PERF
42493326070000,PI,IP,001,18,13970,14214,6684,244,PERF
42493326070000,PI,IP,001,19,14280,14522,6684,242,PERF
42493326080000,PI,IP,001,1,9850,16065,6685,6215,PERF
42493326100000,PI,IP,001,1,10000,14962,7073,4962,PERF
42493326140000,PI,IP,001,1,10042,16295,6999,6253,PERF
42493326160000,PI,IP,001,1,9185,9412,5753,227,PERF
42493326160000,PI,IP,001,2,9500,9730,5753,230,PERF
42493326160000,PI,IP,001,3,9815,10045,5753,230,PERF
42493326160000,PI,IP,001,4,10130,10360,5753,230,PERF
42493326160000,PI,IP,001,5,10502,10675,5753,173,PERF
42493326160000,PI,IP,001,6,10760,10990,5753,230,PERF
42493326160000,PI,IP,001,7,11075,11305,5753,230,PERF
42493326160000,PI,IP,001,8,11390,11620,5753,230,PERF
42493326160000,PI,IP,001,9,11705,11935,5753,230,PERF
42493326160000,PI,IP,001,10,12020,12250,5753,230,PERF
42493326160000,PI,IP,001,11,12335,12565,5753,230,PERF
42493326160000,PI,IP,001,12,12650,12880,5753,230,PERF
42493326160000,PI,IP,001,13,12965,13192,5753,227,PERF
42493326160000,PI,IP,001,14,13280,13510,5753,230,PERF
42493326160000,PI,IP,001,15,13595,13825,5753,230,PERF
42493326160000,PI,IP,001,16,13910,14140,5753,230,PERF
42493326160000,PI,IP,001,17,14227,14450,5753,223,PERF
42493326170000,PI,IP,001,1,9010,9252,6691,242,PERF
42493326170000,PI,IP,001,2,9320,9562,6691,242,PERF
42493326170000,PI,IP,001,3,9626,9872,6691,246,PERF
42493326170000,PI,IP,001,4,9940,10182,6691,242,PERF
42493326170000,PI,IP,001,5,10252,10492,6691,240,PERF
42493326170000,PI,IP,001,6,10558,10802,6691,244,PERF
42493326170000,PI,IP,001,7,10870,11112,6691,242,PERF
42493326170000,PI,IP,001,8,11180,11422,6691,242,PERF
42493326170000,PI,IP,001,9,11490,11732,6691,242,PERF
42493326170000,PI,IP,001,10,11800,12042,6691,242,PERF
42493326170000,PI,IP,001,11,12110,12123,6691,13,PERF
42493326170000,PI,IP,001,12,12420,12660,6691,240,PERF
42493326170000,PI,IP,001,13,12730,12970,6691,240,PERF
42493326170000,PI,IP,001,14,13040,13282,6691,242,PERF
42493326170000,PI,IP,001,15,13350,13592,6691,242,PERF
42493326170000,PI,IP,001,16,13660,13898,6691,238,PERF
42493326170000,PI,IP,001,17,13970,14212,6691,242,PERF
42493326170000,PI,IP,001,18,14280,14522,6691,242,PERF
42493326240000,PI,IP,001,1,9514,15610,6873,6096,PERF
42493326280000,PI,IP,001,1,9400,13192,4522,3792,PERF
42493326290000,PI,IP,001,1,8990,9216,5414,226,PERF
42493326290000,PI,IP,001,2,9284,9510,5414,226,PERF
42493326290000,PI,IP,001,3,9578,9804,5414,226,PERF
42493326290000,PI,IP,001,4,9872,10098,5414,226,PERF
42493326290000,PI,IP,001,5,10166,10392,5414,226,PERF
42493326290000,PI,IP,001,6,10460,10686,5414,226,PERF
42493326290000,PI,IP,001,7,10754,10980,5414,226,PERF
42493326290000,PI,IP,001,8,11048,11274,5414,226,PERF
42493326290000,PI,IP,001,9,11342,11568,5414,226,PERF
42493326290000,PI,IP,001,10,11636,11862,5414,226,PERF
42493326290000,PI,IP,001,11,11930,12156,5414,226,PERF
42493326290000,PI,IP,001,12,12224,12450,5414,226,PERF
42493326290000,PI,IP,001,13,12518,12744,5414,226,PERF
42493326290000,PI,IP,001,14,12812,13038,5414,226,PERF
42493326290000,PI,IP,001,15,13106,13332,5414,226,PERF
42493326290000,PI,IP,001,16,13400,13623,5414,223,PERF
42493326300000,PI,IP,001,1,9010,12922,4661,3912,PERF
42493326310000,PI,IP,001,1,8496,14568,6953,6072,PERF
42493326350000,PI,IP,001,1,8924,14862,6961,5938,PERF
42493326370000,PI,IP,001,1,8740,14848,6754,6108,PERF
42493326380000,PI,IP,001,1,8430,14709,6965,6279,PERF
42493326390000,PI,IP,001,1,9802,16152,7370,6350,PERF
42493326400000,PI,IP,001,1,9664,16202,7261,6538,PERF
42493326420000,PI,IP,001,1,8384,16794,9117,8410,PERF
42493326430000,PI,IP,001,1,8439,14234,6648,5795,PERF
42493326440000,PI,IP,001,1,8144,12610,5271,4466,PERF
42493326450000,PI,IP,001,1,9154,13360,5554,4206,PERF
42493326480000,PI,IP,001,1,9476,15769,7057,6293,PERF
42493326490000,PI,IP,001,1,9202,15075,6417,5873,PERF
42493326510000,PI,IP,001,1,6700,10816,5235,4116,PERF
42493326570000,PI,IP,001,1,8202,17616,10121,9414,PERF
42493326580000,PI,IP,001,1,8840,14173,5933,5333,PERF
42493326590000,PI,IP,001,1,8586,15616,7726,7030,PERF
42493326600000,PI,IP,001,1,9377,14289,5695,4912,PERF
42493326620000,PI,IP,001,1,8876,15263,7446,6387,PERF
42493326630000,PI,IP,001,1,8238,15972,8441,7734,PERF
42493326640000,PI,IP,001,1,8836,16805,8582,7969,PERF
42493326650000,PI,IP,001,1,8798,15743,7376,6945,PERF
42493326660000,PI,IP,001,1,8154,13672,6344,5518,PERF
42493326670000,PI,IP,001,1,9040,18710,10590,9670,PERF
42493326690000,PI,IP,001,1,9221,17750,9365,8529,PERF
42493326710000,PI,IP,001,1,8908,18970,10809,10062,PERF
42493326720000,PI,IP,001,1,8155,9930,3433,1775,PERF
42493326750000,PI,IP,001,1,7882,16791,9605,8909,PERF
42493326790000,PI,IP,001,1,9202,15075,6327,5873,PERF
42493326800000,PI,IP,001,1,8766,15055,6999,6289,PERF
42493326830000,PI,IP,001,1,8428,14205,6661,5777,PERF
42493326840100,PI,IP,001,1,8802,18156,10505,9354,PERF
42493326860000,PI,IP,001,1,8418,16780,9109,8362,PERF
42493326870000,PI,IP,001,1,8130,12614,6572,4484,PERF
42493326880000,PI,IP,001,1,7313,10817,4026,3504,OPENHOLE
42493326920000,PI,IP,001,1,9340,16759,8130,7419,PERF
42493326930000,PI,IP,001,1,9090,16968,8405,7878,PERF
42493327000000,PI,IP,001,1,7458,9899,3160,2441,PERF
42493327010000,PI,IP,001,1,8567,13770,5902,5203,PERF
42493327020000,PI,IP,001,1,8320,15129,7534,6809,PERF
42493327090000,PI,IP,001,1,7930,14980,7654,7050,PERF
42493327120000,PI,IP,001,1,8076,11310,,3234,PERF
42499314600000,PI,IP,001,1,4894,4914,,20,PERF
42507327190100,PI,IP,001,1,5225,5869,1119,644,OPENHOLE
42507327210200,PI,IP,001,1,4726,8900,3991,4174,PERF
42507327440100,PI,IP,001,1,5567,10771,5675,5204,PERF
42507327460000,PI,IP,001,1,6092,6225,5219,133,PERF
42507327460000,PI,IP,001,2,6317,6450,5219,133,PERF
42507327460000,PI,IP,001,3,6542,6675,5219,133,PERF
42507327460000,PI,IP,001,4,6767,6900,5219,133,PERF
42507327460000,PI,IP,001,5,6992,7125,5219,133,PERF
42507327460000,PI,IP,001,6,7217,7350,5219,133,PERF
42507327460000,PI,IP,001,7,7442,7575,5219,133,PERF
42507327460000,PI,IP,001,8,7667,7800,5219,133,PERF
42507327460000,PI,IP,001,9,7892,8025,5219,133,PERF
42507327460000,PI,IP,001,10,8117,8250,5219,133,PERF
42507327460000,PI,IP,001,11,8342,8475,5219,133,PERF
42507327460000,PI,IP,001,12,8567,8700,5219,133,PERF
42507327460000,PI,IP,001,13,8792,8925,5219,133,PERF
42507327460000,PI,IP,001,14,9017,9150,5219,133,PERF
42507327460000,PI,IP,001,15,9242,9375,5219,133,PERF
42507327460000,PI,IP,001,16,9467,9600,5219,133,PERF
42507327460000,PI,IP,001,17,9692,9825,5219,133,PERF
42507327460000,PI,IP,001,18,9917,10050,5219,133,PERF
42507327460000,PI,IP,001,19,10142,10275,5219,133,PERF
42507327460000,PI,IP,001,20,10367,10489,5219,122,PERF
42507327550000,PI,IP,001,1,5860,11579,6724,5719,PERF
42507327570101,PI,IP,001,1,5273,5279,,6,OPENHOLE
42507327570101,PI,IP,001,2,5871,9435,,3564,OPENHOLE
42507327600000,PI,IP,001,1,6360,6722,,362,PERF
42507327600000,PI,IP,001,2,6828,8126,,1298,PERF
42507327600000,PI,IP,001,3,8232,9998,,1766,PERF
42507327600000,PI,IP,001,4,10104,11870,,1766,PERF
42507327600000,PI,IP,001,5,11976,13274,,1298,PERF
42507327600000,PI,IP,001,6,13380,14030,,650,PERF
42507327630000,PI,IP,001,1,5516,10867,6439,5351,PERF
42507327680000,PI,IP,001,1,7021,7022,,1,PERF
42507327680000,PI,IP,001,2,7071,7072,,1,PERF
42507327680000,PI,IP,001,3,7121,7122,,1,PERF
42507327680000,PI,IP,001,4,7171,7172,,1,PERF
42507327680000,PI,IP,001,5,7221,7222,,1,PERF
42507327680000,PI,IP,001,6,7271,7272,,1,PERF
42507327680000,PI,IP,001,7,7321,7322,,1,PERF
42507327680000,PI,IP,001,8,7371,7372,,1,PERF
42507327680000,PI,IP,001,9,7470,7471,,1,PERF
42507327680000,PI,IP,001,10,7520,7521,,1,PERF
42507327680000,PI,IP,001,11,7570,7571,,1,PERF
42507327680000,PI,IP,001,12,7620,7621,,1,PERF
42507327680000,PI,IP,001,13,7670,7671,,1,PERF
42507327680000,PI,IP,001,14,7720,7721,,1,PERF
42507327680000,PI,IP,001,15,7770,7771,,1,PERF
42507327680000,PI,IP,001,16,7820,7821,,1,PERF
42507327680000,PI,IP,001,17,7919,7920,,1,PERF
42507327680000,PI,IP,001,18,7969,7970,,1,PERF
42507327680000,PI,IP,001,19,8019,8020,,1,PERF
42507327680000,PI,IP,001,20,8069,8070,,1,PERF
42507327680000,PI,IP,001,21,8119,8120,,1,PERF
42507327680000,PI,IP,001,22,8169,8170,,1,PERF
42507327680000,PI,IP,001,23,8219,8220,,1,PERF
42507327680000,PI,IP,001,24,8269,8270,,1,PERF
42507327680000,PI,IP,001,25,8368,8369,,1,PERF
42507327680000,PI,IP,001,26,8418,8419,,1,PERF
42507327680000,PI,IP,001,27,8468,8469,,1,PERF
42507327680000,PI,IP,001,28,8518,8519,,1,PERF
42507327680000,PI,IP,001,29,8568,8569,,1,PERF
42507327680000,PI,IP,001,30,8618,8619,,1,PERF
42507327680000,PI,IP,001,31,8668,8669,,1,PERF
42507327680000,PI,IP,001,32,8718,8719,,1,PERF
42507327680000,PI,IP,001,33,8817,8818,,1,PERF
42507327680000,PI,IP,001,34,8867,8868,,1,PERF
42507327680000,PI,IP,001,35,8917,8918,,1,PERF
42507327680000,PI,IP,001,36,8967,8968,,1,PERF
42507327680000,PI,IP,001,37,9017,9018,,1,PERF
42507327680000,PI,IP,001,38,9067,9068,,1,PERF
42507327680000,PI,IP,001,39,9117,9118,,1,PERF
42507327680000,PI,IP,001,40,9167,9168,,1,PERF
42507327680000,PI,IP,001,41,9266,9267,,1,PERF
42507327680000,PI,IP,001,42,9316,9317,,1,PERF
42507327680000,PI,IP,001,43,9366,9367,,1,PERF
42507327680000,PI,IP,001,44,9416,9417,,1,PERF
42507327680000,PI,IP,001,45,9466,9467,,1,PERF
42507327680000,PI,IP,001,46,9516,9517,,1,PERF
42507327680000,PI,IP,001,47,9566,9567,,1,PERF
42507327680000,PI,IP,001,48,9616,9617,,1,PERF
42507327680000,PI,IP,001,49,9715,9716,,1,PERF
42507327680000,PI,IP,001,50,9765,9766,,1,PERF
42507327680000,PI,IP,001,51,9815,9816,,1,PERF
42507327680000,PI,IP,001,52,9865,9866,,1,PERF
42507327680000,PI,IP,001,53,9915,9916,,1,PERF
42507327680000,PI,IP,001,54,9965,9966,,1,PERF
42507327680000,PI,IP,001,55,10015,10016,,1,PERF
42507327680000,PI,IP,001,56,10065,10066,,1,PERF
42507327680000,PI,IP,001,57,10164,10165,,1,PERF
42507327680000,PI,IP,001,58,10214,10215,,1,PERF
42507327680000,PI,IP,001,59,10264,10265,,1,PERF
42507327680000,PI,IP,001,60,10314,10315,,1,PERF
42507327680000,PI,IP,001,61,10364,10365,,1,PERF
42507327680000,PI,IP,001,62,10414,10415,,1,PERF
42507327680000,PI,IP,001,63,10464,10465,,1,PERF
42507327680000,PI,IP,001,64,10514,10515,,1,PERF
42507327680000,PI,IP,001,65,10613,10614,,1,PERF
42507327680000,PI,IP,001,66,10663,10664,,1,PERF
42507327680000,PI,IP,001,67,10713,10714,,1,PERF
42507327680000,PI,IP,001,68,10763,10764,,1,PERF
42507327680000,PI,IP,001,69,10813,10814,,1,PERF
42507327680000,PI,IP,001,70,10863,10864,,1,PERF
42507327680000,PI,IP,001,71,10913,10914,,1,PERF
42507327680000,PI,IP,001,72,10963,10964,,1,PERF
42507327680000,PI,IP,001,73,11062,11063,,1,PERF
42507327680000,PI,IP,001,74,11112,11113,,1,PERF
42507327680000,PI,IP,001,75,11162,11163,,1,PERF
42507327680000,PI,IP,001,76,11212,11213,,1,PERF
42507327680000,PI,IP,001,77,11262,11263,,1,PERF
42507327680000,PI,IP,001,78,11312,11313,,1,PERF
42507327680000,PI,IP,001,79,11362,11363,,1,PERF
42507327680000,PI,IP,001,80,11412,11413,,1,PERF
42507327680000,PI,IP,001,81,11511,11512,,1,PERF
42507327680000,PI,IP,001,82,11561,11562,,1,PERF
42507327680000,PI,IP,001,83,11611,11612,,1,PERF
42507327680000,PI,IP,001,84,11661,11662,,1,PERF
42507327680000,PI,IP,001,85,11711,11712,,1,PERF
42507327680000,PI,IP,001,86,11761,11762,,1,PERF
42507327680000,PI,IP,001,87,11811,11812,,1,PERF
42507327680000,PI,IP,001,88,11861,11862,,1,PERF
42507327680000,PI,IP,001,89,11960,11961,,1,PERF
42507327680000,PI,IP,001,90,12010,12011,,1,PERF
42507327680000,PI,IP,001,91,12060,12061,,1,PERF
42507327680000,PI,IP,001,92,12110,12111,,1,PERF
42507327680000,PI,IP,001,93,12160,12161,,1,PERF
42507327680000,PI,IP,001,94,12210,12211,,1,PERF
42507327680000,PI,IP,001,95,12260,12261,,1,PERF
42507327680000,PI,IP,001,96,12310,12311,,1,PERF
42507327680000,PI,IP,001,97,12409,12410,,1,PERF
42507327680000,PI,IP,001,98,12459,12460,,1,PERF
42507327680000,PI,IP,001,99,12509,12510,,1,PERF
42507327680000,PI,IP,001,100,12559,12560,,1,PERF
42507327680000,PI,IP,001,101,12609,12610,,1,PERF
42507327680000,PI,IP,001,102,12659,12660,,1,PERF
42507327680000,PI,IP,001,103,12709,12710,,1,PERF
42507327680000,PI,IP,001,104,12759,12760,,1,PERF
42507327680000,PI,IP,001,105,12819,12820,,1,PERF
42507327680000,PI,IP,001,106,12854,12855,,1,PERF
42507327680000,PI,IP,001,107,12889,12890,,1,PERF
42507327680000,PI,IP,001,108,12924,12925,,1,PERF
42507327680000,PI,IP,001,109,12959,12960,,1,PERF
42507327690000,PI,IP,001,1,6869,7105,6454,236,PERF
42507327690000,PI,IP,001,2,7153,7389,6454,236,PERF
42507327690000,PI,IP,001,3,7437,7673,6454,236,PERF
42507327690000,PI,IP,001,4,7721,7957,6454,236,PERF
42507327690000,PI,IP,001,5,8005,8241,6454,236,PERF
42507327690000,PI,IP,001,6,8289,8525,6454,236,PERF
42507327690000,PI,IP,001,7,8573,8809,6454,236,PERF
42507327690000,PI,IP,001,8,8857,9093,6454,236,PERF
42507327690000,PI,IP,001,9,9141,9377,6454,236,PERF
42507327690000,PI,IP,001,10,9425,9661,6454,236,PERF
42507327690000,PI,IP,001,11,9709,9945,6454,236,PERF
42507327690000,PI,IP,001,12,9993,10229,6454,236,PERF
42507327690000,PI,IP,001,13,10277,10513,6454,236,PERF
42507327690000,PI,IP,001,14,10561,10797,6454,236,PERF
42507327690000,PI,IP,001,15,10845,11081,6454,236,PERF
42507327690000,PI,IP,001,16,11129,11365,6454,236,PERF
42507327690000,PI,IP,001,17,11413,11649,6454,236,PERF
42507327690000,PI,IP,001,18,11697,11933,6454,236,PERF
42507327690000,PI,IP,001,19,11981,12217,6454,236,PERF
42507327690000,PI,IP,001,20,12265,12500,6454,235,PERF
42507327710000,PI,IP,001,1,7014,10976,4802,3962,PERF
42507327720000,PI,IP,002,1,6548,14460,8203,7912,PERF
42507327720000,PI,PT,001,1,14319,14320,8203,1,PERF
42507327720000,PI,PT,001,2,14354,14355,8203,1,PERF
42507327720000,PI,PT,001,3,14389,14390,8203,1,PERF
42507327720000,PI,PT,001,4,14424,14425,8203,1,PERF
42507327720000,PI,PT,001,5,14459,14460,8203,1,PERF
42507327730000,PI,IP,001,1,7038,13400,,6362,PERF
42507327740000,PI,IP,001,1,5155,10826,6126,5671,PERF
42507327750000,PI,IP,001,1,5209,11245,6727,6036,PERF
42507327780000,PI,IP,001,1,6342,6502,6530,160,PERF
42507327780000,PI,IP,001,2,6596,6750,6530,154,PERF
42507327780000,PI,IP,001,3,6856,7000,6530,144,PERF
42507327780000,PI,IP,001,4,7098,7248,6530,150,PERF
42507327780000,PI,IP,001,5,7348,7450,6530,102,PERF
42507327780000,PI,IP,001,6,7602,7750,6530,148,PERF
42507327780000,PI,IP,001,7,7850,8000,6530,150,PERF
42507327780000,PI,IP,001,8,8098,8258,6530,160,PERF
42507327780000,PI,IP,001,9,8345,8500,6530,155,PERF
42507327780000,PI,IP,001,10,8598,8747,6530,149,PERF
42507327780000,PI,IP,001,11,8848,9006,6530,158,PERF
42507327780000,PI,IP,001,12,9098,9250,6530,152,PERF
42507327780000,PI,IP,001,13,9349,9498,6530,149,PERF
42507327780000,PI,IP,001,14,9608,9754,6530,146,PERF
42507327780000,PI,IP,001,15,9854,10004,6530,150,PERF
42507327780000,PI,IP,001,16,10098,10250,6530,152,PERF
42507327780000,PI,IP,001,17,10348,10500,6530,152,PERF
42507327780000,PI,IP,001,18,10598,10750,6530,152,PERF
42507327780000,PI,IP,001,19,10878,11000,6530,122,PERF
42507327780000,PI,IP,001,20,11098,11260,6530,162,PERF
42507327780000,PI,IP,001,21,11572,11690,6530,118,PERF
42507327790000,PI,IP,001,1,4900,9723,4401,4823,OPENHOLE
42507327850000,PI,IP,001,1,6774,15075,8568,8301,PERF
42507327860000,PI,IP,001,1,6570,13222,7155,6652,PERF
42507327920000,PI,IP,001,1,7115,15250,,8135,PERF
42507327930000,PI,IP,001,1,7137,10160,4901,3023,PERF
42507327930000,PI,IP,001,2,10237,10517,4901,280,PERF
42507327930000,PI,IP,001,3,10520,10857,4901,337,PERF
42507327940000,PI,IP,001,1,6590,11295,4880,4705,PERF
42507327960000,PI,IP,001,1,6324,13935,7817,7611,PERF
42507327970000,PI,IP,001,1,6969,15407,,8438,COMB
42507328010000,PI,IP,002,1,6509,14153,,7644,PERF
42507328010000,PI,PT,001,1,6509,14153,,7644,PERF
42507328030000,PI,IP,001,1,6721,14700,8660,7979,PERF
42507328050000,PI,IP,001,1,5744,13529,,7785,PERF
42507328060000,PI,IP,001,1,5830,13627,8908,7797,PERF
42507328070000,PI,IP,001,1,6261,14045,8723,7784,PERF
42507328090000,PI,IP,001,1,6750,14779,,8029,PERF
42507328100000,PI,IP,001,1,6421,14860,8685,8439,PERF
42507328140000,PI,IP,001,1,6869,13110,6630,6241,PERF
42507328180000,PI,IP,001,1,6888,14440,7659,7552,PERF
42507328190000,PI,IP,001,1,7044,14738,8225,7694,PERF
42507328210000,PI,IP,001,1,5765,13578,,7813,PERF
42507328230000,PI,IP,001,1,5784,14156,9189,8372,PERF
42507328240000,PI,IP,001,1,5849,10059,,4210,PERF
42507328250000,PI,IP,002,1,7981,8242,7757,261,PERF
42507328250000,PI,IP,002,2,8287,8548,7757,261,PERF
42507328250000,PI,IP,002,3,8593,8854,7757,261,PERF
42507328250000,PI,IP,002,4,8899,9160,7757,261,PERF
42507328250000,PI,IP,002,5,9205,9466,7757,261,PERF
42507328250000,PI,IP,002,6,9511,9772,7757,261,PERF
42507328250000,PI,IP,002,7,9817,10078,7757,261,PERF
42507328250000,PI,IP,002,8,10123,10384,7757,261,PERF
42507328250000,PI,IP,002,9,10429,10690,7757,261,PERF
42507328250000,PI,IP,002,10,10735,10996,7757,261,PERF
42507328250000,PI,IP,002,11,11041,11302,7757,261,PERF
42507328250000,PI,IP,002,12,11347,11608,7757,261,PERF
42507328250000,PI,IP,002,13,11653,11914,7757,261,PERF
42507328250000,PI,IP,002,14,11959,12220,7757,261,PERF
42507328250000,PI,IP,002,15,12265,12526,7757,261,PERF
42507328250000,PI,IP,002,16,12571,12832,7757,261,PERF
42507328250000,PI,IP,002,17,12877,13138,7757,261,PERF
42507328250000,PI,PT,001,1,13183,13444,7757,261,PERF
42507328250000,PI,PT,001,2,13489,13750,7757,261,PERF
42507328250000,PI,PT,001,3,13795,14055,7757,260,PERF
42507328290000,PI,IP,001,1,7003,14952,,7949,PERF
42507328300000,PI,IP,003,1,5750,5762,,12,PERF
42507328300000,PI,PT,001,1,5851,5977,,126,PERF
42507328300000,PI,PT,002,2,5352,5417,,65,PERF
42507328310000,PI,IP,001,1,7017,7227,5562,210,PERF
42507328310000,PI,IP,001,2,7337,7547,5562,210,PERF
42507328310000,PI,IP,001,3,7657,7867,5562,210,PERF
42507328310000,PI,IP,001,4,7977,8187,5562,210,PERF
42507328310000,PI,IP,001,5,8297,8507,5562,210,PERF
42507328310000,PI,IP,001,6,8617,8827,5562,210,PERF
42507328310000,PI,IP,001,7,8937,9147,5562,210,PERF
42507328310000,PI,IP,001,8,9257,9467,5562,210,PERF
42507328310000,PI,IP,001,9,9577,9787,5562,210,PERF
42507328310000,PI,IP,001,10,9897,10107,5562,210,PERF
42507328310000,PI,IP,001,11,10217,10427,5562,210,PERF
42507328310000,PI,IP,001,12,10537,10747,5562,210,PERF
42507328310000,PI,IP,001,13,10857,11067,5562,210,PERF
42507328310000,PI,IP,001,14,11177,11415,5562,238,PERF
42507328350000,PI,IP,001,1,6668,6877,5452,209,PERF
42507328350000,PI,IP,001,2,6993,7202,5452,209,PERF
42507328350000,PI,IP,001,3,7318,7527,5452,209,PERF
42507328350000,PI,IP,001,4,7643,7852,5452,209,PERF
42507328350000,PI,IP,001,5,7968,8177,5452,209,PERF
42507328350000,PI,IP,001,6,8293,8502,5452,209,PERF
42507328350000,PI,IP,001,7,8618,8827,5452,209,PERF
42507328350000,PI,IP,001,8,8943,9152,5452,209,PERF
42507328350000,PI,IP,001,9,9268,9477,5452,209,PERF
42507328350000,PI,IP,001,10,9593,9802,5452,209,PERF
42507328350000,PI,IP,001,11,9918,10127,5452,209,PERF
42507328350000,PI,IP,001,12,10243,10452,5452,209,PERF
42507328350000,PI,IP,001,13,10568,10777,5452,209,PERF
42507328350000,PI,IP,001,14,10893,11102,5452,209,PERF
42507328360000,PI,IP,001,1,6497,14887,,8390,PERF
42507328370000,PI,IP,001,1,6367,14281,,7914,PERF
42507328390000,PI,IP,001,1,6662,6871,5403,209,PERF
42507328390000,PI,IP,001,2,6993,7202,5403,209,PERF
42507328390000,PI,IP,001,3,7324,7533,5403,209,PERF
42507328390000,PI,IP,001,4,7655,7864,5403,209,PERF
42507328390000,PI,IP,001,5,7986,8195,5403,209,PERF
42507328390000,PI,IP,001,6,8317,8526,5403,209,PERF
42507328390000,PI,IP,001,7,8648,8857,5403,209,PERF
42507328390000,PI,IP,001,8,8979,9188,5403,209,PERF
42507328390000,PI,IP,001,9,9310,9519,5403,209,PERF
42507328390000,PI,IP,001,10,9641,9850,5403,209,PERF
42507328390000,PI,IP,001,11,9972,10181,5403,209,PERF
42507328390000,PI,IP,001,12,10303,10512,5403,209,PERF
42507328390000,PI,IP,001,13,10634,10843,5403,209,PERF
42507328390000,PI,IP,001,14,10965,11236,5403,271,PERF
42507328440000,PI,IP,001,1,7007,14901,8273,7894,PERF
42507328460000,PI,IP,001,1,6749,12000,6732,5251,PERF
42507328470000,PI,IP,001,1,6015,12132,6792,6117,PERF
42507328500000,PI,IP,001,1,7076,14786,,7710,PERF
42507328550000,PI,IP,001,1,7011,15064,,8053,PERF
42507328580000,PI,IP,001,1,6178,14866,,8688,PERF
42507328590000,PI,IP,001,1,6302,13038,7371,6736,PERF
42507328650000,PI,IP,001,1,7002,12361,5730,5359,PERF
42507328660000,PI,IP,002,1,7526,11360,6315,3834,PERF
42507328660000,PI,PT,001,1,7526,11360,6315,3834,PERF
42507328670000,PI,IP,001,1,6926,15085,,8159,PERF
42507328690000,PI,IP,001,1,6783,11715,5963,4932,PERF
42507328700000,PI,IP,001,1,6533,12184,5854,5651,PERF
42507328710100,PI,IP,001,1,6654,11467,5249,4813,PERF
42507328720000,PI,IP,002,1,8019,11855,6894,3836,PERF
42507328720000,PI,PT,001,1,8019,11855,6894,3836,PERF
42507328760000,PI,IP,001,1,6613,11942,6131,5329,PERF
42507328780000,PI,IP,002,1,5438,5459,,21,PERF
42507328780000,PI,PT,001,1,5593,5669,,76,PERF
42507328790000,PI,IP,001,1,6686,11447,5961,4761,PERF
42507328860000,PI,IP,001,1,7570,7775,5534,205,PERF
42507328860000,PI,IP,001,2,7866,8057,5534,191,PERF
42507328860000,PI,IP,001,3,8145,8339,5534,194,PERF
42507328860000,PI,IP,001,4,8414,8621,5534,207,PERF
42507328860000,PI,IP,001,5,8698,8903,5534,205,PERF
42507328860000,PI,IP,001,6,8980,9185,5534,205,PERF
42507328860000,PI,IP,001,7,9262,9457,5534,195,PERF
42507328860000,PI,IP,001,8,9544,9749,5534,205,PERF
42507328860000,PI,IP,001,9,9826,10031,5534,205,PERF
42507328860000,PI,IP,001,10,10113,10313,5534,200,PERF
42507328860000,PI,IP,001,11,10398,10595,5534,197,PERF
42507328860000,PI,IP,001,12,10672,10877,5534,205,PERF
42507328860000,PI,IP,001,13,10954,11159,5534,205,PERF
42507328860000,PI,IP,001,14,11236,11441,5534,205,PERF
42507328860000,PI,IP,001,15,11518,11723,5534,205,PERF
42507328860000,PI,IP,001,16,11800,12005,5534,205,PERF
42507328870000,PI,IP,001,1,7166,12518,6200,5352,PERF
42507328890000,PI,IP,001,1,6596,11807,6058,5211,PERF
42507328910000,PI,IP,001,1,6769,11653,,4884,PERF
42507328940000,PI,IP,001,1,6958,14909,,7951,PERF
42507328950000,PI,IP,001,1,6724,14953,9158,8229,PERF
42507328970000,PI,IP,002,1,7630,12398,7180,4768,PERF
42507328970000,PI,PT,001,1,7630,12398,7180,4768,PERF
42507328990000,PI,IP,002,1,5874,5895,,21,PERF
42507328990000,PI,PT,001,1,5874,5895,,21,PERF
42507329000000,PI,IP,001,1,6814,11724,6394,4910,PERF
42507329080000,PI,IP,001,1,7041,14738,8635,7697,PERF
42507329160000,PI,IP,001,1,6696,12984,,6288,PERF
42507329200000,PI,IP,001,1,6575,14487,8176,7912,PERF
42507329210000,PI,IP,001,1,6714,6715,8317,1,PERF
42507329210000,PI,IP,001,2,6744,6745,8317,1,PERF
42507329210000,PI,IP,001,3,6774,6775,8317,1,PERF
42507329210000,PI,IP,001,4,6804,6805,8317,1,PERF
42507329210000,PI,IP,001,5,6834,6835,8317,1,PERF
42507329210000,PI,IP,001,6,6864,6865,8317,1,PERF
42507329210000,PI,IP,001,7,6894,6895,8317,1,PERF
42507329210000,PI,IP,001,8,6924,6925,8317,1,PERF
42507329210000,PI,IP,001,9,6954,6955,8317,1,PERF
42507329210000,PI,IP,001,10,6984,6985,8317,1,PERF
42507329210000,PI,IP,001,11,7046,7047,8317,1,PERF
42507329210000,PI,IP,001,12,7076,7077,8317,1,PERF
42507329210000,PI,IP,001,13,7106,7107,8317,1,PERF
42507329210000,PI,IP,001,14,7136,7137,8317,1,PERF
42507329210000,PI,IP,001,15,7166,7167,8317,1,PERF
42507329210000,PI,IP,001,16,7196,7197,8317,1,PERF
42507329210000,PI,IP,001,17,7226,7227,8317,1,PERF
42507329210000,PI,IP,001,18,7256,7257,8317,1,PERF
42507329210000,PI,IP,001,19,7286,7287,8317,1,PERF
42507329210000,PI,IP,001,20,7316,7317,8317,1,PERF
42507329210000,PI,IP,001,21,7378,7379,8317,1,PERF
42507329210000,PI,IP,001,22,7408,7409,8317,1,PERF
42507329210000,PI,IP,001,23,7438,7439,8317,1,PERF
42507329210000,PI,IP,001,24,7468,7469,8317,1,PERF
42507329210000,PI,IP,001,25,7498,7499,8317,1,PERF
42507329210000,PI,IP,001,26,7528,7529,8317,1,PERF
42507329210000,PI,IP,001,27,7558,7559,8317,1,PERF
42507329210000,PI,IP,001,28,7588,7589,8317,1,PERF
42507329210000,PI,IP,001,29,7618,7619,8317,1,PERF
42507329210000,PI,IP,001,30,7648,7649,8317,1,PERF
42507329210000,PI,IP,001,31,7710,7711,8317,1,PERF
42507329210000,PI,IP,001,32,7740,7741,8317,1,PERF
42507329210000,PI,IP,001,33,7770,7771,8317,1,PERF
42507329210000,PI,IP,001,34,7800,7801,8317,1,PERF
42507329210000,PI,IP,001,35,7830,7831,8317,1,PERF
42507329210000,PI,IP,001,36,7860,7861,8317,1,PERF
42507329210000,PI,IP,001,37,7890,7891,8317,1,PERF
42507329210000,PI,IP,001,38,7920,7921,8317,1,PERF
42507329210000,PI,IP,001,39,7950,7951,8317,1,PERF
42507329210000,PI,IP,001,40,7980,7981,8317,1,PERF
42507329210000,PI,IP,001,41,8042,8043,8317,1,PERF
42507329210000,PI,IP,001,42,8072,8073,8317,1,PERF
42507329210000,PI,IP,001,43,8102,8103,8317,1,PERF
42507329210000,PI,IP,001,44,8132,8133,8317,1,PERF
42507329210000,PI,IP,001,45,8162,8163,8317,1,PERF
42507329210000,PI,IP,001,46,8192,8193,8317,1,PERF
42507329210000,PI,IP,001,47,8222,8223,8317,1,PERF
42507329210000,PI,IP,001,48,8252,8253,8317,1,PERF
42507329210000,PI,IP,001,49,8282,8283,8317,1,PERF
42507329210000,PI,IP,001,50,8312,8313,8317,1,PERF
42507329210000,PI,IP,001,51,8374,8375,8317,1,PERF
42507329210000,PI,IP,001,52,8404,8405,8317,1,PERF
42507329210000,PI,IP,001,53,8434,8435,8317,1,PERF
42507329210000,PI,IP,001,54,8464,8465,8317,1,PERF
42507329210000,PI,IP,001,55,8494,8495,8317,1,PERF
42507329210000,PI,IP,001,56,8524,8525,8317,1,PERF
42507329210000,PI,IP,001,57,8554,8555,8317,1,PERF
42507329210000,PI,IP,001,58,8584,8585,8317,1,PERF
42507329210000,PI,IP,001,59,8614,8615,8317,1,PERF
42507329210000,PI,IP,001,60,8644,8645,8317,1,PERF
42507329210000,PI,IP,001,61,8706,8707,8317,1,PERF
42507329210000,PI,IP,001,62,8736,8737,8317,1,PERF
42507329210000,PI,IP,001,63,8766,8767,8317,1,PERF
42507329210000,PI,IP,001,64,8796,8797,8317,1,PERF
42507329210000,PI,IP,001,65,8826,8827,8317,1,PERF
42507329210000,PI,IP,001,66,8856,8857,8317,1,PERF
42507329210000,PI,IP,001,67,8886,8887,8317,1,PERF
42507329210000,PI,IP,001,68,8916,8917,8317,1,PERF
42507329210000,PI,IP,001,69,8946,8947,8317,1,PERF
42507329210000,PI,IP,001,70,8976,8976,8317,0,PERF
42507329210000,PI,IP,001,71,9038,9038,8317,0,PERF
42507329210000,PI,IP,001,72,9068,9069,8317,1,PERF
42507329210000,PI,IP,001,73,9098,9099,8317,1,PERF
42507329210000,PI,IP,001,74,9128,9129,8317,1,PERF
42507329210000,PI,IP,001,75,9158,9159,8317,1,PERF
42507329210000,PI,IP,001,76,9188,9189,8317,1,PERF
42507329210000,PI,IP,001,77,9218,9219,8317,1,PERF
42507329210000,PI,IP,001,78,9248,9249,8317,1,PERF
42507329210000,PI,IP,001,79,9278,9279,8317,1,PERF
42507329210000,PI,IP,001,80,9308,9309,8317,1,PERF
42507329210000,PI,IP,001,81,9370,9371,8317,1,PERF
42507329210000,PI,IP,001,82,9400,9401,8317,1,PERF
42507329210000,PI,IP,001,83,9430,9431,8317,1,PERF
42507329210000,PI,IP,001,84,9460,9461,8317,1,PERF
42507329210000,PI,IP,001,85,9490,9491,8317,1,PERF
42507329210000,PI,IP,001,86,9520,9521,8317,1,PERF
42507329210000,PI,IP,001,87,9550,9551,8317,1,PERF
42507329210000,PI,IP,001,88,9580,9581,8317,1,PERF
42507329210000,PI,IP,001,89,9610,9611,8317,1,PERF
42507329210000,PI,IP,001,90,9640,9641,8317,1,PERF
42507329210000,PI,IP,001,91,9702,9703,8317,1,PERF
42507329210000,PI,IP,001,92,9732,9733,8317,1,PERF
42507329210000,PI,IP,001,93,9762,9763,8317,1,PERF
42507329210000,PI,IP,001,94,9792,9793,8317,1,PERF
42507329210000,PI,IP,001,95,9822,9823,8317,1,PERF
42507329210000,PI,IP,001,96,9852,9853,8317,1,PERF
42507329210000,PI,IP,001,97,9882,9883,8317,1,PERF
42507329210000,PI,IP,001,98,9912,9913,8317,1,PERF
42507329210000,PI,IP,001,99,9942,9943,8317,1,PERF
42507329210000,PI,IP,001,100,9972,9973,8317,1,PERF
42507329210000,PI,IP,001,101,10034,10035,8317,1,PERF
42507329210000,PI,IP,001,102,10064,10065,8317,1,PERF
42507329210000,PI,IP,001,103,10094,10095,8317,1,PERF
42507329210000,PI,IP,001,104,10124,10125,8317,1,PERF
42507329210000,PI,IP,001,105,10154,10155,8317,1,PERF
42507329210000,PI,IP,001,106,10184,10185,8317,1,PERF
42507329210000,PI,IP,001,107,10214,10215,8317,1,PERF
42507329210000,PI,IP,001,108,10244,10245,8317,1,PERF
42507329210000,PI,IP,001,109,10274,10275,8317,1,PERF
42507329210000,PI,IP,001,110,10304,10305,8317,1,PERF
42507329210000,PI,IP,001,111,10366,10367,8317,1,PERF
42507329210000,PI,IP,001,112,10396,10397,8317,1,PERF
42507329210000,PI,IP,001,113,10426,10427,8317,1,PERF
42507329210000,PI,IP,001,114,10456,10457,8317,1,PERF
42507329210000,PI,IP,001,115,10486,10487,8317,1,PERF
42507329210000,PI,IP,001,116,10516,10517,8317,1,PERF
42507329210000,PI,IP,001,117,10546,10547,8317,1,PERF
42507329210000,PI,IP,001,118,10576,10577,8317,1,PERF
42507329210000,PI,IP,001,119,10606,10607,8317,1,PERF
42507329210000,PI,IP,001,120,10636,10637,8317,1,PERF
42507329210000,PI,IP,001,121,10698,10699,8317,1,PERF
42507329210000,PI,IP,001,122,10728,10729,8317,1,PERF
42507329210000,PI,IP,001,123,10758,10759,8317,1,PERF
42507329210000,PI,IP,001,124,10788,10789,8317,1,PERF
42507329210000,PI,IP,001,125,10818,10819,8317,1,PERF
42507329210000,PI,IP,001,126,10848,10849,8317,1,PERF
42507329210000,PI,IP,001,127,10878,10879,8317,1,PERF
42507329210000,PI,IP,001,128,10908,10909,8317,1,PERF
42507329210000,PI,IP,001,129,10938,10939,8317,1,PERF
42507329210000,PI,IP,001,130,10968,10969,8317,1,PERF
42507329210000,PI,IP,001,131,11030,11031,8317,1,PERF
42507329210000,PI,IP,001,132,11060,11061,8317,1,PERF
42507329210000,PI,IP,001,133,11090,11091,8317,1,PERF
42507329210000,PI,IP,001,134,11120,11121,8317,1,PERF
42507329210000,PI,IP,001,135,11150,11151,8317,1,PERF
42507329210000,PI,IP,001,136,11180,11181,8317,1,PERF
42507329210000,PI,IP,001,137,11210,11211,8317,1,PERF
42507329210000,PI,IP,001,138,11240,11241,8317,1,PERF
42507329210000,PI,IP,001,139,11270,11271,8317,1,PERF
42507329210000,PI,IP,001,140,11300,11301,8317,1,PERF
42507329210000,PI,IP,001,141,11362,11363,8317,1,PERF
42507329210000,PI,IP,001,142,11392,11393,8317,1,PERF
42507329210000,PI,IP,001,143,11422,11423,8317,1,PERF
42507329210000,PI,IP,001,144,11452,11453,8317,1,PERF
42507329210000,PI,IP,001,145,11482,11483,8317,1,PERF
42507329210000,PI,IP,001,146,11512,11513,8317,1,PERF
42507329210000,PI,IP,001,147,11542,11543,8317,1,PERF
42507329210000,PI,IP,001,148,11572,11573,8317,1,PERF
42507329210000,PI,IP,001,149,11602,11603,8317,1,PERF
42507329210000,PI,IP,001,150,11632,11633,8317,1,PERF
42507329210000,PI,IP,001,151,11694,11695,8317,1,PERF
42507329210000,PI,IP,001,152,11724,11725,8317,1,PERF
42507329210000,PI,IP,001,153,11754,11755,8317,1,PERF
42507329210000,PI,IP,001,154,11784,11785,8317,1,PERF
42507329210000,PI,IP,001,155,11814,11815,8317,1,PERF
42507329210000,PI,IP,001,156,11844,11845,8317,1,PERF
42507329210000,PI,IP,001,157,11874,11875,8317,1,PERF
42507329210000,PI,IP,001,158,11904,11905,8317,1,PERF
42507329210000,PI,IP,001,159,11934,11935,8317,1,PERF
42507329210000,PI,IP,001,160,11964,11965,8317,1,PERF
42507329210000,PI,IP,001,161,12026,12027,8317,1,PERF
42507329210000,PI,IP,001,162,12056,12057,8317,1,PERF
42507329210000,PI,IP,001,163,12086,12087,8317,1,PERF
42507329210000,PI,IP,001,164,12116,12117,8317,1,PERF
42507329210000,PI,IP,001,165,12146,12147,8317,1,PERF
42507329210000,PI,IP,001,166,12176,12177,8317,1,PERF
42507329210000,PI,IP,001,167,12206,12207,8317,1,PERF
42507329210000,PI,IP,001,168,12236,12237,8317,1,PERF
42507329210000,PI,IP,001,169,12266,12267,8317,1,PERF
42507329210000,PI,IP,001,170,12296,12297,8317,1,PERF
42507329210000,PI,IP,001,171,12359,12360,8317,1,PERF
42507329210000,PI,IP,001,172,12389,12390,8317,1,PERF
42507329210000,PI,IP,001,173,12419,12420,8317,1,PERF
42507329210000,PI,IP,001,174,12449,12450,8317,1,PERF
42507329210000,PI,IP,001,175,12479,12480,8317,1,PERF
42507329210000,PI,IP,001,176,12509,12510,8317,1,PERF
42507329210000,PI,IP,001,177,12539,12540,8317,1,PERF
42507329210000,PI,IP,001,178,12569,12570,8317,1,PERF
42507329210000,PI,IP,001,179,12599,12600,8317,1,PERF
42507329210000,PI,IP,001,180,12629,12630,8317,1,PERF
42507329210000,PI,IP,001,181,12692,12693,8317,1,PERF
42507329210000,PI,IP,001,182,12722,12723,8317,1,PERF
42507329210000,PI,IP,001,183,12752,12753,8317,1,PERF
42507329210000,PI,IP,001,184,12782,12783,8317,1,PERF
42507329210000,PI,IP,001,185,12812,12813,8317,1,PERF
42507329210000,PI,IP,001,186,12842,12843,8317,1,PERF
42507329210000,PI,IP,001,187,12872,12873,8317,1,PERF
42507329210000,PI,IP,001,188,12902,12903,8317,1,PERF
42507329210000,PI,IP,001,189,12932,12933,8317,1,PERF
42507329210000,PI,IP,001,190,12962,12963,8317,1,PERF
42507329210000,PI,IP,001,191,13025,13026,8317,1,PERF
42507329210000,PI,IP,001,192,13055,13056,8317,1,PERF
42507329210000,PI,IP,001,193,13085,13086,8317,1,PERF
42507329210000,PI,IP,001,194,13115,13116,8317,1,PERF
42507329210000,PI,IP,001,195,13145,13146,8317,1,PERF
42507329210000,PI,IP,001,196,13175,13176,8317,1,PERF
42507329210000,PI,IP,001,197,13205,13206,8317,1,PERF
42507329210000,PI,IP,001,198,13235,13236,8317,1,PERF
42507329210000,PI,IP,001,199,13265,13266,8317,1,PERF
42507329210000,PI,IP,001,200,13295,13296,8317,1,PERF
42507329210000,PI,IP,001,201,13358,13359,8317,1,PERF
42507329210000,PI,IP,001,202,13388,13389,8317,1,PERF
42507329210000,PI,IP,001,203,13418,13419,8317,1,PERF
42507329210000,PI,IP,001,204,13448,13449,8317,1,PERF
42507329210000,PI,IP,001,205,13478,13479,8317,1,PERF
42507329210000,PI,IP,001,206,13508,13509,8317,1,PERF
42507329210000,PI,IP,001,207,13538,13539,8317,1,PERF
42507329210000,PI,IP,001,208,13568,13569,8317,1,PERF
42507329210000,PI,IP,001,209,13598,13599,8317,1,PERF
42507329210000,PI,IP,001,210,13628,13629,8317,1,PERF
42507329210000,PI,IP,001,211,13691,13692,8317,1,PERF
42507329210000,PI,IP,001,212,13721,13722,8317,1,PERF
42507329210000,PI,IP,001,213,13751,13752,8317,1,PERF
42507329210000,PI,IP,001,214,13781,13782,8317,1,PERF
42507329210000,PI,IP,001,215,13811,13812,8317,1,PERF
42507329210000,PI,IP,001,216,13841,13842,8317,1,PERF
42507329210000,PI,IP,001,217,13871,13872,8317,1,PERF
42507329210000,PI,IP,001,218,13901,13902,8317,1,PERF
42507329210000,PI,IP,001,219,13931,13932,8317,1,PERF
42507329210000,PI,IP,001,220,13961,13962,8317,1,PERF
42507329210000,PI,IP,001,221,14024,14025,8317,1,PERF
42507329210000,PI,IP,001,222,14054,14055,8317,1,PERF
42507329210000,PI,IP,001,223,14084,14085,8317,1,PERF
42507329210000,PI,IP,001,224,14114,14115,8317,1,PERF
42507329210000,PI,IP,001,225,14144,14145,8317,1,PERF
42507329210000,PI,IP,001,226,14174,14175,8317,1,PERF
42507329210000,PI,IP,001,227,14204,14205,8317,1,PERF
42507329210000,PI,IP,001,228,14234,14235,8317,1,PERF
42507329210000,PI,IP,001,229,14264,14265,8317,1,PERF
42507329210000,PI,IP,001,230,14294,14295,8317,1,PERF
42507329210000,PI,IP,001,231,14357,14358,8317,1,PERF
42507329210000,PI,IP,001,232,14394,14395,8317,1,PERF
42507329210000,PI,IP,001,233,14432,14433,8317,1,PERF
42507329210000,PI,IP,001,234,14469,14470,8317,1,PERF
42507329210000,PI,IP,001,235,14506,14507,8317,1,PERF
42507329410000,PI,IP,001,1,9009,13475,8100,4466,PERF
42507329430000,PI,IP,001,1,5983,10306,5142,4323,PERF
42507329450000,PI,IP,001,1,6648,11723,6468,5075,PERF
42507329490000,PI,IP,001,1,5644,5665,,21,PERF
42507329500000,PI,IP,001,1,5650,5739,,89,PERF
42507329660000,PI,IP,001,1,6790,12232,6234,5442,PERF
42507329740000,PI,IP,001,1,6892,14030,7914,7138,PERF
42127350710000,PI,IP,001,1,7703,13976,6875,6273,PERF
42127351000000,PI,IP,001,1,6580,6803,5590,223,PERF
42127351000000,PI,IP,001,2,6903,7121,5590,218,PERF
42127351000000,PI,IP,001,3,7218,7448,5590,230,PERF
42127351000000,PI,IP,001,4,7552,7769,5590,217,PERF
42127351000000,PI,IP,001,5,7872,8088,5590,216,PERF
42127351000000,PI,IP,001,6,8195,8413,5590,218,PERF
42127351000000,PI,IP,001,7,8518,8741,5590,223,PERF
42127351000000,PI,IP,001,8,8841,9064,5590,223,PERF
42127351000000,PI,IP,001,9,9164,9387,5590,223,PERF
42127351000000,PI,IP,001,10,9487,9710,5590,223,PERF
42127351000000,PI,IP,001,11,9810,9995,5590,185,PERF
42127351000000,PI,IP,001,12,10133,10356,5590,223,PERF
42127351000000,PI,IP,001,13,10456,10679,5590,223,PERF
42127351000000,PI,IP,001,14,10779,11002,5590,223,PERF
42127351000000,PI,IP,001,15,11102,11325,5590,223,PERF
42127351000000,PI,IP,001,16,11431,11654,5590,223,PERF
42127351080000,PI,IP,001,1,6837,12722,6732,5885,PERF
42127351130100,PI,PT,001,1,7107,11848,,4741,PERF
42127351170000,PI,PT,001,1,7081,11940,,4859,PERF
42127351220000,PI,IP,001,1,7108,11956,,4848,PERF
42127351280000,PI,IP,001,1,7229,11778,5583,4549,PERF
42127351320000,PI,IP,001,1,7520,15080,9076,7560,PERF
42127351330000,PI,IP,001,1,7748,15444,,7696,PERF
42127351340000,PI,IP,001,1,7589,15051,9078,7462,PERF
42127351400000,PI,IP,001,1,7787,15003,8772,7216,PERF
42127351410000,PI,IP,001,1,7715,14840,8746,7125,PERF
42127351510000,PI,IP,001,1,7820,15009,8760,7189,PERF
42127351520000,PI,IP,001,1,7900,14954,,7054,PERF
42127351530000,PI,IP,001,1,8005,15388,,7383,PERF
42127351540000,PI,IP,001,1,8002,8234,5989,232,PERF
42127351540000,PI,IP,001,2,8314,8549,5989,235,PERF
42127351540000,PI,IP,001,3,8626,8862,5989,236,PERF
42127351540000,PI,IP,001,4,8938,9174,5989,236,PERF
42127351540000,PI,IP,001,5,9250,9486,5989,236,PERF
42127351540000,PI,IP,001,6,9562,9798,5989,236,PERF
42127351540000,PI,IP,001,7,9874,10110,5989,236,PERF
42127351540000,PI,IP,001,8,10186,10422,5989,236,PERF
42127351540000,PI,IP,001,9,10498,10734,5989,236,PERF
42127351540000,PI,IP,001,10,10810,11046,5989,236,PERF
42127351540000,PI,IP,001,11,11123,11358,5989,235,PERF
42127351540000,PI,IP,001,12,11440,11670,5989,230,PERF
42127351540000,PI,IP,001,13,11740,11982,5989,242,PERF
42127351540000,PI,IP,001,14,12058,12294,5989,236,PERF
42127351540000,PI,IP,001,15,12370,12600,5989,230,PERF
42127351540000,PI,IP,001,16,12682,12918,5989,236,PERF
42127351540000,PI,IP,001,17,12994,13219,5989,225,PERF
42127351560000,PI,IP,001,1,8000,12930,5996,4930,PERF
42127352520000,PI,IP,001,1,8378,8674,6197,296,PERF
42127352520000,PI,IP,001,2,8774,9066,6197,292,PERF
42127352520000,PI,IP,001,3,9162,9458,6197,296,PERF
42127352520000,PI,IP,001,4,9554,9850,6197,296,PERF
42127352520000,PI,IP,001,5,9946,10242,6197,296,PERF
42127352520000,PI,IP,001,6,10338,10634,6197,296,PERF
42127352520000,PI,IP,001,7,10730,11026,6197,296,PERF
42127352520000,PI,IP,001,8,11122,11418,6197,296,PERF
42127352520000,PI,IP,001,9,11514,11804,6197,290,PERF
42127352520000,PI,IP,001,10,11906,12202,6197,296,PERF
42127352520000,PI,IP,001,11,12298,12594,6197,296,PERF
42127352520000,PI,IP,001,12,12690,12986,6197,296,PERF
42127352520000,PI,IP,001,13,13086,13378,6197,292,PERF
42127352520000,PI,IP,001,14,13474,13667,6197,193,PERF
42127352520000,PI,IP,001,15,13866,14108,6197,242,PERF
42255326430000,PI,IP,001,1,10984,16017,,5033,PERF
42255326440100,PI,IP,001,1,10796,15578,,4782,PERF
42255326460000,PI,IP,001,1,10490,16268,6251,5778,PERF
42255326470000,PI,IP,001,1,10525,16900,6814,6375,PERF
42255326480000,PI,IP,001,1,12552,12782,4388,230,PERF
42255326480000,PI,IP,001,2,12860,13090,4388,230,PERF
42255326480000,PI,IP,001,3,13168,13392,4388,224,PERF
42255326480000,PI,IP,001,4,13476,13706,4388,230,PERF
42255326480000,PI,IP,001,5,13784,14014,4388,230,PERF
42255326480000,PI,IP,001,6,14092,14322,4388,230,PERF
42255326480000,PI,IP,001,7,14400,14630,4388,230,PERF
42255326480000,PI,IP,001,8,14708,14938,4388,230,PERF
42255326480000,PI,IP,001,9,15016,15242,4388,226,PERF
42255326480000,PI,IP,001,10,15324,15554,4388,230,PERF
42255326480000,PI,IP,001,11,15632,15867,4388,235,PERF
42255326480000,PI,IP,001,12,16028,16210,4388,182,PERF
42255326490000,PI,IP,001,1,10540,16093,6163,5553,PERF
42255326530000,PI,IP,001,1,9480,17821,8810,8341,PERF
42255326540000,PI,IP,001,1,11003,16061,6131,5058,PERF
42255326550000,PI,IP,001,1,12397,17718,5972,5321,PERF
42255326560000,PI,IP,001,1,12438,17775,5957,5337,PERF
42255326590000,PI,IP,001,1,10950,16171,6117,5221,PERF
42255326600000,PI,IP,001,1,12135,18693,7431,6558,PERF
42255326610000,PI,IP,001,1,12260,18604,7291,6344,PERF
42255326620000,PI,IP,001,1,12370,17902,6196,5532,PERF
42255326630000,PI,IP,001,1,10800,15888,6050,5088,PERF
42255326640000,PI,IP,001,1,10748,17060,6884,6312,PERF
42255326650000,PI,IP,001,1,11730,11932,5248,202,PERF
42255326650000,PI,IP,001,2,11990,12187,5248,197,PERF
42255326650000,PI,IP,001,3,12250,12522,5248,272,PERF
42255326650000,PI,IP,001,4,12600,12872,5248,272,PERF
42255326650000,PI,IP,001,5,12950,13222,5248,272,PERF
42255326650000,PI,IP,001,6,13300,13572,5248,272,PERF
42255326650000,PI,IP,001,7,13656,13922,5248,266,PERF
42255326650000,PI,IP,001,8,14000,14272,5248,272,PERF
42255326650000,PI,IP,001,9,14350,14622,5248,272,PERF
42255326650000,PI,IP,001,10,14700,14972,5248,272,PERF
42255326650000,PI,IP,001,11,15050,15322,5248,272,PERF
42255326650000,PI,IP,001,12,15400,15672,5248,272,PERF
42255326650000,PI,IP,001,13,15750,16022,5248,272,PERF
42255326650000,PI,IP,001,14,16100,16372,5248,272,PERF
42255326660000,PI,IP,001,1,11988,16719,5346,4731,PERF
42255326670000,PI,IP,001,1,13330,19531,6552,6201,PERF
42255326690000,PI,IP,001,1,12437,16627,5017,4190,PERF
42255326700000,PI,IP,001,1,12004,16807,5361,4803,PERF
42255326720000,PI,IP,001,1,12982,17934,5890,4952,PERF
42255326730000,PI,IP,001,1,10783,13074,3119,2291,PERF
42255326780000,PI,IP,001,1,10725,16754,6375,6029,PERF
42255326790000,PI,IP,001,1,12300,16222,5378,3922,PERF
42255326800000,PI,IP,001,1,11673,16921,,5248,PERF
42255326810000,PI,IP,001,1,11683,16549,,4866,PERF
42255326840000,PI,IP,001,1,12003,16489,6125,4486,PERF
42255326850000,PI,IP,001,1,12902,18511,6365,5609,PERF
42255326870000,PI,IP,001,1,11850,11910,6056,60,PERF
42255326870000,PI,IP,001,2,11975,12212,6056,237,PERF
42255326870000,PI,IP,001,3,12260,12594,6056,334,PERF
42255326870000,PI,IP,001,4,12668,13002,6056,334,PERF
42255326870000,PI,IP,001,5,13080,13352,6056,272,PERF
42255326870000,PI,IP,001,6,13445,13747,6056,302,PERF
42255326870000,PI,IP,001,7,13825,14097,6056,272,PERF
42255326870000,PI,IP,001,8,14175,14447,6056,272,PERF
42255326870000,PI,IP,001,9,14525,14797,6056,272,PERF
42255326870000,PI,IP,001,10,14875,15147,6056,272,PERF
42255326870000,PI,IP,001,11,15225,15497,6056,272,PERF
42255326870000,PI,IP,001,12,15575,15847,6056,272,PERF
42255326870000,PI,IP,001,13,15925,16197,6056,272,PERF
42255326870000,PI,IP,001,14,16275,16547,6056,272,PERF
42255326870000,PI,IP,001,15,16625,16897,6056,272,PERF
42255326870000,PI,IP,001,16,16975,17247,6056,272,PERF
42255326870000,PI,IP,001,17,17325,17593,6056,268,PERF
42255326900000,PI,IP,001,1,10700,14350,4904,3650,PERF
42255326910000,PI,IP,001,1,11955,12226,6136,271,PERF
42255326910000,PI,IP,001,2,12307,12594,6136,287,PERF
42255326910000,PI,IP,001,3,12671,12962,6136,291,PERF
42255326910000,PI,IP,001,4,13039,13330,6136,291,PERF
42255326910000,PI,IP,001,5,13407,13698,6136,291,PERF
42255326910000,PI,IP,001,6,13775,14066,6136,291,PERF
42255326910000,PI,IP,001,7,14143,14435,6136,292,PERF
42255326910000,PI,IP,001,8,14511,14802,6136,291,PERF
42255326910000,PI,IP,001,9,14879,15170,6136,291,PERF
42255326910000,PI,IP,001,10,15248,15538,6136,290,PERF
42255326910000,PI,IP,001,11,15615,15907,6136,292,PERF
42255326910000,PI,IP,001,12,15983,16274,6136,291,PERF
42255326910000,PI,IP,001,13,16351,16642,6136,291,PERF
42255326910000,PI,IP,001,14,16719,17010,6136,291,PERF
42255326910000,PI,IP,001,15,17087,17378,6136,291,PERF
42255326910000,PI,IP,001,16,17455,17682,6136,227,PERF
42255326920000,PI,IP,001,1,10784,14359,4888,3575,PERF
42255326930000,PI,IP,001,1,12171,18506,7179,6335,PERF
42255326940000,PI,IP,001,1,12200,18335,7072,6135,PERF
42255326990000,PI,IP,001,1,13506,17591,4523,4085,PERF
42255327040000,PI,IP,001,1,11838,15852,4863,4014,PERF
42255327050000,PI,IP,001,1,12443,16633,4961,4190,PERF
42255327060000,PI,IP,001,1,11823,15983,4856,4160,PERF
42255327070000,PI,IP,001,1,12381,16288,4815,3907,PERF
42255327120000,PI,IP,001,1,11888,17154,,5266,PERF
42255327140000,PI,IP,001,1,11700,17372,,5672,PERF
42255327270000,PI,IP,001,1,11894,16076,4693,4182,PERF
42255327290000,PI,IP,001,1,10966,11229,7086,263,PERF
42255327290000,PI,IP,001,2,11311,11577,7086,266,PERF
42255327290000,PI,IP,001,3,11654,11920,7086,266,PERF
42255327290000,PI,IP,001,4,11997,12268,7086,271,PERF
42255327290000,PI,IP,001,5,12350,12611,7086,261,PERF
42255327290000,PI,IP,001,6,12693,12964,7086,271,PERF
42255327290000,PI,IP,001,7,13036,13302,7086,266,PERF
42255327290000,PI,IP,001,8,13379,13655,7086,276,PERF
42255327290000,PI,IP,001,9,13732,14008,7086,276,PERF
42255327290000,PI,IP,001,10,14085,14336,7086,251,PERF
42255327290000,PI,IP,001,11,14438,14714,7086,276,PERF
42255327290000,PI,IP,001,12,14791,15067,7086,276,PERF
42255327290000,PI,IP,001,13,15144,15424,7086,280,PERF
42255327290000,PI,IP,001,14,15498,15773,7086,275,PERF
42255327290000,PI,IP,001,15,15847,16126,7086,279,PERF
42255327290000,PI,IP,001,16,16203,16479,7086,276,PERF
42255327290000,PI,IP,001,17,16556,16832,7086,276,PERF
42255327290000,PI,IP,001,18,16909,17185,7086,276,PERF
42255327290000,PI,IP,001,19,17262,17534,7086,272,PERF
42255327300000,PI,IP,001,1,12445,17465,5934,5020,PERF
42255327330000,PI,IP,001,1,11080,11376,4891,296,PERF
42255327330000,PI,IP,001,2,11453,11749,4891,296,PERF
42255327330000,PI,IP,001,3,11826,12119,4891,293,PERF
42255327330000,PI,IP,001,4,12199,12485,4891,286,PERF
42255327330000,PI,IP,001,5,12562,12848,4891,286,PERF
42255327330000,PI,IP,001,6,12925,13211,4891,286,PERF
42255327330000,PI,IP,001,7,13288,13580,4891,292,PERF
42255327330000,PI,IP,001,8,13651,13937,4891,286,PERF
42255327330000,PI,IP,001,9,14019,14300,4891,281,PERF
42255327330000,PI,IP,001,10,14377,14663,4891,286,PERF
42255327330000,PI,IP,001,11,14740,15026,4891,286,PERF
42255327330000,PI,IP,001,12,15103,15375,4891,272,PERF
42255327400000,PI,IP,001,1,12356,16756,5246,4400,PERF
42255327410000,PI,IP,001,1,12574,16986,5196,4412,PERF
42255327470000,PI,IP,001,1,10525,16750,6732,6225,PERF
42255327480000,PI,IP,001,1,12319,16857,5338,4538,PERF
42255327500000,PI,IP,001,1,12140,16890,,4750,PERF
42255327530000,PI,IP,001,1,12951,18062,5320,5111,PERF
42255327570000,PI,IP,001,1,11963,16745,5280,4782,PERF
42255327600000,PI,IP,001,1,11464,16887,5407,5423,PERF
42255327640000,PI,IP,001,1,13432,17103,3974,3671,PERF
42255327650000,PI,IP,001,1,11416,16810,5998,5394,PERF
42255327660000,PI,IP,001,1,11326,16169,5972,4843,PERF
42255327730000,PI,IP,001,1,10464,15420,5310,4956,PERF
42255327750000,PI,IP,001,1,13191,17252,4477,4061,PERF
42255327760000,PI,IP,001,1,11910,16002,4682,4092,PERF
42255327780000,PI,IP,001,1,12745,17600,5772,4855,PERF
42255327860000,PI,IP,001,1,12453,17107,5532,4654,PERF
42255327930000,PI,IP,001,1,10956,16446,5686,5490,PERF
42255327990000,PI,IP,001,1,11211,16494,5745,5283,PERF
42255328000000,PI,IP,001,1,11191,16551,5837,5360,PERF
42255328020000,PI,IP,001,1,10732,10943,6187,211,PERF
42255328020000,PI,IP,001,2,11003,11214,6187,211,PERF
42255328020000,PI,IP,001,3,11274,11485,6187,211,PERF
42255328020000,PI,IP,001,4,11546,11756,6187,210,PERF
42255328020000,PI,IP,001,5,11816,12027,6187,211,PERF
42255328020000,PI,IP,001,6,12087,12299,6187,212,PERF
42255328020000,PI,IP,001,7,12359,12570,6187,211,PERF
42255328020000,PI,IP,001,8,12630,12841,6187,211,PERF
42255328020000,PI,IP,001,9,12901,13112,6187,211,PERF
42255328020000,PI,IP,001,10,13256,13383,6187,127,PERF
42255328020000,PI,IP,001,11,13443,13654,6187,211,PERF
42255328020000,PI,IP,001,12,13714,13925,6187,211,PERF
42255328020000,PI,IP,001,13,13985,14196,6187,211,PERF
42255328020000,PI,IP,001,14,14256,14467,6187,211,PERF
42255328020000,PI,IP,001,15,14527,14738,6187,211,PERF
42255328020000,PI,IP,001,16,14798,15010,6187,212,PERF
42255328020000,PI,IP,001,17,15070,15281,6187,211,PERF
42255328020000,PI,IP,001,18,15341,15552,6187,211,PERF
42255328020000,PI,IP,001,19,15612,15823,6187,211,PERF
42255328020000,PI,IP,001,20,15883,16094,6187,211,PERF
42255328020000,PI,IP,001,21,16163,16365,6187,202,PERF
42255328030000,PI,IP,001,1,10780,10993,6228,213,PERF
42255328030000,PI,IP,001,2,11053,11266,6228,213,PERF
42255328030000,PI,IP,001,3,11326,11539,6228,213,PERF
42255328030000,PI,IP,001,4,11599,11812,6228,213,PERF
42255328030000,PI,IP,001,5,11872,12085,6228,213,PERF
42255328030000,PI,IP,001,6,12145,12358,6228,213,PERF
42255328030000,PI,IP,001,7,12418,12631,6228,213,PERF
42255328030000,PI,IP,001,8,12691,12904,6228,213,PERF
42255328030000,PI,IP,001,9,12964,13177,6228,213,PERF
42255328030000,PI,IP,001,10,13237,13450,6228,213,PERF
42255328030000,PI,IP,001,11,13510,13723,6228,213,PERF
42255328030000,PI,IP,001,12,13783,13996,6228,213,PERF
42255328030000,PI,IP,001,13,14056,14269,6228,213,PERF
42255328030000,PI,IP,001,14,14329,14532,6228,203,PERF
42255328030000,PI,IP,001,15,14602,14815,6228,213,PERF
42255328030000,PI,IP,001,16,14875,15088,6228,213,PERF
42255328030000,PI,IP,001,17,15148,15361,6228,213,PERF
42255328030000,PI,IP,001,18,15421,15634,6228,213,PERF
42255328030000,PI,IP,001,19,15694,15907,6228,213,PERF
42255328030000,PI,IP,001,20,15967,16180,6228,213,PERF
42255328030000,PI,IP,001,21,16250,16453,6228,203,PERF
42255328040000,PI,IP,001,1,12315,17176,5675,4861,PERF
42255328050000,PI,IP,001,1,13097,17323,4785,4226,PERF
42255328080000,PI,IP,001,1,11060,16488,6454,5428,PERF
42255328190000,PI,IP,001,1,10210,15365,5617,5155,PERF
42255328210000,PI,IP,001,1,13185,18858,,5673,PERF
42255328280000,PI,IP,001,1,12453,17314,5537,4861,PERF
42255328300000,PI,IP,001,1,11036,16271,5928,5235,PERF
42255328310100,PI,IP,001,1,11054,16309,5519,5255,PERF
42255328340000,PI,PT,001,1,13386,18555,,5169,PERF
42255328350000,PI,IP,001,1,12584,18940,7094,6356,PERF
42255328360000,PI,IP,001,1,11204,15271,4656,4067,PERF
42255328370000,PI,IP,001,1,12496,18590,7050,6094,PERF
42255328380000,PI,IP,001,1,11192,15209,4677,4017,PERF
42255328400000,PI,IP,001,1,11288,11463,6254,175,PERF
42255328400000,PI,IP,001,2,11533,11709,6254,176,PERF
42255328400000,PI,IP,001,3,11779,11954,6254,175,PERF
42255328400000,PI,IP,001,4,12024,12203,6254,179,PERF
42255328400000,PI,IP,001,5,12269,12440,6254,171,PERF
42255328400000,PI,IP,001,6,12520,12690,6254,170,PERF
42255328400000,PI,IP,001,7,12760,12930,6254,170,PERF
42255328400000,PI,IP,001,8,13005,13181,6254,176,PERF
42255328400000,PI,IP,001,9,13251,13420,6254,169,PERF
42255328400000,PI,IP,001,10,13501,13671,6254,170,PERF
42255328400000,PI,IP,001,11,13741,13917,6254,176,PERF
42255328400000,PI,IP,001,12,13987,14162,6254,175,PERF
42255328400000,PI,IP,001,13,14249,14407,6254,158,PERF
42255328400000,PI,IP,001,14,14477,14653,6254,176,PERF
42255328400000,PI,IP,001,15,14723,14900,6254,177,PERF
42255328400000,PI,IP,001,16,14968,15143,6254,175,PERF
42255328400000,PI,IP,001,17,15210,15389,6254,179,PERF
42255328400000,PI,IP,001,18,15459,15626,6254,167,PERF
42255328400000,PI,IP,001,19,15704,15879,6254,175,PERF
42255328400000,PI,IP,001,20,15949,16125,6254,176,PERF
42255328400000,PI,IP,001,21,16195,16365,6254,170,PERF
42255328400000,PI,IP,001,22,16450,16615,6254,165,PERF
42255328400000,PI,IP,001,23,16685,16861,6254,176,PERF
42255328400000,PI,IP,001,24,16969,17098,6254,129,PERF
42255328420000,PI,IP,001,1,12121,17922,6705,5801,PERF
42255328430000,PI,IP,001,1,12181,17530,6049,5349,PERF
42255328440000,PI,IP,001,1,10342,15985,6280,5643,PERF
42255328460000,PI,IP,001,1,12108,17883,6682,5775,PERF
42255328480000,PI,IP,001,1,10765,15650,5598,4885,PERF
42255328490000,PI,IP,001,1,10732,14715,4541,3983,PERF
42255328510000,PI,IP,001,1,13300,18101,6163,4801,PERF
42255328520000,PI,IP,001,1,13350,18231,6439,4881,PERF
42255328530000,PI,IP,001,1,11160,15617,5354,4457,PERF
42255328570000,PI,IP,001,1,8453,13800,5836,5347,PERF
42479420710000,PI,IP,001,1,9282,13840,5451,4558,PERF
42479420730000,PI,IP,001,1,9286,14016,5586,4730,PERF
42479420790000,PI,IP,001,1,9436,14836,6582,5400,PERF
42479420800000,PI,IP,001,1,9254,14958,6361,5704,PERF
42479420810000,PI,IP,001,1,9441,14809,6281,5368,PERF
42479420850000,PI,IP,001,1,9465,14786,6395,5321,PERF
42479420860000,PI,IP,001,1,9389,14597,6181,5208,PERF
42479420870000,PI,IP,001,1,9376,14816,6069,5440,PERF
42479420910000,PI,IP,001,1,9921,15123,5685,5202,PERF
42479421180000,PI,IP,001,1,9094,13951,5614,4857,PERF
42479421540000,PI,IP,001,1,8864,15235,7216,6371,PERF
42479421550000,PI,IP,001,1,8924,15974,,7050,PERF
42479421560000,PI,IP,001,1,8912,16420,7574,7508,PERF
42479421750000,PI,IP,001,1,9660,14883,,5223,PERF
42479421760000,PI,IP,001,1,9666,14814,6473,5148,PERF
42297352010000,PI,IP,001,1,14176,19497,5453,5321,PERF
42297352030000,PI,IP,001,1,12000,19149,7321,7149,PERF
42297352090000,PI,IP,001,1,11493,14604,3849,3111,PERF
42297352140000,PI,IP,001,1,14432,19163,4918,4731,PERF
42297352150000,PI,IP,001,1,13070,19111,6509,6041,PERF
42297352170000,PI,IP,001,1,13030,19191,6331,6161,PERF
42297352190100,PI,PT,001,1,14358,19109,,4751,PERF
42297352260000,PI,IP,001,1,13480,18401,5747,4921,PERF
42297352270000,PI,IP,001,1,13150,16901,3876,3751,PERF
42297352280000,PI,IP,001,1,13240,18051,5348,4811,PERF
42297352290000,PI,IP,001,1,13430,18551,6137,5121,PERF
42297352300000,PI,IP,001,1,12980,18601,5763,5621,PERF
42297352360000,PI,IP,001,1,14350,19249,5086,4899,PERF
42297352400000,PI,IP,001,1,13372,18101,5333,4729,PERF
42297352410000,PI,IP,001,1,11317,16277,5043,4960,PERF
42297352580000,PI,IP,001,1,11817,15267,4088,3450,PERF
42297352600000,PI,IP,001,1,11433,16933,6103,5500,PERF
42297352610100,PI,IP,001,1,11746,19075,,7329,PERF
42297352620000,PI,IP,001,1,11318,15500,4493,4182,PERF
42297352630000,PI,IP,001,1,11838,15016,4240,3178,PERF
42297352640000,PI,IP,001,1,11898,17157,5423,5259,COMB
42297352770000,PI,IP,001,1,12800,17921,5473,5121,PERF
42297352830000,PI,IP,001,1,11338,17659,6628,6321,PERF
42297352860000,PI,IP,001,1,11426,14700,3612,3274,PERF
42297352870000,PI,IP,001,1,11767,15842,,4075,PERF
42297352880000,PI,IP,001,1,11505,15627,4912,4122,PERF
42297352890000,PI,IP,001,1,12940,18801,6224,5861,PERF
42297352990000,PI,IP,001,1,13240,19401,6292,6161,PERF
42163335200000,PI,IP,001,1,7066,7277,5856,211,PERF
42163335200000,PI,IP,001,2,7376,7587,5856,211,PERF
42163335200000,PI,IP,001,3,7686,7897,5856,211,PERF
42163335200000,PI,IP,001,4,7996,8207,5856,211,PERF
42163335200000,PI,IP,001,5,8306,8517,5856,211,PERF
42163335200000,PI,IP,001,6,8616,8827,5856,211,PERF
42163335200000,PI,IP,001,7,8926,9137,5856,211,PERF
42163335200000,PI,IP,001,8,9236,9447,5856,211,PERF
42163335200000,PI,IP,001,9,9546,9757,5856,211,PERF
42163335200000,PI,IP,001,10,9856,10067,5856,211,PERF
42163335200000,PI,IP,001,11,10166,10377,5856,211,PERF
42163335200000,PI,IP,001,12,10476,10687,5856,211,PERF
42163335200000,PI,IP,001,13,10786,10997,5856,211,PERF
42163335200000,PI,IP,001,14,11230,11441,5856,211,PERF
42163335200000,PI,IP,001,15,11476,11617,5856,141,PERF
42163335200000,PI,IP,001,16,11716,11927,5856,211,PERF
42163335200000,PI,IP,001,17,12026,12236,5856,210,PERF
42163335210000,PI,IP,001,1,7510,7721,5960,211,PERF
42163335210000,PI,IP,001,2,7820,8031,5960,211,PERF
42163335210000,PI,IP,001,3,8130,8341,5960,211,PERF
42163335210000,PI,IP,001,4,8440,8651,5960,211,PERF
42163335210000,PI,IP,001,5,8750,8961,5960,211,PERF
42163335210000,PI,IP,001,6,9060,9271,5960,211,PERF
42163335210000,PI,IP,001,7,9370,9581,5960,211,PERF
42163335210000,PI,IP,001,8,9680,9861,5960,181,PERF
42163335210000,PI,IP,001,9,9990,10201,5960,211,PERF
42163335210000,PI,IP,001,10,10300,10511,5960,211,PERF
42163335210000,PI,IP,001,11,10610,10821,5960,211,PERF
42163335210000,PI,IP,001,12,10920,11131,5960,211,PERF
42163335210000,PI,IP,001,13,11230,11441,5960,211,PERF
42163335210000,PI,IP,001,14,11540,11751,5960,211,PERF
42163335210000,PI,IP,001,15,11850,12061,5960,211,PERF
42163335210000,PI,IP,001,16,12160,12371,5960,211,PERF
42163335210000,PI,IP,001,17,12470,12651,5960,181,PERF
42163335220000,PI,IP,001,1,6399,14316,8297,7917,PERF
42163335280000,PI,IP,001,1,7640,7851,5444,211,PERF
42163335280000,PI,IP,001,2,7950,8160,5444,210,PERF
42163335280000,PI,IP,001,3,8260,8471,5444,211,PERF
42163335280000,PI,IP,001,4,8570,8781,5444,211,PERF
42163335280000,PI,IP,001,5,8880,9091,5444,211,PERF
42163335280000,PI,IP,001,6,9190,9401,5444,211,PERF
42163335280000,PI,IP,001,7,9500,9712,5444,212,PERF
42163335280000,PI,IP,001,8,9810,10029,5444,219,PERF
42163335280000,PI,IP,001,9,10120,10331,5444,211,PERF
42163335280000,PI,IP,001,10,10430,10641,5444,211,PERF
42163335280000,PI,IP,001,11,10740,10951,5444,211,PERF
42163335280000,PI,IP,001,12,11050,11261,5444,211,PERF
42163335280000,PI,IP,001,13,11360,11571,5444,211,PERF
42163335280000,PI,IP,001,14,11670,11881,5444,211,PERF
42163335280000,PI,IP,001,15,11980,12161,5444,181,PERF
42163335280000,PI,IP,001,16,12290,12501,5444,211,PERF
42163335290000,PI,IP,001,1,8137,13920,,5783,PERF
42163335330000,PI,IP,001,1,8869,12567,5206,3698,PERF
42163335420100,PI,IP,001,1,6791,13031,7122,6240,PERF
42163335440000,PI,IP,001,1,8582,14592,6500,6010,PERF
42163335470000,PI,IP,001,1,8596,14558,6508,5962,PERF
42163335490000,PI,IP,001,1,8350,13535,6164,5185,PERF
42163335510000,PI,IP,001,1,7855,10795,3159,2940,PERF
42163335520000,PI,IP,001,1,7830,12929,5549,5099,PERF
42163335550000,PI,IP,001,1,8440,11682,5050,3242,PERF
42163335580000,PI,IP,001,1,8107,14181,6764,6074,PERF
42163335610000,PI,IP,001,1,7935,8076,8019,141,PERF
42163335610000,PI,IP,001,2,8135,8276,8019,141,PERF
42163335610000,PI,IP,001,3,8335,8476,8019,141,PERF
42163335610000,PI,IP,001,4,8535,8676,8019,141,PERF
42163335610000,PI,IP,001,5,8735,8876,8019,141,PERF
42163335610000,PI,IP,001,6,8935,9076,8019,141,PERF
42163335610000,PI,IP,001,7,9135,9276,8019,141,PERF
42163335610000,PI,IP,001,8,9335,9476,8019,141,PERF
42163335610000,PI,IP,001,9,9535,9676,8019,141,PERF
42163335610000,PI,IP,001,10,9735,9876,8019,141,PERF
42163335610000,PI,IP,001,11,9935,10076,8019,141,PERF
42163335610000,PI,IP,001,12,10135,10276,8019,141,PERF
42163335610000,PI,IP,001,13,10335,10476,8019,141,PERF
42163335610000,PI,IP,001,14,10535,10676,8019,141,PERF
42163335610000,PI,IP,001,15,10735,10876,8019,141,PERF
42163335610000,PI,IP,001,16,10935,11076,8019,141,PERF
42163335610000,PI,IP,001,17,11135,11276,8019,141,PERF
42163335610000,PI,IP,001,18,11335,11476,8019,141,PERF
42163335610000,PI,IP,001,19,11535,11676,8019,141,PERF
42163335610000,PI,IP,001,20,11735,11876,8019,141,PERF
42163335610000,PI,IP,001,21,11935,12076,8019,141,PERF
42163335610000,PI,IP,001,22,12135,12276,8019,141,PERF
42163335610000,PI,IP,001,23,12335,12476,8019,141,PERF
42163335610000,PI,IP,001,24,12535,12676,8019,141,PERF
42163335610000,PI,IP,001,25,12735,12876,8019,141,PERF
42163335610000,PI,IP,001,26,13335,13476,8019,141,PERF
42163335610000,PI,IP,001,27,13535,13676,8019,141,PERF
42163335610000,PI,IP,001,28,13735,13876,8019,141,PERF
42163335610000,PI,IP,001,29,13935,14076,8019,141,PERF
42163335610000,PI,IP,001,30,14135,14276,8019,141,PERF
42163335610000,PI,IP,001,31,14335,14476,8019,141,PERF
42163335610000,PI,IP,001,32,14535,14676,8019,141,PERF
42163335610000,PI,IP,001,33,14735,14876,8019,141,PERF
42163335610000,PI,IP,001,34,14935,15076,8019,141,PERF
42163335620000,PI,IP,001,1,7947,8152,5085,205,PERF
42163335620000,PI,IP,001,2,8227,8432,5085,205,PERF
42163335620000,PI,IP,001,3,8512,8706,5085,194,PERF
42163335620000,PI,IP,001,4,8787,8992,5085,205,PERF
42163335620000,PI,IP,001,5,9067,9272,5085,205,PERF
42163335620000,PI,IP,001,6,9347,9552,5085,205,PERF
42163335620000,PI,IP,001,7,9627,9832,5085,205,PERF
42163335620000,PI,IP,001,8,9907,10112,5085,205,PERF
42163335620000,PI,IP,001,9,10187,10381,5085,194,PERF
42163335620000,PI,IP,001,10,10467,10672,5085,205,PERF
42163335620000,PI,IP,001,11,10747,10952,5085,205,PERF
42163335620000,PI,IP,001,12,11027,11232,5085,205,PERF
42163335620000,PI,IP,001,13,11307,11512,5085,205,PERF
42163335620000,PI,IP,001,14,11587,11795,5085,208,PERF
42163335620000,PI,IP,001,15,11867,12072,5085,205,PERF
42163335620000,PI,IP,001,16,12147,12352,5085,205,PERF
42163335640000,PI,IP,001,1,7941,8146,5025,205,PERF
42163335640000,PI,IP,001,2,8221,8426,5025,205,PERF
42163335640000,PI,IP,001,3,8510,8706,5025,196,PERF
42163335640000,PI,IP,001,4,8790,8981,5025,191,PERF
42163335640000,PI,IP,001,5,9061,9266,5025,205,PERF
42163335640000,PI,IP,001,6,9348,9546,5025,198,PERF
42163335640000,PI,IP,001,7,9672,9826,5025,154,PERF
42163335640000,PI,IP,001,8,9901,10106,5025,205,PERF
42163335640000,PI,IP,001,9,10181,10386,5025,205,PERF
42163335640000,PI,IP,001,10,10461,10666,5025,205,PERF
42163335640000,PI,IP,001,11,10744,10946,5025,202,PERF
42163335640000,PI,IP,001,12,11026,11230,5025,204,PERF
42163335640000,PI,IP,001,13,11309,11504,5025,195,PERF
42163335640000,PI,IP,001,14,11585,11791,5025,206,PERF
42163335640000,PI,IP,001,15,11861,12066,5025,205,PERF
42163335680000,PI,IP,001,1,7588,7789,5963,201,PERF
42163335680000,PI,IP,001,2,7869,8060,5963,191,PERF
42163335680000,PI,IP,001,3,8150,8351,5963,201,PERF
42163335680000,PI,IP,001,4,8431,8632,5963,201,PERF
42163335680000,PI,IP,001,5,8712,8913,5963,201,PERF
42163335680000,PI,IP,001,6,8995,9194,5963,199,PERF
42163335680000,PI,IP,001,7,9274,9475,5963,201,PERF
42163335680000,PI,IP,001,8,9555,9756,5963,201,PERF
42163335680000,PI,IP,001,9,9836,10037,5963,201,PERF
42163335680000,PI,IP,001,10,10117,10318,5963,201,PERF
42163335680000,PI,IP,001,11,10398,10599,5963,201,PERF
42163335680000,PI,IP,001,12,10679,10880,5963,201,PERF
42163335680000,PI,IP,001,13,10960,11161,5963,201,PERF
42163335680000,PI,IP,001,14,11241,11442,5963,201,PERF
42163335680000,PI,IP,001,15,11522,11723,5963,201,PERF
42163335680000,PI,IP,001,16,11803,12004,5963,201,PERF
42163335680000,PI,IP,001,17,12084,12285,5963,201,PERF
42163335770000,PI,IP,001,1,7786,7991,7176,205,PERF
42163335770000,PI,IP,001,2,8071,8276,7176,205,PERF
42163335770000,PI,IP,001,3,8356,8561,7176,205,PERF
42163335770000,PI,IP,001,4,8641,8846,7176,205,PERF
42163335770000,PI,IP,001,5,8926,9128,7176,202,PERF
42163335770000,PI,IP,001,6,9211,9411,7176,200,PERF
42163335770000,PI,IP,001,7,9496,9701,7176,205,PERF
42163335770000,PI,IP,001,8,9785,9986,7176,201,PERF
42163335770000,PI,IP,001,9,10066,10271,7176,205,PERF
42163335770000,PI,IP,001,10,10351,10556,7176,205,PERF
42163335770000,PI,IP,001,11,10636,10841,7176,205,PERF
42163335770000,PI,IP,001,12,10921,11126,7176,205,PERF
42163335770000,PI,IP,001,13,11222,11422,7176,200,PERF
42163335770000,PI,IP,001,14,11503,11704,7176,201,PERF
42163335770000,PI,IP,001,15,11784,11985,7176,201,PERF
42163335770000,PI,IP,001,16,12061,12266,7176,205,PERF
42163335770000,PI,IP,001,17,12699,12909,7176,210,PERF
42163335770000,PI,IP,001,18,13005,13212,7176,207,PERF
42163335770000,PI,IP,001,19,13400,13401,7176,1,PERF
42163335770000,PI,IP,001,20,13678,13679,7176,1,PERF
42163335770000,PI,IP,001,21,13959,13960,7176,1,PERF
42163335790000,PI,IP,001,1,10736,12191,5138,1455,PERF
42163335800000,PI,IP,001,1,7923,11436,4969,3513,PERF
42163335810000,PI,IP,001,1,7206,11490,,4284,PERF
42163335820000,PI,IP,001,1,5948,5968,,20,PERF
42163335860000,PI,IP,001,1,6610,11398,5585,4788,PERF
42163335900000,PI,IP,001,1,7916,12284,5169,4368,PERF
42163335940000,PI,IP,001,1,8489,13077,,4588,PERF
42163335960000,PI,IP,001,1,7760,11221,,3461,PERF
42163335970000,PI,IP,001,1,6620,14205,7858,7585,PERF
42163336020000,PI,IP,001,1,8384,13661,5648,5277,PERF
42163336090000,PI,IP,001,1,8710,13800,6139,5090,PERF
42163336170000,PI,IP,001,1,8130,13152,5924,5022,PERF
42163336210000,PI,IP,001,1,10790,13712,5863,2922,PERF
42163336570000,PI,IP,001,1,8653,15132,7299,6479,PERF
42163336580000,PI,IP,001,1,8355,13607,6053,5252,PERF
42163336770000,PI,IP,001,1,8253,14204,6805,5951,PERF
42013344900000,PI,IP,001,1,10524,16380,6455,5856,PERF
42013344910000,PI,IP,001,1,11338,11550,4661,212,PERF
42013344910000,PI,IP,001,2,11628,11840,4661,212,PERF
42013344910000,PI,IP,001,3,11918,12100,4661,182,PERF
42013344910000,PI,IP,001,4,12168,12350,4661,182,PERF
42013344910000,PI,IP,001,5,12418,12600,4661,182,PERF
42013344910000,PI,IP,001,6,12668,12850,4661,182,PERF
42013344910000,PI,IP,001,7,12918,13100,4661,182,PERF
42013344910000,PI,IP,001,8,13168,13345,4661,177,PERF
42013344910000,PI,IP,001,9,13418,13600,4661,182,PERF
42013344910000,PI,IP,001,10,13668,13848,4661,180,PERF
42013344910000,PI,IP,001,11,13918,14100,4661,182,PERF
42013344910000,PI,IP,001,12,14168,14347,4661,179,PERF
42013344910000,PI,IP,001,13,14418,14598,4661,180,PERF
42013344910000,PI,IP,001,14,14668,14845,4661,177,PERF
42013344910000,PI,IP,001,15,14968,15205,4661,237,PERF
42013344920000,PI,IP,001,1,10410,15683,5658,5273,PERF
42013344930000,PI,IP,001,1,7750,13168,6374,5418,PERF
42013344940000,PI,IP,001,1,9942,14165,5213,4223,PERF
42013344950000,PI,IP,001,1,10513,17307,7531,6794,PERF
42013344960000,PI,IP,001,1,10510,16994,7325,6484,PERF
42013344980000,PI,IP,001,1,8277,13178,5904,4901,PERF
42013345020000,PI,IP,001,1,9421,15876,6933,6455,PERF
42013345040000,PI,IP,001,1,10950,11150,6977,200,PERF
42013345040000,PI,IP,001,2,11200,11450,6977,250,PERF
42013345040000,PI,IP,001,3,11500,11750,6977,250,PERF
42013345040000,PI,IP,001,4,11800,12050,6977,250,PERF
42013345040000,PI,IP,001,5,12100,12350,6977,250,PERF
42013345040000,PI,IP,001,6,12400,12650,6977,250,PERF
42013345040000,PI,IP,001,7,12700,12950,6977,250,PERF
42013345040000,PI,IP,001,8,13000,13250,6977,250,PERF
42013345040000,PI,IP,001,9,13300,13550,6977,250,PERF
42013345040000,PI,IP,001,10,13600,13850,6977,250,PERF
42013345040000,PI,IP,001,11,14200,14450,6977,250,PERF
42013345040000,PI,IP,001,12,14500,14750,6977,250,PERF
42013345040000,PI,IP,001,13,14800,15050,6977,250,PERF
42013345040000,PI,IP,001,14,15100,15350,6977,250,PERF
42013345040000,PI,IP,001,15,15400,15650,6977,250,PERF
42013345040000,PI,IP,001,16,15700,15950,6977,250,PERF
42013345040000,PI,IP,001,17,16000,16250,6977,250,PERF
42013345040000,PI,IP,001,18,16300,16550,6977,250,PERF
42013345040000,PI,IP,001,19,16600,16850,6977,250,PERF
42013345040000,PI,IP,001,20,16900,17100,6977,200,PERF
42013345050100,PI,IP,001,1,11000,11200,4114,200,PERF
42013345050100,PI,IP,001,2,11250,11500,4114,250,PERF
42013345050100,PI,IP,001,3,11550,11800,4114,250,PERF
42013345050100,PI,IP,001,4,11850,12100,4114,250,PERF
42013345050100,PI,IP,001,5,12150,12400,4114,250,PERF
42013345050100,PI,IP,001,6,12450,12700,4114,250,PERF
42013345050100,PI,IP,001,7,12750,13000,4114,250,PERF
42013345050100,PI,IP,001,8,13050,13300,4114,250,PERF
42013345050100,PI,IP,001,9,13350,13600,4114,250,PERF
42013345050100,PI,IP,001,10,13650,13900,4114,250,PERF
42013345050100,PI,IP,001,11,13950,14200,4114,250,PERF
42013345060000,PI,IP,001,1,11316,11623,6364,307,PERF
42013345060000,PI,IP,001,2,11816,12020,6364,204,PERF
42013345060000,PI,IP,001,3,12109,12381,6364,272,PERF
42013345060000,PI,IP,001,4,12459,12731,6364,272,PERF
42013345060000,PI,IP,001,5,12809,13081,6364,272,PERF
42013345060000,PI,IP,001,6,13159,13431,6364,272,PERF
42013345060000,PI,IP,001,7,13509,13781,6364,272,PERF
42013345060000,PI,IP,001,8,13859,14131,6364,272,PERF
42013345060000,PI,IP,001,9,14209,14481,6364,272,PERF
42013345060000,PI,IP,001,10,14559,14831,6364,272,PERF
42013345060000,PI,IP,001,11,14909,15181,6364,272,PERF
42013345060000,PI,IP,001,12,15257,15529,6364,272,PERF
42013345060000,PI,IP,001,13,15609,15881,6364,272,PERF
42013345060000,PI,IP,001,14,15959,16231,6364,272,PERF
42013345060000,PI,IP,001,15,16309,16581,6364,272,PERF
42013345060000,PI,IP,001,16,16744,16916,6364,172,PERF
42013345070000,PI,IP,001,1,8970,16277,8436,7307,PERF
42013345080000,PI,IP,001,1,9977,14807,5600,4830,PERF
42013345090000,PI,IP,001,1,9723,14549,5533,4826,PERF
42013345100000,PI,IP,001,1,9894,16038,6943,6144,PERF
42013345120000,PI,IP,001,1,9902,14980,5587,5078,PERF
42013345140000,PI,IP,001,1,9161,15884,7284,6723,PERF
42013345180000,PI,IP,001,1,10529,16239,6301,5710,PERF
42013345200000,PI,IP,001,1,10630,14810,4847,4180,PERF
42013345210000,PI,IP,001,1,11247,11444,5048,197,PERF
42013345210000,PI,IP,001,2,11504,11671,5048,167,PERF
42013345210000,PI,IP,001,3,11761,11958,5048,197,PERF
42013345210000,PI,IP,001,4,12018,12215,5048,197,PERF
42013345210000,PI,IP,001,5,12275,12472,5048,197,PERF
42013345210000,PI,IP,001,6,12532,12729,5048,197,PERF
42013345210000,PI,IP,001,7,12789,12986,5048,197,PERF
42013345210000,PI,IP,001,8,13046,13243,5048,197,PERF
42013345210000,PI,IP,001,9,13303,13500,5048,197,PERF
42013345210000,PI,IP,001,10,13560,13757,5048,197,PERF
42013345210000,PI,IP,001,11,13816,14014,5048,198,PERF
42013345210000,PI,IP,001,12,14074,14271,5048,197,PERF
42013345210000,PI,IP,001,13,14331,14518,5048,187,PERF
42013345210000,PI,IP,001,14,14578,14651,5048,73,PERF
42013345210000,PI,IP,001,15,14711,14898,5048,187,PERF
42013345210000,PI,IP,001,16,14958,15145,5048,187,PERF
42013345210000,PI,IP,001,17,15205,15392,5048,187,PERF
42013345210000,PI,IP,001,18,15450,15722,5048,272,PERF
42013345220000,PI,IP,001,1,11202,16245,5819,5043,PERF
42013345230000,PI,IP,001,1,10915,11177,5357,262,PERF
42013345230000,PI,IP,001,2,11245,11517,5357,272,PERF
42013345230000,PI,IP,001,3,11585,11887,5357,302,PERF
42013345230000,PI,IP,001,4,11925,12197,5357,272,PERF
42013345230000,PI,IP,001,5,12265,12537,5357,272,PERF
42013345230000,PI,IP,001,6,12605,12877,5357,272,PERF
42013345230000,PI,IP,001,7,12945,13212,5357,267,PERF
42013345230000,PI,IP,001,8,13285,13557,5357,272,PERF
42013345230000,PI,IP,001,9,13625,13897,5357,272,PERF
42013345230000,PI,IP,001,10,13965,14147,5357,182,PERF
42013345230000,PI,IP,001,11,14305,14577,5357,272,PERF
42013345230000,PI,IP,001,12,14645,14917,5357,272,PERF
42013345230000,PI,IP,001,13,14985,15257,5357,272,PERF
42013345230000,PI,IP,001,14,15325,15597,5357,272,PERF
42013345240000,PI,IP,001,1,11232,16266,5892,5034,PERF
42013345250000,PI,IP,001,1,11277,11516,6764,239,PERF
42013345250000,PI,IP,001,2,11584,11856,6764,272,PERF
42013345250000,PI,IP,001,3,11934,12204,6764,270,PERF
42013345250000,PI,IP,001,4,12284,12556,6764,272,PERF
42013345250000,PI,IP,001,5,12634,12906,6764,272,PERF
42013345250000,PI,IP,001,6,12984,13256,6764,272,PERF
42013345250000,PI,IP,001,7,13334,13606,6764,272,PERF
42013345250000,PI,IP,001,8,13686,13952,6764,266,PERF
42013345250000,PI,IP,001,9,14034,14306,6764,272,PERF
42013345250000,PI,IP,001,10,14384,14656,6764,272,PERF
42013345250000,PI,IP,001,11,14734,15006,6764,272,PERF
42013345250000,PI,IP,001,12,15084,15356,6764,272,PERF
42013345250000,PI,IP,001,13,15434,15706,6764,272,PERF
42013345250000,PI,IP,001,14,15790,16056,6764,266,PERF
42013345250000,PI,IP,001,15,16134,16406,6764,272,PERF
42013345250000,PI,IP,001,16,16484,16756,6764,272,PERF
42013345250000,PI,IP,001,17,16834,17106,6764,272,PERF
42013345250000,PI,IP,001,18,17124,17396,6764,272,PERF
42013345260000,PI,IP,001,1,11190,11462,6506,272,PERF
42013345260000,PI,IP,001,2,11548,11820,6506,272,PERF
42013345260000,PI,IP,001,3,11906,12178,6506,272,PERF
42013345260000,PI,IP,001,4,12268,12536,6506,268,PERF
42013345260000,PI,IP,001,5,12622,12894,6506,272,PERF
42013345260000,PI,IP,001,6,12980,13252,6506,272,PERF
42013345260000,PI,IP,001,7,13338,13610,6506,272,PERF
42013345260000,PI,IP,001,8,13696,13968,6506,272,PERF
42013345260000,PI,IP,001,9,14054,14326,6506,272,PERF
42013345260000,PI,IP,001,10,14412,14684,6506,272,PERF
42013345260000,PI,IP,001,11,14770,15042,6506,272,PERF
42013345260000,PI,IP,001,12,15128,15340,6506,212,PERF
42013345260000,PI,IP,001,13,15486,15758,6506,272,PERF
42013345260000,PI,IP,001,14,15844,16116,6506,272,PERF
42013345260000,PI,IP,001,15,16202,16474,6506,272,PERF
42013345260000,PI,IP,001,16,16560,16832,6506,272,PERF
42013345260000,PI,IP,001,17,16918,17190,6506,272,PERF
42013345270000,PI,IP,001,1,9630,14517,5590,4887,PERF
42013345280000,PI,IP,001,1,10775,11047,5436,272,PERF
42013345280000,PI,IP,001,2,11125,11397,5436,272,PERF
42013345280000,PI,IP,001,3,11475,11757,5436,282,PERF
42013345280000,PI,IP,001,4,11825,12097,5436,272,PERF
42013345280000,PI,IP,001,5,12172,12447,5436,275,PERF
42013345280000,PI,IP,001,6,12525,12797,5436,272,PERF
42013345280000,PI,IP,001,7,12875,13147,5436,272,PERF
42013345280000,PI,IP,001,8,13225,13497,5436,272,PERF
42013345280000,PI,IP,001,9,13578,13850,5436,272,PERF
42013345280000,PI,IP,001,10,13925,14197,5436,272,PERF
42013345280000,PI,IP,001,11,14275,14547,5436,272,PERF
42013345280000,PI,IP,001,12,14625,14900,5436,275,PERF
42013345280000,PI,IP,001,13,14975,15247,5436,272,PERF
42013345280000,PI,IP,001,14,15325,15597,5436,272,PERF
42013345280000,PI,IP,001,15,15677,15947,5436,270,PERF
42013345290000,PI,IP,001,1,11317,11592,6176,275,PERF
42013345290000,PI,IP,001,2,11670,11938,6176,268,PERF
42013345290000,PI,IP,001,3,12023,12295,6176,272,PERF
42013345290000,PI,IP,001,4,12374,12648,6176,274,PERF
42013345290000,PI,IP,001,5,12727,13002,6176,275,PERF
42013345290000,PI,IP,001,6,13080,13534,6176,454,PERF
42013345290000,PI,IP,001,7,13628,13702,6176,74,PERF
42013345290000,PI,IP,001,8,13786,14060,6176,274,PERF
42013345290000,PI,IP,001,9,14139,14414,6176,275,PERF
42013345290000,PI,IP,001,10,14492,14766,6176,274,PERF
42013345290000,PI,IP,001,11,14845,15119,6176,274,PERF
42013345290000,PI,IP,001,12,15198,15472,6176,274,PERF
42013345290000,PI,IP,001,13,15555,15821,6176,266,PERF
42013345290000,PI,IP,001,14,15904,16178,6176,274,PERF
42013345290000,PI,IP,001,15,16257,16531,6176,274,PERF
42013345290000,PI,IP,001,16,16610,16790,6176,180,PERF
42013345300000,PI,IP,001,1,11430,11657,5269,227,PERF
42013345300000,PI,IP,001,2,11731,11958,5269,227,PERF
42013345300000,PI,IP,001,3,12032,12259,5269,227,PERF
42013345300000,PI,IP,001,4,12333,12560,5269,227,PERF
42013345300000,PI,IP,001,5,12634,12861,5269,227,PERF
42013345300000,PI,IP,001,6,12935,13162,5269,227,PERF
42013345300000,PI,IP,001,7,13236,13484,5269,248,PERF
42013345300000,PI,IP,001,8,13563,13811,5269,248,PERF
42013345300000,PI,IP,001,9,13890,14138,5269,248,PERF
42013345300000,PI,IP,001,10,14217,14465,5269,248,PERF
42013345300000,PI,IP,001,11,14544,14792,5269,248,PERF
42013345300000,PI,IP,001,12,14872,15113,5269,241,PERF
42013345300000,PI,IP,001,13,15191,15433,5269,242,PERF
42013345300000,PI,IP,001,14,15511,15753,5269,242,PERF
42013345300000,PI,IP,001,15,15831,16109,5269,278,PERF
42013345310000,PI,IP,001,1,11150,11407,5539,257,PERF
42013345310000,PI,IP,001,2,11485,11740,5539,255,PERF
42013345310000,PI,IP,001,3,11818,12075,5539,257,PERF
42013345310000,PI,IP,001,4,12153,12410,5539,257,PERF
42013345310000,PI,IP,001,5,12488,12745,5539,257,PERF
42013345310000,PI,IP,001,6,12823,13080,5539,257,PERF
42013345310000,PI,IP,001,7,13162,13415,5539,253,PERF
42013345310000,PI,IP,001,8,13493,13750,5539,257,PERF
42013345310000,PI,IP,001,9,13828,14085,5539,257,PERF
42013345310000,PI,IP,001,10,14163,14420,5539,257,PERF
42013345310000,PI,IP,001,11,14498,14745,5539,247,PERF
42013345310000,PI,IP,001,12,14833,15090,5539,257,PERF
42013345310000,PI,IP,001,13,15168,15425,5539,257,PERF
42013345310000,PI,IP,001,14,15503,15760,5539,257,PERF
42013345310000,PI,IP,001,15,15838,16110,5539,272,PERF
42013345320000,PI,IP,001,1,11479,11746,5855,267,PERF
42013345320000,PI,IP,001,2,11829,12099,5855,270,PERF
42013345320000,PI,IP,001,3,12177,12452,5855,275,PERF
42013345320000,PI,IP,001,4,12527,12799,5855,272,PERF
42013345320000,PI,IP,001,5,12877,13149,5855,272,PERF
42013345320000,PI,IP,001,6,13227,13499,5855,272,PERF
42013345320000,PI,IP,001,7,13577,13849,5855,272,PERF
42013345320000,PI,IP,001,8,13930,14199,5855,269,PERF
42013345320000,PI,IP,001,9,14277,14552,5855,275,PERF
42013345320000,PI,IP,001,10,14627,14809,5855,182,PERF
42013345320000,PI,IP,001,11,14977,15159,5855,182,PERF
42013345320000,PI,IP,001,12,15327,15599,5855,272,PERF
42013345320000,PI,IP,001,13,15677,15948,5855,271,PERF
42013345320000,PI,IP,001,14,16027,16298,5855,271,PERF
42013345320000,PI,IP,001,15,16375,16557,5855,182,PERF
42013345340000,PI,IP,001,1,11152,11418,5700,266,PERF
42013345340000,PI,IP,001,2,11496,11762,5700,266,PERF
42013345340000,PI,IP,001,3,11840,12106,5700,266,PERF
42013345340000,PI,IP,001,4,12184,12450,5700,266,PERF
42013345340000,PI,IP,001,5,12528,12794,5700,266,PERF
42013345340000,PI,IP,001,6,12872,13138,5700,266,PERF
42013345340000,PI,IP,001,7,13216,13482,5700,266,PERF
42013345340000,PI,IP,001,8,13560,13826,5700,266,PERF
42013345340000,PI,IP,001,9,13904,14170,5700,266,PERF
42013345340000,PI,IP,001,10,14248,14514,5700,266,PERF
42013345340000,PI,IP,001,11,14592,14858,5700,266,PERF
42013345340000,PI,IP,001,12,14936,15202,5700,266,PERF
42013345340000,PI,IP,001,13,15280,15546,5700,266,PERF
42013345340000,PI,IP,001,14,15624,15890,5700,266,PERF
42013345340000,PI,IP,001,15,15968,16223,5700,255,PERF
42013345380000,PI,IP,001,1,9850,15678,6517,5828,PERF
42013345390000,PI,IP,001,1,9621,15633,6655,6012,PERF
42013345400000,PI,IP,001,1,10072,15917,6432,5845,PERF
42013345410000,PI,IP,001,1,9469,14752,5885,5283,PERF
42013345420000,PI,IP,001,1,9960,15455,6638,5495,PERF
42013345430000,PI,IP,001,1,11945,12232,7616,287,PERF
42013345430000,PI,IP,001,2,12308,12595,7616,287,PERF
42013345430000,PI,IP,001,3,12671,12958,7616,287,PERF
42013345430000,PI,IP,001,4,13034,13327,7616,293,PERF
42013345430000,PI,IP,001,5,13400,13684,7616,284,PERF
42013345430000,PI,IP,001,6,13760,14047,7616,287,PERF
42013345430000,PI,IP,001,7,14486,14773,7616,287,PERF
42013345430000,PI,IP,001,8,14849,15136,7616,287,PERF
42013345430000,PI,IP,001,9,15212,15499,7616,287,PERF
42013345430000,PI,IP,001,10,15575,15862,7616,287,PERF
42013345430000,PI,IP,001,11,15938,16225,7616,287,PERF
42013345430000,PI,IP,001,12,16301,16588,7616,287,PERF
42013345430000,PI,IP,001,13,16664,16951,7616,287,PERF
42013345430000,PI,IP,001,14,17027,17314,7616,287,PERF
42013345430000,PI,IP,001,15,17390,17677,7616,287,PERF
42013345430000,PI,IP,001,16,17753,18040,7616,287,PERF
42013345430000,PI,IP,001,17,18118,18384,7616,266,PERF
42013345450000,PI,IP,001,1,11258,15035,4107,3777,PERF
42013345460000,PI,IP,001,1,10950,11200,6647,250,PERF
42013345460000,PI,IP,001,2,11250,11500,6647,250,PERF
42013345460000,PI,IP,001,3,11550,11800,6647,250,PERF
42013345460000,PI,IP,001,4,11850,12100,6647,250,PERF
42013345460000,PI,IP,001,5,12150,12400,6647,250,PERF
42013345460000,PI,IP,001,6,12450,12700,6647,250,PERF
42013345460000,PI,IP,001,7,12750,13000,6647,250,PERF
42013345460000,PI,IP,001,8,13050,13300,6647,250,PERF
42013345460000,PI,IP,001,9,13350,13600,6647,250,PERF
42013345460000,PI,IP,001,10,13650,13900,6647,250,PERF
42013345460000,PI,IP,001,11,13950,14200,6647,250,PERF
42013345460000,PI,IP,001,12,14250,14500,6647,250,PERF
42013345460000,PI,IP,001,13,14550,14800,6647,250,PERF
42013345460000,PI,IP,001,14,14850,15100,6647,250,PERF
42013345460000,PI,IP,001,15,15150,15400,6647,250,PERF
42013345460000,PI,IP,001,16,15450,15700,6647,250,PERF
42013345460000,PI,IP,001,17,15750,16000,6647,250,PERF
42013345460000,PI,IP,001,18,16050,16300,6647,250,PERF
42013345460000,PI,IP,001,19,16350,16600,6647,250,PERF
42013345460000,PI,IP,001,20,16650,16900,6647,250,PERF
42013345470000,PI,IP,001,1,9569,14979,6067,5410,PERF
42013345480000,PI,IP,001,1,9638,14893,5997,5255,PERF
42013345490000,PI,IP,001,1,10159,15371,5645,5212,PERF
42013345500000,PI,IP,001,1,8654,13502,5313,4848,PERF
42013345530000,PI,IP,001,1,9850,15872,6409,6022,PERF
42013345580000,PI,IP,001,1,10070,15730,6385,5660,PERF
42013345610000,PI,IP,001,1,10889,18341,8423,7452,PERF
42013345660000,PI,IP,001,1,11165,17489,6916,6324,PERF
42013345690000,PI,IP,001,1,11288,17422,6966,6134,PERF
42013345710000,PI,IP,001,1,9920,14744,5524,4824,PERF
42013345720000,PI,IP,001,1,9960,15938,6705,5978,PERF
42013345730000,PI,IP,001,1,10180,15707,5886,5527,PERF
42013345750000,PI,IP,001,1,11234,16482,5857,5248,PERF
42013345760000,PI,IP,001,1,11352,17421,6973,6069,PERF
42013345770000,PI,IP,001,1,11324,17490,6904,6166,PERF
42013345820000,PI,IP,001,1,9814,14087,5757,4273,PERF
42013345840000,PI,IP,001,1,10176,16828,7208,6652,PERF
42013345860000,PI,IP,001,1,10900,11150,6641,250,PERF
42013345860000,PI,IP,001,2,11200,11450,6641,250,PERF
42013345860000,PI,IP,001,3,11500,11750,6641,250,PERF
42013345860000,PI,IP,001,4,11800,12050,6641,250,PERF
42013345860000,PI,IP,001,5,12100,12350,6641,250,PERF
42013345860000,PI,IP,001,6,12400,12650,6641,250,PERF
42013345860000,PI,IP,001,7,12700,12950,6641,250,PERF
42013345860000,PI,IP,001,8,13000,13250,6641,250,PERF
42013345860000,PI,IP,001,9,13300,13550,6641,250,PERF
42013345860000,PI,IP,001,10,13600,13850,6641,250,PERF
42013345860000,PI,IP,001,11,13900,14150,6641,250,PERF
42013345860000,PI,IP,001,12,14200,14450,6641,250,PERF
42013345860000,PI,IP,001,13,14650,14850,6641,200,PERF
42013345860000,PI,IP,001,14,14900,15150,6641,250,PERF
42013345860000,PI,IP,001,15,15200,15450,6641,250,PERF
42013345860000,PI,IP,001,16,15500,15750,6641,250,PERF
42013345860000,PI,IP,001,17,15800,16000,6641,200,PERF
42013345860000,PI,IP,001,18,16100,16350,6641,250,PERF
42013345860000,PI,IP,001,19,16400,16650,6641,250,PERF
42013345860000,PI,IP,001,20,16700,16950,6641,250,PERF
42013345870000,PI,IP,001,1,11316,16446,5891,5130,PERF
42013345880000,PI,IP,001,1,10954,15744,5264,4790,PERF
42013345890000,PI,IP,001,1,9470,14736,5653,5266,PERF
42013345900000,PI,IP,001,1,11250,16524,5897,5274,PERF
42013345910000,PI,IP,001,1,11135,15587,,4452,PERF
42013345930000,PI,IP,001,1,9608,15191,6202,5583,PERF
42013345950000,PI,IP,001,1,11143,15477,4607,4334,PERF
42013345960000,PI,IP,001,1,10774,14789,4540,4015,PERF
42013345970000,PI,IP,001,1,9662,16432,7367,6770,PERF
42013345990000,PI,IP,001,1,11256,16412,5859,5156,PERF
42013346070000,PI,IP,001,1,9243,15345,6711,6102,PERF
42013346080000,PI,IP,001,1,9216,15252,6406,6036,PERF
42013346100000,PI,IP,001,1,9060,14525,6028,5465,PERF
42013346130000,PI,IP,001,1,9983,16345,6962,6362,PERF
42013346200000,PI,IP,001,1,8742,15344,7697,6602,PERF
42013346210000,PI,IP,001,1,7829,14080,7088,6251,PERF
42013346220000,PI,IP,001,1,11246,15503,4531,4257,PERF
42013346230000,PI,IP,001,1,9134,15085,6371,5951,PERF
42013346240000,PI,IP,001,1,9040,15100,6359,6060,PERF
42013346340000,PI,IP,001,1,8351,13804,6197,5453,PERF
42013346360000,PI,IP,001,1,8340,13525,5589,5185,PERF
42013346380000,PI,IP,001,1,7837,16169,8801,8332,PERF
42013346510000,PI,IP,001,1,9434,16470,8197,7036,PERF
42013346520000,PI,IP,001,1,9464,15261,6898,5797,PERF
42013346560000,PI,IP,001,1,8079,12326,5124,4247,PERF
42013346590000,PI,IP,001,1,8894,14230,6200,5336,PERF
42283337900000,PI,IP,001,1,7996,12584,5046,4588,PERF
42123329620000,PI,IP,001,1,13720,17351,3638,3631,PERF
42123329630000,PI,IP,001,1,13685,17301,,3616,PERF
42123329640000,PI,IP,001,1,13715,17361,3995,3646,PERF
42123330030000,PI,IP,001,1,13664,16460,,2796,PERF
42283335810000,PI,IP,001,1,8753,9098,6468,345,PERF
42283335810000,PI,IP,001,2,9151,9496,6468,345,PERF
42283335810000,PI,IP,001,3,9549,9894,6468,345,PERF
42283335810000,PI,IP,001,4,9947,10292,6468,345,PERF
42283335810000,PI,IP,001,5,10345,10690,6468,345,PERF
42283335810000,PI,IP,001,6,10743,11088,6468,345,PERF
42283335810000,PI,IP,001,7,11141,11486,6468,345,PERF
42283335810000,PI,IP,001,8,11539,11884,6468,345,PERF
42283335810000,PI,IP,001,9,11937,12282,6468,345,PERF
42283335810000,PI,IP,001,10,12335,12680,6468,345,PERF
42283335810000,PI,IP,001,11,12733,13078,6468,345,PERF
42283335810000,PI,IP,001,12,13131,13476,6468,345,PERF
42283335810000,PI,IP,001,13,13529,13874,6468,345,PERF
42283335810000,PI,IP,001,14,13927,14272,6468,345,PERF
42283335810000,PI,IP,001,15,14325,14670,6468,345,PERF
42283335810000,PI,IP,001,16,14723,15068,6468,345,PERF
42283335850000,PI,IP,001,1,7985,13605,6124,5620,PERF
42283335910000,PI,IP,001,1,8464,8669,,205,PERF
42283335910000,PI,IP,001,2,8748,8951,,203,PERF
42283335910000,PI,IP,001,3,9030,9231,,201,PERF
42283335910000,PI,IP,001,4,9316,9521,,205,PERF
42283335910000,PI,IP,001,5,9607,9805,,198,PERF
42283335910000,PI,IP,001,6,9884,10089,,205,PERF
42283335910000,PI,IP,001,7,10168,10373,,205,PERF
42283335910000,PI,IP,001,8,10452,10657,,205,PERF
42283335910000,PI,IP,001,9,10736,10941,,205,PERF
42283335910000,PI,IP,001,10,11020,11225,,205,PERF
42283335910000,PI,IP,001,11,11304,11509,,205,PERF
42283335910000,PI,IP,001,12,11588,11793,,205,PERF
42283335910000,PI,IP,001,13,11872,12077,,205,PERF
42283335910000,PI,IP,001,14,12156,12361,,205,PERF
42283335910000,PI,IP,001,15,12440,12645,,205,PERF
42283335910000,PI,IP,001,16,12724,12929,,205,PERF
42283335910000,PI,IP,001,17,13008,13213,,205,PERF
42283335910000,PI,IP,001,18,13292,13497,,205,PERF
42283335910000,PI,IP,001,19,13576,13781,,205,PERF
42283335910000,PI,IP,001,20,13866,14056,,190,PERF
42283335910000,PI,IP,001,21,14150,14349,,199,PERF
42283335910000,PI,IP,001,22,14428,14633,,205,PERF
42283335910000,PI,IP,001,23,14712,14917,,205,PERF
42283335920000,PI,IP,001,1,8337,8537,5079,200,PERF
42283335920000,PI,IP,001,2,8618,8811,5079,193,PERF
42283335920000,PI,IP,001,3,8899,9091,5079,192,PERF
42283335920000,PI,IP,001,4,9180,9385,5079,205,PERF
42283335920000,PI,IP,001,5,9461,9664,5079,203,PERF
42283335920000,PI,IP,001,6,9742,9947,5079,205,PERF
42283335920000,PI,IP,001,7,10033,10228,5079,195,PERF
42283335920000,PI,IP,001,8,10320,10509,5079,189,PERF
42283335920000,PI,IP,001,9,10593,10790,5079,197,PERF
42283335920000,PI,IP,001,10,10870,11071,5079,201,PERF
42283335920000,PI,IP,001,11,11150,11352,5079,202,PERF
42283335920000,PI,IP,001,12,11430,11633,5079,203,PERF
42283335920000,PI,IP,001,13,11715,11914,5079,199,PERF
42283335920000,PI,IP,001,14,12092,12195,5079,103,PERF
42283335920000,PI,IP,001,15,12271,12476,5079,205,PERF
42283335920000,PI,IP,001,16,12552,12752,5079,200,PERF
42283335930000,PI,IP,001,1,7788,12146,5042,4358,PERF
42283335940000,PI,IP,001,1,8384,8589,9343,205,PERF
42283335940000,PI,IP,001,2,8669,8881,9343,212,PERF
42283335940000,PI,IP,001,3,8960,9153,9343,193,PERF
42283335940000,PI,IP,001,4,9250,9439,9343,189,PERF
42283335940000,PI,IP,001,5,9524,9729,9343,205,PERF
42283335940000,PI,IP,001,6,9809,10014,9343,205,PERF
42283335940000,PI,IP,001,7,10049,10299,9343,250,PERF
42283335940000,PI,IP,001,8,10379,10584,9343,205,PERF
42283335940000,PI,IP,001,9,10664,10869,9343,205,PERF
42283335940000,PI,IP,001,10,10949,11154,9343,205,PERF
42283335940000,PI,IP,001,11,11243,11439,9343,196,PERF
42283335940000,PI,IP,001,12,11519,11724,9343,205,PERF
42283335940000,PI,IP,001,13,11804,12009,9343,205,PERF
42283335940000,PI,IP,001,14,12094,12301,9343,207,PERF
42283335940000,PI,IP,001,15,12380,12573,9343,193,PERF
42283335940000,PI,IP,001,16,12668,12864,9343,196,PERF
42283335940000,PI,IP,001,17,12944,13149,9343,205,PERF
42283335940000,PI,IP,001,18,13229,13434,9343,205,PERF
42283335940000,PI,IP,001,19,13514,13719,9343,205,PERF
42283335940000,PI,IP,001,20,13799,14004,9343,205,PERF
42283335940000,PI,IP,001,21,14084,14289,9343,205,PERF
42283335940000,PI,IP,001,22,14369,14573,9343,204,PERF
42283335940000,PI,IP,001,23,14660,14855,9343,195,PERF
42283335940000,PI,IP,001,24,14949,15144,9343,195,PERF
42283335940000,PI,IP,001,25,15224,15429,9343,205,PERF
42283335940000,PI,IP,001,26,15509,15714,9343,205,PERF
42283335940000,PI,IP,001,27,15794,15999,9343,205,PERF
42283335940000,PI,IP,001,28,16079,16284,9343,205,PERF
42283335940000,PI,IP,001,29,16364,16571,9343,207,PERF
42283335940000,PI,IP,001,30,16649,16854,9343,205,PERF
42283336240000,PI,IP,001,1,9642,14947,5928,5305,PERF
42283336290000,PI,IP,001,1,8874,15697,7403,6823,PERF
42283336310000,PI,IP,001,1,9714,15442,6347,5728,PERF
42283336330000,PI,IP,001,1,8620,13368,,4748,PERF
42283336430000,PI,IP,001,1,9649,15272,6231,5623,PERF
42283336440000,PI,IP,001,1,10000,14680,5571,4680,PERF
42283336450000,PI,IP,001,1,9993,14434,5555,4441,PERF
42283336580100,PI,IP,001,1,9457,13711,4973,4254,PERF
42283336600000,PI,IP,001,1,7936,8141,6694,205,PERF
42283336600000,PI,IP,001,2,8201,8406,6694,205,PERF
42283336600000,PI,IP,001,3,8470,8657,6694,187,PERF
42283336600000,PI,IP,001,4,8731,8936,6694,205,PERF
42283336600000,PI,IP,001,5,9006,9201,6694,195,PERF
42283336600000,PI,IP,001,6,9261,9466,6694,205,PERF
42283336600000,PI,IP,001,7,9606,9806,6694,200,PERF
42283336600000,PI,IP,001,8,9886,10091,6694,205,PERF
42283336600000,PI,IP,001,9,10171,10376,6694,205,PERF
42283336600000,PI,IP,001,10,10456,10661,6694,205,PERF
42283336600000,PI,IP,001,11,10741,10946,6694,205,PERF
42283336600000,PI,IP,001,12,11026,11231,6694,205,PERF
42283336600000,PI,IP,001,13,11311,11516,6694,205,PERF
42283336600000,PI,IP,001,14,11596,11801,6694,205,PERF
42283336600000,PI,IP,001,15,11881,12086,6694,205,PERF
42283336600000,PI,IP,001,16,12166,12371,6694,205,PERF
42283336600000,PI,IP,001,17,12451,12661,6694,210,PERF
42283336600000,PI,IP,001,18,12740,12935,6694,195,PERF
42283336600000,PI,IP,001,19,13026,13223,6694,197,PERF
42283336600000,PI,IP,001,20,13306,13511,6694,205,PERF
42283336600000,PI,IP,001,21,13591,13796,6694,205,PERF
42283336600000,PI,IP,001,22,13880,14075,6694,195,PERF
42283336740000,PI,PT,001,1,9693,14033,,4340,PERF
42283337050000,PI,IP,001,1,8609,13168,4791,4559,PERF
42283337060000,PI,IP,001,1,9321,15618,6832,6297,PERF
42283337360000,PI,IP,001,1,9625,15097,6195,5472,PERF
42283337590000,PI,IP,001,1,9372,15778,6931,6406,PERF
42283337670000,PI,IP,001,1,7921,12776,5301,4855,PERF
42283337830000,PI,IP,001,1,9380,15193,6193,5813,PERF
42283337850000,PI,IP,001,1,8629,13785,5485,5156,PERF
42177327780000,PI,IP,001,1,12126,16337,4627,4211,PERF
42177327800000,PI,IP,001,1,9015,13551,,4536,PERF
42177327850000,PI,IP,001,1,11950,16128,4374,4178,PERF
42177327860000,PI,IP,001,1,11950,16262,4447,4312,PERF
42177327870000,PI,IP,001,1,11976,16487,4558,4511,PERF
42177327930000,PI,IP,001,1,9728,15986,6571,6258,PERF
42177328030000,PI,IP,001,1,11716,18372,7596,6656,PERF
42177328070000,PI,IP,001,1,11958,15036,3678,3078,PERF
42177328080000,PI,PT,001,1,8434,11950,,3516,PERF
42177328090000,PI,IP,001,1,12234,15547,4180,3313,PERF
42177328130000,PI,IP,001,1,12167,16102,4743,3935,PERF
42177328140000,PI,PT,001,1,9725,13680,,3955,PERF
42177328200000,PI,IP,001,1,10759,16129,5748,5370,PERF
42177328240000,PI,IP,001,1,10798,15811,5549,5013,PERF
42177328260000,PI,IP,001,1,12269,17211,5022,4942,PERF
42177328540000,PI,IP,001,1,10133,14499,5114,4366,PERF
42177328600000,PI,IP,001,1,9330,15076,6148,5746,PERF
42311351650000,PI,IP,001,1,10138,15726,6479,5588,PERF
42311351680000,PI,IP,001,1,10233,15792,6464,5559,PERF
42311351690000,PI,IP,001,1,11360,17784,7087,6424,PERF
42311351910000,PI,IP,002,1,10300,14835,5124,4535,PERF
42311351910000,PI,PT,001,1,10300,14835,5124,4535,PERF
42311352000000,PI,IP,001,1,10913,17205,6874,6292,PERF
42311352010000,PI,IP,001,1,11536,17667,7106,6131,PERF
42311352030000,PI,IP,001,1,11263,19309,8385,8046,PERF
42311352170000,PI,IP,001,1,10210,14905,4980,4695,PERF
42311352460000,PI,IP,001,1,10728,17072,6922,6344,PERF
42149332290000,PI,IP,001,1,10194,11463,3509,1269,PERF
42149332300000,PI,IP,002,1,11498,16000,5570,4502,PERF
42149332300000,PI,PT,001,1,11498,16000,5570,4502,PERF
42149332350100,PI,IP,001,1,10577,15648,5834,5071,PERF
42149332370000,PI,IP,001,1,8534,12028,4667,3494,PERF
42149332400000,PI,IP,001,1,10784,15245,5597,4461,PERF
42149332480000,PI,PT,001,1,,,,,PERF
42149332620100,PI,IP,001,1,15738,17825,6745,2087,PERF
42149332680000,PI,IP,001,1,11614,16777,6488,5163,PERF
42149332710000,PI,IP,001,1,11980,18008,7256,6028,PERF
42149332760000,PI,IP,001,1,11598,17460,6787,5862,PERF
42255328580000,PI,IP,001,1,12255,16969,5641,4714,PERF
42255328610000,PI,IP,001,1,9186,14547,6113,5361,PERF
42255328620000,PI,IP,001,1,8834,14913,6542,6079,PERF
42255328650000,PI,IP,001,1,12174,17320,6082,5146,PERF
42255328820000,PI,IP,001,1,10886,16128,6203,5242,PERF
42255328970100,PI,IP,001,1,12420,18607,6821,6187,PERF
42255329030000,PI,IP,001,1,11365,18909,7822,7544,PERF
42255329060000,PI,IP,001,1,9837,12948,4251,3111,PERF
42255329070000,PI,IP,001,1,11337,17725,7324,6388,PERF
42255329100000,PI,IP,001,1,12869,17176,5361,4307,PERF
42255329110000,PI,IP,001,1,12698,17354,5690,4656,PERF
42255329180000,PI,IP,001,1,10000,14733,5096,4733,PERF
42255329190000,PI,IP,001,1,12289,16926,5461,4637,PERF
42255329200000,PI,IP,001,1,12791,16937,5498,4146,PERF
42255329280000,PI,IP,001,1,10031,14660,5039,4629,PERF
42255329490000,PI,IP,001,1,11502,14918,4026,3416,PERF
42255329500000,PI,IP,001,1,11741,14970,4028,3229,PERF
42255329840000,PI,IP,001,1,12541,18787,7180,6246,PERF
42255330060000,PI,IP,001,1,9815,12870,,3055,PERF
42255330380000,PI,IP,001,1,12017,16280,4960,4263,PERF
42255330390000,PI,IP,001,1,12059,16229,5037,4170,PERF
42025338210000,PI,IP,001,1,14285,17901,4715,3616,PERF
42025338250000,PI,IP,001,1,13349,18750,7090,5401,PERF
42025338260000,PI,IP,001,1,13400,17041,4229,3641,PERF
42025338380000,PI,IP,001,1,13380,17759,4977,4379,PERF
42025338390000,PI,IP,001,1,13101,19953,7162,6852,PERF
42025338420000,PI,IP,001,1,13200,19781,6606,6581,PERF
42025338490000,PI,IP,001,1,13215,18026,5547,4811,PERF
